season,team,pos,g,gs,mp,fg,fga,fg%,3p,3pa,3p%,2p,2pa,2p%,efg%,ft,fta,ft%,orb,drb,trb,ast,stl,blk,tov,pf,pts,name
2020-2021,Miami Heat,PF,61,4,737,124,228,0.544,0,1,0,124,227,0.546,0.544,56,110,0.509,73,135,208,29,20,28,43,91,304,Precious Achiuwa
2021-2022,Toronto Raptors,C,73,28,1725,265,603,0.439,56,156,0.359,209,447,0.468,0.486,78,131,0.595,146,327,473,82,37,41,84,151,664,Precious Achiuwa
2022-2023,Toronto Raptors,C,55,12,1140,196,404,0.485,29,108,0.269,167,296,0.564,0.521,87,124,0.702,100,228,328,50,31,30,59,102,508,Precious Achiuwa
2023-2024,Total,PF,74,18,1624,235,469,0.501,26,97,0.268,209,372,0.562,0.529,69,112,0.616,191,296,487,97,46,68,83,143,565,Precious Achiuwa
2023-2024,Toronto Raptors,C,25,0,437,78,170,0.459,13,47,0.277,65,123,0.528,0.497,24,42,0.571,50,86,136,44,16,12,29,40,193,Precious Achiuwa
2023-2024,New York Knicks,PF,49,18,1187,157,299,0.525,13,50,0.26,144,249,0.578,0.547,45,70,0.643,141,210,351,53,30,56,54,103,372,Precious Achiuwa
2024-2025,New York Knicks,PF,10,1,195,21,46,0.457,3,9,0.333,18,37,0.486,0.489,7,14,0.5,24,46,70,13,8,9,10,14,52,Precious Achiuwa
2013-2014,Oklahoma City Thunder,C,81,20,1197,93,185,0.503,0,0,,93,185,0.503,0.503,79,136,0.581,142,190,332,43,40,57,71,203,265,Steven Adams
2014-2015,Oklahoma City Thunder,C,70,67,1771,217,399,0.544,0,2,0,217,397,0.547,0.544,103,205,0.502,199,324,523,66,38,86,99,222,537,Steven Adams
2015-2016,Oklahoma City Thunder,C,80,80,2014,261,426,0.613,0,0,,261,426,0.613,0.613,114,196,0.582,219,314,533,62,42,89,84,223,636,Steven Adams
2016-2017,Oklahoma City Thunder,C,80,80,2389,374,655,0.571,0,1,0,374,654,0.572,0.571,157,257,0.611,281,332,613,86,89,78,146,195,905,Steven Adams
2017-2018,Oklahoma City Thunder,C,76,76,2487,448,712,0.629,0,2,0,448,710,0.631,0.629,160,286,0.559,384,301,685,88,92,78,128,215,1056,Steven Adams
2018-2019,Oklahoma City Thunder,C,80,80,2669,481,809,0.595,0,2,0,481,807,0.596,0.595,146,292,0.5,391,369,760,124,117,76,135,204,1108,Steven Adams
2019-2020,Oklahoma City Thunder,C,63,63,1680,283,478,0.592,1,3,0.333,282,475,0.594,0.593,117,201,0.582,207,376,583,146,51,67,94,122,684,Steven Adams
2020-2021,New Orleans Pelicans,C,58,58,1605,189,308,0.614,0,3,0,189,305,0.62,0.614,60,135,0.444,213,301,514,111,54,38,78,113,438,Steven Adams
2021-2022,Memphis Grizzlies,C,76,75,1999,210,384,0.547,0,1,0,210,383,0.548,0.547,108,199,0.543,349,411,760,256,65,60,115,153,528,Steven Adams
2022-2023,Memphis Grizzlies,C,42,42,1133,157,263,0.597,0,1,0,157,262,0.599,0.597,47,129,0.364,214,271,485,97,36,46,79,98,361,Steven Adams
2024-2025,Houston Rockets,C,18,0,186,17,28,0.607,0,0,,17,28,0.607,0.607,10,27,0.37,28,38,66,19,5,4,21,19,44,Steven Adams
2017-2018,Miami Heat,C,69,19,1368,174,340,0.512,0,7,0,174,333,0.523,0.512,129,179,0.721,118,263,381,101,32,41,66,138,477,Bam Adebayo
2018-2019,Miami Heat,C,82,28,1913,280,486,0.576,3,15,0.2,277,471,0.588,0.579,166,226,0.735,165,432,597,184,71,65,121,203,729,Bam Adebayo
2019-2020,Miami Heat,PF,72,72,2417,440,790,0.557,2,14,0.143,438,776,0.564,0.558,264,382,0.691,176,559,735,368,82,93,204,182,1146,Bam Adebayo
2020-2021,Miami Heat,C,64,64,2143,456,800,0.57,2,8,0.25,454,792,0.573,0.571,283,354,0.799,142,431,573,346,75,66,169,145,1197,Bam Adebayo
2021-2022,Miami Heat,C,56,56,1825,406,729,0.557,0,6,0,406,723,0.562,0.557,256,340,0.753,137,427,564,190,80,44,148,171,1068,Bam Adebayo
2022-2023,Miami Heat,C,75,75,2598,602,1114,0.54,1,12,0.083,601,1102,0.545,0.541,324,402,0.806,184,504,688,240,88,61,187,208,1529,Bam Adebayo
2023-2024,Miami Heat,C,71,71,2416,530,1017,0.521,15,42,0.357,515,975,0.528,0.529,292,387,0.755,159,578,737,278,81,66,162,159,1367,Bam Adebayo
2024-2025,Miami Heat,C,28,28,976,173,382,0.453,23,77,0.299,150,305,0.492,0.483,86,120,0.717,68,210,278,137,39,24,60,57,455,Bam Adebayo
2022-2023,Utah Jazz,SG,59,22,1209,165,386,0.427,81,228,0.355,84,158,0.532,0.532,56,69,0.812,43,78,121,67,16,15,41,99,467,Ochai Agbaji
2023-2024,Total,SG,78,28,1641,178,433,0.411,62,211,0.294,116,222,0.523,0.483,37,56,0.661,74,142,216,83,47,44,64,117,455,Ochai Agbaji
2023-2024,Utah Jazz,SG,51,10,1003,106,249,0.426,47,142,0.331,59,107,0.551,0.52,15,20,0.75,35,91,126,47,27,29,34,66,274,Ochai Agbaji
2023-2024,Toronto Raptors,SG,27,18,638,72,184,0.391,15,69,0.217,57,115,0.496,0.432,22,36,0.611,39,51,90,36,20,15,30,51,181,Ochai Agbaji
2024-2025,Toronto Raptors,SG,31,29,945,144,279,0.516,53,127,0.417,91,152,0.599,0.611,17,26,0.654,27,96,123,57,28,15,24,71,358,Ochai Agbaji
2021-2022,Memphis Grizzlies,PF,32,0,360,53,132,0.402,6,48,0.125,47,84,0.56,0.424,20,32,0.625,33,54,87,21,6,10,16,36,132,Santi Aldama
2022-2023,Memphis Grizzlies,PF,77,20,1682,247,525,0.47,94,266,0.353,153,259,0.591,0.56,108,144,0.75,85,286,371,97,45,48,60,143,696,Santi Aldama
2023-2024,Memphis Grizzlies,PF,61,35,1618,247,568,0.435,106,304,0.349,141,264,0.534,0.528,54,87,0.621,72,280,352,138,43,54,69,89,654,Santi Aldama
2024-2025,Memphis Grizzlies,PF,31,11,797,158,311,0.508,54,139,0.388,104,172,0.605,0.595,33,43,0.767,48,178,226,92,28,17,38,32,403,Santi Aldama
2024-2025,Denver Nuggets,SG,10,0,48,3,12,0.25,1,6,0.167,2,6,0.333,0.292,2,2,1,0,1,1,3,0,1,1,3,9,Trey Alexander
2020-2021,Phoenix Suns,SG,15,0,47,3,12,0.25,2,9,0.222,1,3,0.333,0.333,1,2,0.5,2,8,10,6,0,1,3,2,9,Ty-Shon Alexander
2019-2020,New Orleans Pelicans,SG,47,1,591,98,266,0.368,46,133,0.346,52,133,0.391,0.455,25,37,0.676,9,75,84,89,17,8,54,57,267,Nickeil Alexander-Walker
2020-2021,New Orleans Pelicans,SG,46,13,1007,192,458,0.419,76,219,0.347,116,239,0.485,0.502,48,66,0.727,13,131,144,102,47,22,69,88,508,Nickeil Alexander-Walker
2021-2022,Total,SG,65,21,1466,253,680,0.372,105,338,0.311,148,342,0.433,0.449,81,109,0.743,37,150,187,156,46,23,93,103,692,Nickeil Alexander-Walker
2021-2022,New Orleans Pelicans,SG,50,19,1317,237,632,0.375,95,305,0.311,142,327,0.434,0.45,70,97,0.722,36,128,164,139,41,19,85,88,639,Nickeil Alexander-Walker
2021-2022,Utah Jazz,SG,15,2,149,16,48,0.333,10,33,0.303,6,15,0.4,0.438,11,12,0.917,1,22,23,17,5,4,8,15,53,Nickeil Alexander-Walker
2022-2023,Total,SG,59,3,884,131,295,0.444,61,159,0.384,70,136,0.515,0.547,40,60,0.667,15,86,101,108,32,21,55,88,363,Nickeil Alexander-Walker
2022-2023,Utah Jazz,SG,36,3,528,83,170,0.488,35,87,0.402,48,83,0.578,0.591,27,39,0.692,8,51,59,76,24,14,45,58,228,Nickeil Alexander-Walker
2022-2023,Minnesota Timberwolves,SG,23,0,356,48,125,0.384,26,72,0.361,22,53,0.415,0.488,13,21,0.619,7,35,42,32,8,7,10,30,135,Nickeil Alexander-Walker
2023-2024,Minnesota Timberwolves,SG,82,20,1921,236,538,0.439,131,335,0.391,105,203,0.517,0.56,52,65,0.8,35,132,167,204,64,42,76,143,655,Nickeil Alexander-Walker
2024-2025,Minnesota Timberwolves,SG,30,2,709,104,209,0.498,51,118,0.432,53,91,0.582,0.62,26,34,0.765,17,66,83,76,26,9,40,48,285,Nickeil Alexander-Walker
2018-2019,Chicago Bulls,SG,10,1,120,13,39,0.333,3,12,0.25,10,27,0.37,0.372,8,12,0.667,11,15,26,13,1,0,8,7,37,Rawle Alkins
2018-2019,Utah Jazz,SG,38,2,416,67,178,0.376,32,99,0.323,35,79,0.443,0.466,45,60,0.75,3,20,23,25,6,6,33,47,211,Grayson Allen
2019-2020,Memphis Grizzlies,SG,38,0,718,117,251,0.466,57,141,0.404,60,110,0.545,0.58,39,45,0.867,8,77,85,52,10,2,33,53,330,Grayson Allen
2020-2021,Memphis Grizzlies,SG,50,38,1259,173,414,0.418,107,274,0.391,66,140,0.471,0.547,79,91,0.868,19,141,160,108,46,8,48,71,532,Grayson Allen
2021-2022,Milwaukee Bucks,SG,66,61,1805,255,569,0.448,159,389,0.409,96,180,0.533,0.588,64,74,0.865,32,190,222,100,46,18,43,96,733,Grayson Allen
2022-2023,Milwaukee Bucks,SG,72,70,1972,245,557,0.44,146,366,0.399,99,191,0.518,0.571,114,126,0.905,61,176,237,163,62,14,72,117,750,Grayson Allen
2023-2024,Phoenix Suns,SG,75,74,2513,340,682,0.499,205,445,0.461,135,237,0.57,0.649,129,147,0.878,48,247,295,227,69,45,95,157,1014,Grayson Allen
2024-2025,Phoenix Suns,SG,23,1,550,74,183,0.404,50,133,0.376,24,50,0.48,0.541,42,50,0.84,16,58,74,42,20,7,24,34,240,Grayson Allen
2017-2018,Brooklyn Nets,C,72,31,1441,234,397,0.589,5,15,0.333,229,382,0.599,0.596,114,147,0.776,144,244,388,49,28,88,82,147,587,Jarrett Allen
2018-2019,Brooklyn Nets,C,80,80,2096,335,568,0.59,6,45,0.133,329,523,0.629,0.595,197,278,0.709,191,481,672,110,43,120,103,184,873,Jarrett Allen
2019-2020,Brooklyn Nets,C,70,64,1852,302,465,0.649,0,6,0,302,459,0.658,0.649,171,270,0.633,216,455,671,110,40,92,77,162,775,Jarrett Allen
2020-2021,Total,C,63,45,1864,298,482,0.618,6,19,0.316,292,463,0.631,0.624,204,290,0.703,196,435,631,106,32,90,100,96,806,Jarrett Allen
2020-2021,Brooklyn Nets,C,12,5,320,44,65,0.677,0,0,,44,65,0.677,0.677,46,61,0.754,38,87,125,20,7,19,22,21,134,Jarrett Allen
2020-2021,Cleveland Cavaliers,C,51,40,1544,254,417,0.609,6,19,0.316,248,398,0.623,0.616,158,229,0.69,158,348,506,86,25,71,78,75,672,Jarrett Allen
2021-2022,Cleveland Cavaliers,C,56,56,1810,369,545,0.677,1,10,0.1,368,535,0.688,0.678,165,233,0.708,192,410,602,92,44,75,94,97,904,Jarrett Allen
2022-2023,Cleveland Cavaliers,C,68,68,2220,403,626,0.644,1,10,0.1,402,616,0.653,0.645,162,221,0.733,221,445,666,113,54,84,93,153,969,Jarrett Allen
2023-2024,Cleveland Cavaliers,C,77,77,2442,519,819,0.634,0,6,0,519,813,0.638,0.634,233,314,0.742,243,568,811,210,53,81,121,147,1271,Jarrett Allen
2024-2025,Cleveland Cavaliers,C,31,31,909,167,243,0.687,0,1,0,167,242,0.69,0.687,78,106,0.736,70,240,310,59,32,24,34,38,412,Jarrett Allen
2023-2024,Memphis Grizzlies,SF,5,0,125,6,23,0.261,0,7,0,6,16,0.375,0.261,1,2,0.5,4,13,17,5,4,0,2,18,13,Timmy Allen
2021-2022,New Orleans Pelicans,PG,54,1,834,131,294,0.446,32,110,0.291,99,184,0.538,0.5,36,53,0.679,25,75,100,152,71,7,40,73,330,Jose Alvarado
2022-2023,New Orleans Pelicans,PG,61,10,1310,201,489,0.411,83,247,0.336,118,242,0.488,0.496,65,80,0.813,28,113,141,186,67,10,81,125,550,Jose Alvarado
2023-2024,New Orleans Pelicans,PG,56,0,1028,142,345,0.412,78,207,0.377,64,138,0.464,0.525,35,52,0.673,25,103,128,117,59,15,40,89,397,Jose Alvarado
2024-2025,New Orleans Pelicans,PG,11,7,282,40,101,0.396,24,60,0.4,16,41,0.39,0.515,14,17,0.824,6,18,24,49,17,3,14,26,118,Jose Alvarado
2015-2016,Dallas Mavericks,SF,55,9,647,71,175,0.406,22,83,0.265,49,92,0.533,0.469,44,55,0.8,18,114,132,29,19,25,24,45,208,Justin Anderson
2016-2017,Total,SF,75,10,1228,186,439,0.424,58,194,0.299,128,245,0.522,0.49,102,129,0.791,69,176,245,66,41,23,66,109,532,Justin Anderson
2016-2017,Dallas Mavericks,SF,51,2,710,111,277,0.401,37,122,0.303,74,155,0.477,0.468,70,88,0.795,39,110,149,32,28,16,40,64,329,Justin Anderson
2016-2017,Philadelphia 76ers,SF,24,8,518,75,162,0.463,21,72,0.292,54,90,0.6,0.528,32,41,0.78,30,66,96,34,13,7,26,45,203,Justin Anderson
2017-2018,Philadelphia 76ers,SF,38,0,519,87,202,0.431,34,103,0.33,53,99,0.535,0.515,28,38,0.737,25,68,93,25,15,7,16,54,236,Justin Anderson
2018-2019,Atlanta Hawks,SF,48,4,463,64,157,0.408,24,77,0.312,40,80,0.5,0.484,26,35,0.743,24,60,84,23,22,13,23,48,178,Justin Anderson
2019-2020,Brooklyn Nets,SG,10,1,107,10,38,0.263,6,29,0.207,4,9,0.444,0.342,2,4,0.5,1,20,21,8,0,6,4,13,28,Justin Anderson
2021-2022,Total,SF,16,6,316,36,95,0.379,15,59,0.254,21,36,0.583,0.458,15,19,0.789,4,42,46,33,8,6,8,22,102,Justin Anderson
2021-2022,Cleveland Cavaliers,SF,3,0,47,4,8,0.5,2,6,0.333,2,2,1,0.625,3,4,0.75,0,6,6,6,1,0,2,4,13,Justin Anderson
2021-2022,Indiana Pacers,SF,13,6,269,32,87,0.368,13,53,0.245,19,34,0.559,0.443,12,15,0.8,4,36,40,27,7,6,6,18,89,Justin Anderson
2014-2015,San Antonio Spurs,SF,33,8,358,31,89,0.348,3,11,0.273,28,78,0.359,0.365,9,14,0.643,5,67,72,28,15,7,10,28,74,Kyle Anderson
2015-2016,San Antonio Spurs,SF,78,11,1245,138,295,0.468,12,37,0.324,126,258,0.488,0.488,62,83,0.747,25,219,244,123,60,29,59,97,350,Kyle Anderson
2016-2017,San Antonio Spurs,SF,72,14,1020,93,209,0.445,15,40,0.375,78,169,0.462,0.481,45,57,0.789,33,175,208,91,51,26,39,63,246,Kyle Anderson
2017-2018,San Antonio Spurs,SF,74,67,1978,231,438,0.527,19,57,0.333,212,381,0.556,0.549,104,146,0.712,84,312,396,202,115,60,94,114,585,Kyle Anderson
2018-2019,Memphis Grizzlies,SF,43,40,1281,150,276,0.543,9,34,0.265,141,242,0.583,0.56,37,64,0.578,48,203,251,128,54,37,58,112,346,Kyle Anderson
2019-2020,Memphis Grizzlies,SF,67,28,1330,157,331,0.474,24,85,0.282,133,246,0.541,0.511,52,78,0.667,58,227,285,162,54,37,66,111,390,Kyle Anderson
2020-2021,Memphis Grizzlies,PF,69,69,1887,308,658,0.468,94,261,0.36,214,397,0.539,0.54,144,184,0.783,52,344,396,250,84,57,86,120,854,Kyle Anderson
2021-2022,Memphis Grizzlies,PF,69,11,1484,209,469,0.446,36,109,0.33,173,360,0.481,0.484,67,105,0.638,69,299,368,183,77,45,71,108,521,Kyle Anderson
2022-2023,Minnesota Timberwolves,PF,69,46,1957,252,495,0.509,43,105,0.41,209,390,0.536,0.553,100,136,0.735,66,302,368,335,78,63,103,146,647,Kyle Anderson
2023-2024,Minnesota Timberwolves,PF,79,10,1782,199,433,0.46,11,48,0.229,188,385,0.488,0.472,97,137,0.708,60,213,273,331,71,47,91,128,506,Kyle Anderson
2024-2025,Golden State Warriors,PF,26,2,378,51,123,0.415,15,42,0.357,36,81,0.444,0.476,13,20,0.65,16,62,78,58,20,12,13,28,130,Kyle Anderson
2013-2014,Milwaukee Bucks,SF,77,23,1897,173,418,0.414,41,118,0.347,132,300,0.44,0.463,138,202,0.683,78,261,339,150,60,61,122,173,525,Giannis Antetokounmpo
2014-2015,Milwaukee Bucks,SG,81,71,2541,383,780,0.491,7,44,0.159,376,736,0.511,0.496,257,347,0.741,100,442,542,207,73,85,173,254,1030,Giannis Antetokounmpo
2015-2016,Milwaukee Bucks,PG,80,79,2823,513,1013,0.506,28,109,0.257,485,904,0.537,0.52,296,409,0.724,113,499,612,345,94,113,208,258,1350,Giannis Antetokounmpo
2016-2017,Milwaukee Bucks,SF,80,80,2845,656,1259,0.521,49,180,0.272,607,1079,0.563,0.541,471,612,0.77,142,558,700,434,131,151,234,246,1832,Giannis Antetokounmpo
2017-2018,Milwaukee Bucks,PF,75,75,2756,742,1402,0.529,43,140,0.307,699,1262,0.554,0.545,487,641,0.76,156,597,753,361,109,106,223,231,2014,Giannis Antetokounmpo
2018-2019,Milwaukee Bucks,PF,72,72,2358,721,1247,0.578,52,203,0.256,669,1044,0.641,0.599,500,686,0.729,159,739,898,424,92,110,268,232,1994,Giannis Antetokounmpo
2019-2020,Milwaukee Bucks,PF,63,63,1917,685,1238,0.553,89,293,0.304,596,945,0.631,0.589,398,629,0.633,140,716,856,354,61,66,230,195,1857,Giannis Antetokounmpo
2020-2021,Milwaukee Bucks,PF,61,61,2013,626,1100,0.569,67,221,0.303,559,879,0.636,0.6,398,581,0.685,97,574,671,357,72,73,207,168,1717,Giannis Antetokounmpo
2021-2022,Milwaukee Bucks,PF,67,67,2204,689,1245,0.553,71,242,0.293,618,1003,0.616,0.582,553,766,0.722,134,644,778,388,72,91,219,212,2002,Giannis Antetokounmpo
2022-2023,Milwaukee Bucks,PF,63,63,2024,707,1278,0.553,47,171,0.275,660,1107,0.596,0.572,498,772,0.645,137,605,742,359,52,51,246,197,1959,Giannis Antetokounmpo
2023-2024,Milwaukee Bucks,PF,73,73,2567,837,1369,0.611,34,124,0.274,803,1245,0.645,0.624,514,782,0.657,196,645,841,476,87,79,250,210,2222,Giannis Antetokounmpo
2024-2025,Milwaukee Bucks,PF,24,24,840,307,501,0.613,4,18,0.222,303,483,0.627,0.617,167,272,0.614,48,230,278,144,17,36,82,56,785,Giannis Antetokounmpo
2018-2019,Dallas Mavericks,PF,2,0,11,0,3,0,0,0,0,3,0,0,2,4,0.5,0,1,1,0,2,0,1,0,2,0,Kostas Antetokounmpo
2019-2020,Los Angeles Lakers,PF,5,0,20,3,3,1,0,0,3,3,1,1,1,2,0.5,2,1,3,2,0,0,1,2,7,0,Kostas Antetokounmpo
2020-2021,Los Angeles Lakers,PF,15,0,56,3,10,0.3,0,0,3,10,0.3,0.3,6,13,0.462,4,15,19,1,2,4,11,8,12,0,Kostas Antetokounmpo
2015-2016,New York Knicks,SF,2,0,6,3,4,0.75,0,1,0,3,3,1,0.75,0,0,,0,1,1,0,0,0,0,2,6,Thanasis Antetokounmpo
2019-2020,Milwaukee Bucks,SF,20,2,129,24,48,0.5,0,10,0,24,38,0.632,0.5,7,17,0.412,12,12,24,15,7,2,12,18,55,Thanasis Antetokounmpo
2020-2021,Milwaukee Bucks,SF,57,3,551,67,137,0.489,7,29,0.241,60,108,0.556,0.515,25,49,0.51,54,70,124,46,22,10,43,74,166,Thanasis Antetokounmpo
2021-2022,Milwaukee Bucks,SF,48,6,473,70,128,0.547,2,14,0.143,68,114,0.596,0.555,29,46,0.63,40,61,101,22,16,12,26,68,171,Thanasis Antetokounmpo
2022-2023,Milwaukee Bucks,PF,37,0,206,20,46,0.435,0,8,0,20,38,0.526,0.435,11,22,0.5,15,29,44,15,3,3,12,22,51,Thanasis Antetokounmpo
2023-2024,Milwaukee Bucks,PF,34,0,155,16,30,0.533,0,1,0,16,29,0.552,0.533,0,2,0,7,6,13,17,7,4,14,24,32,Thanasis Antetokounmpo
2020-2021,Orlando Magic,PG,47,34,1273,219,552,0.397,58,172,0.337,161,380,0.424,0.449,109,131,0.832,38,183,221,192,30,18,106,98,605,Cole Anthony
2021-2022,Orlando Magic,PG,65,65,2059,357,912,0.391,132,391,0.338,225,521,0.432,0.464,216,253,0.854,32,316,348,369,46,17,170,171,1062,Cole Anthony
2022-2023,Orlando Magic,PG,60,4,1552,277,610,0.454,75,206,0.364,202,404,0.5,0.516,152,170,0.894,47,241,288,235,37,31,91,158,781,Cole Anthony
2023-2024,Orlando Magic,PG,81,0,1817,332,763,0.435,93,275,0.338,239,488,0.49,0.496,180,218,0.826,64,247,311,236,64,37,126,175,937,Cole Anthony
2024-2025,Orlando Magic,PG,30,0,350,65,164,0.396,20,67,0.299,45,97,0.464,0.457,32,41,0.78,11,55,66,67,11,5,45,47,182,Cole Anthony
2017-2018,Toronto Raptors,SF,74,62,1481,163,346,0.471,73,197,0.371,90,149,0.604,0.577,39,62,0.629,44,140,184,55,52,14,45,130,438,OG Anunoby
2018-2019,Toronto Raptors,SF,67,6,1352,183,404,0.453,67,202,0.332,116,202,0.574,0.536,36,62,0.581,58,139,197,47,46,22,55,140,469,OG Anunoby
2019-2020,Toronto Raptors,SF,69,68,2066,286,566,0.505,89,228,0.39,197,338,0.583,0.584,72,102,0.706,80,284,364,108,96,45,79,167,733,OG Anunoby
2020-2021,Toronto Raptors,SF,43,43,1433,249,519,0.48,104,261,0.398,145,258,0.562,0.58,80,102,0.784,54,183,237,94,66,32,75,114,682,OG Anunoby
2021-2022,Toronto Raptors,SF,48,48,1728,309,697,0.443,115,317,0.363,194,380,0.511,0.526,89,118,0.754,74,190,264,125,71,25,80,131,822,OG Anunoby
2022-2023,Toronto Raptors,SF,67,67,2386,421,885,0.476,142,367,0.387,279,518,0.539,0.556,140,167,0.838,95,237,332,131,128,50,132,200,1124,OG Anunoby
2023-2024,Total,SF,50,50,1702,282,577,0.489,102,267,0.382,180,310,0.581,0.577,67,89,0.753,47,161,208,107,68,36,81,119,733,OG Anunoby
2023-2024,Toronto Raptors,SF,27,27,900,157,321,0.489,61,163,0.374,96,158,0.608,0.584,33,46,0.717,24,82,106,72,28,13,43,62,408,OG Anunoby
2023-2024,New York Knicks,SF,23,23,802,125,256,0.488,41,104,0.394,84,152,0.553,0.568,34,43,0.791,23,79,102,35,40,23,38,57,325,OG Anunoby
2024-2025,New York Knicks,PF,31,31,1122,195,407,0.479,65,183,0.355,130,224,0.58,0.559,58,73,0.795,37,119,156,63,47,31,42,78,513,OG Anunoby
2017-2018,Chicago Bulls,PG,24,0,304,17,41,0.415,9,31,0.29,8,10,0.8,0.524,5,6,0.833,1,24,25,35,13,0,13,18,48,Ryan Arcidiacono
2018-2019,Chicago Bulls,PG,81,32,1961,187,418,0.447,81,217,0.373,106,201,0.527,0.544,89,102,0.873,27,192,219,269,65,4,63,171,544,Ryan Arcidiacono
2019-2020,Chicago Bulls,PG,58,4,930,90,220,0.409,54,138,0.391,36,82,0.439,0.532,27,38,0.711,20,90,110,96,27,3,37,96,261,Ryan Arcidiacono
2020-2021,Chicago Bulls,PG,44,0,450,49,117,0.419,25,67,0.373,24,50,0.48,0.526,13,20,0.65,5,62,67,56,9,0,10,47,136,Ryan Arcidiacono
2021-2022,New York Knicks,PG,10,0,76,6,12,0.5,4,9,0.444,2,3,0.667,0.667,0,0,,0,8,8,4,1,0,3,5,16,Ryan Arcidiacono
2022-2023,Total,PG,20,4,172,9,37,0.243,8,23,0.348,1,14,0.071,0.351,0,0,,0,15,15,23,5,0,7,17,26,Ryan Arcidiacono
2022-2023,New York Knicks,PG,11,0,26,1,5,0.2,1,3,0.333,0,2,0,0.3,0,0,,0,4,4,2,2,0,1,3,3,Ryan Arcidiacono
2022-2023,Portland Trail Blazers,PG,9,4,146,8,32,0.25,7,20,0.35,1,12,0.083,0.359,0,0,,0,11,11,21,3,0,6,14,23,Ryan Arcidiacono
2023-2024,New York Knicks,PG,20,0,45,0,6,0,0,6,0,0,0,,0,0,0,,0,8,8,4,2,0,2,5,0,Ryan Arcidiacono
2020-2021,Washington Wizards,SF,54,32,1257,130,312,0.417,53,168,0.315,77,144,0.535,0.502,29,45,0.644,22,240,262,63,32,15,33,140,342,Deni Avdija
2021-2022,Washington Wizards,SF,82,8,1984,250,579,0.432,82,259,0.317,168,320,0.525,0.503,103,136,0.757,52,373,425,167,59,44,87,190,685,Deni Avdija
2022-2023,Washington Wizards,SF,76,40,2020,253,579,0.437,69,232,0.297,184,347,0.53,0.497,122,165,0.739,74,413,487,211,65,29,123,209,697,Deni Avdija
2023-2024,Washington Wizards,SF,75,75,2257,406,803,0.506,88,235,0.374,318,568,0.56,0.56,202,273,0.74,84,456,540,286,60,36,160,185,1102,Deni Avdija
2024-2025,Portland Trail Blazers,SF,30,12,794,128,287,0.446,44,121,0.364,84,166,0.506,0.523,91,117,0.778,39,135,174,95,28,22,62,65,391,Deni Avdija
2021-2022,Washington Wizards,SG,7,0,20,1,6,0.167,0,1,0,1,5,0.2,0.167,0,0,1,2,3,4,0,0,0,0,2,0,Joel Ayayi
2018-2019,Phoenix Suns,C,71,70,2183,509,870,0.585,0,4,0,509,866,0.588,0.585,141,189,0.746,223,506,729,125,61,67,126,209,1159,Deandre Ayton
2019-2020,Phoenix Suns,C,38,32,1236,310,568,0.546,3,13,0.231,307,555,0.553,0.548,67,89,0.753,147,289,436,72,26,58,80,117,690,Deandre Ayton
2020-2021,Phoenix Suns,C,69,69,2115,430,687,0.626,4,20,0.2,426,667,0.639,0.629,133,173,0.769,228,499,727,99,41,81,103,196,997,Deandre Ayton
2021-2022,Phoenix Suns,C,58,58,1713,442,697,0.634,7,19,0.368,435,678,0.642,0.639,106,142,0.746,149,444,593,84,40,40,91,142,997,Deandre Ayton
2022-2023,Phoenix Suns,C,67,67,2035,522,887,0.589,7,24,0.292,515,863,0.597,0.592,152,200,0.76,172,495,667,115,37,53,120,190,1203,Deandre Ayton
2023-2024,Portland Trail Blazers,C,55,55,1784,427,749,0.57,1,10,0.1,426,739,0.576,0.571,65,79,0.823,176,433,609,90,56,42,99,109,920,Deandre Ayton
2024-2025,Portland Trail Blazers,C,21,21,637,142,254,0.559,6,23,0.261,136,231,0.589,0.571,15,24,0.625,62,150,212,29,19,19,34,49,305,Deandre Ayton
2020-2021,Utah Jazz,C,15,0,57,4,9,0.444,0,0,4,9,0.444,0.444,8,10,0.8,4,9,13,0,1,4,3,9,16,0,Udoka Azubuike
2021-2022,Utah Jazz,C,17,6,195,37,49,0.755,0,0,37,49,0.755,0.755,6,11,0.545,18,53,71,0,1,11,12,25,80,0,Udoka Azubuike
2022-2023,Utah Jazz,C,36,4,359,59,72,0.819,0,0,59,72,0.819,0.819,7,20,0.35,31,88,119,11,6,15,18,34,125,0,Udoka Azubuike
2023-2024,Phoenix Suns,C,16,0,113,16,23,0.696,0,0,16,23,0.696,0.696,3,13,0.231,11,21,32,3,1,6,4,17,35,0,Udoka Azubuike
2023-2024,Portland Trail Blazers,C,22,1,226,14,22,0.636,0,0,14,22,0.636,0.636,6,12,0.5,20,31,51,13,3,20,15,46,34,0,Ibou Badji
2018-2019,Sacramento Kings,PF,62,4,1567,356,706,0.504,30,96,0.313,326,610,0.534,0.525,181,262,0.691,162,309,471,62,33,59,98,120,923,Marvin Bagley III
2019-2020,Sacramento Kings,C,13,6,334,78,167,0.467,4,22,0.182,74,145,0.51,0.479,25,31,0.806,29,68,97,10,6,12,18,43,185,Marvin Bagley III
2020-2021,Sacramento Kings,PF,43,42,1112,247,490,0.504,37,108,0.343,210,382,0.55,0.542,77,134,0.575,106,212,318,43,21,21,59,100,608,Marvin Bagley III
2021-2022,Total,PF,48,25,1153,225,446,0.504,23,97,0.237,202,349,0.579,0.53,67,101,0.663,105,233,338,36,22,18,39,93,540,Marvin Bagley III
2021-2022,Sacramento Kings,PF,30,17,663,114,246,0.463,15,62,0.242,99,184,0.538,0.494,35,47,0.745,67,148,215,17,9,11,21,50,278,Marvin Bagley III
2021-2022,Detroit Pistons,PF,18,8,490,111,200,0.555,8,35,0.229,103,165,0.624,0.575,32,54,0.593,38,85,123,19,13,7,18,43,262,Marvin Bagley III
2022-2023,Detroit Pistons,C,42,25,990,202,382,0.529,19,66,0.288,183,316,0.579,0.554,81,108,0.75,94,175,269,36,19,30,46,81,504,Marvin Bagley III
2023-2024,Total,C,50,25,1053,239,408,0.586,9,23,0.391,230,385,0.597,0.597,96,126,0.762,130,182,312,55,20,33,59,81,583,Marvin Bagley III
2023-2024,Detroit Pistons,C,26,10,478,107,181,0.591,1,6,0.167,106,175,0.606,0.594,50,61,0.82,46,72,118,27,5,14,29,40,265,Marvin Bagley III
2023-2024,Washington Wizards,C,24,15,575,132,227,0.581,8,17,0.471,124,210,0.59,0.599,46,65,0.708,84,110,194,28,15,19,30,41,318,Marvin Bagley III
2024-2025,Washington Wizards,C,19,1,166,38,71,0.535,2,10,0.2,36,61,0.59,0.549,15,23,0.652,27,29,56,7,7,5,11,12,93,Marvin Bagley III
2023-2024,Charlotte Hornets,PG,10,0,65,8,24,0.333,1,8,0.125,7,16,0.438,0.354,6,7,0.857,6,3,9,7,3,0,4,2,23,Amari Bailey
2022-2023,Golden State Warriors,SF,31,0,226,43,109,0.394,32,84,0.381,11,25,0.44,0.541,4,6,0.667,1,39,40,11,6,4,11,14,122,Patrick Baldwin Jr.
2023-2024,Washington Wizards,SF,38,7,493,59,155,0.381,31,97,0.32,28,58,0.483,0.481,19,28,0.679,17,106,123,29,18,15,19,56,168,Patrick Baldwin Jr.
2024-2025,Washington Wizards,SF,13,0,59,10,20,0.5,5,11,0.455,5,9,0.556,0.625,2,4,0.5,3,9,12,1,2,2,2,4,27,Patrick Baldwin Jr.
2020-2021,Charlotte Hornets,PG,51,31,1469,293,672,0.436,92,261,0.352,201,411,0.489,0.504,125,165,0.758,63,239,302,313,81,18,145,136,803,LaMelo Ball
2021-2022,Charlotte Hornets,PG,75,75,2422,538,1254,0.429,220,565,0.389,318,689,0.462,0.517,212,243,0.872,108,393,501,571,119,30,245,237,1508,LaMelo Ball
2022-2023,Charlotte Hornets,PG,36,36,1268,296,721,0.411,144,383,0.376,152,338,0.45,0.51,102,122,0.836,42,189,231,304,46,11,129,118,838,LaMelo Ball
2023-2024,Charlotte Hornets,PG,22,22,711,183,423,0.433,70,197,0.355,113,226,0.5,0.515,90,104,0.865,29,84,113,176,40,4,83,79,526,LaMelo Ball
2024-2025,Charlotte Hornets,PG,22,22,742,230,541,0.425,99,286,0.346,131,255,0.514,0.517,103,122,0.844,19,98,117,163,29,5,90,82,662,LaMelo Ball
2017-2018,Los Angeles Lakers,PG,52,50,1780,203,564,0.36,90,295,0.305,113,269,0.42,0.44,32,71,0.451,69,291,360,376,88,43,136,117,528,Lonzo Ball
2018-2019,Los Angeles Lakers,PG,47,45,1423,185,456,0.406,75,228,0.329,110,228,0.482,0.488,20,48,0.417,54,197,251,255,69,19,103,114,465,Lonzo Ball
2019-2020,New Orleans Pelicans,PG,63,54,2025,277,687,0.403,148,395,0.375,129,292,0.442,0.511,43,76,0.566,71,312,383,438,88,38,193,128,745,Lonzo Ball
2020-2021,New Orleans Pelicans,PG,55,55,1747,290,700,0.414,172,455,0.378,118,245,0.482,0.537,50,64,0.781,33,230,263,316,82,31,123,103,802,Lonzo Ball
2021-2022,Chicago Bulls,PG,35,35,1212,162,383,0.423,110,260,0.423,52,123,0.423,0.567,21,28,0.75,35,155,190,178,64,31,82,85,455,Lonzo Ball
2024-2025,Chicago Bulls,PG,12,0,210,20,64,0.313,15,53,0.283,5,11,0.455,0.43,7,7,1,4,33,37,43,13,7,12,14,62,Lonzo Ball
2018-2019,Orlando Magic,C,47,1,766,117,243,0.481,21,70,0.3,96,173,0.555,0.525,37,63,0.587,64,169,233,39,13,64,43,102,292,Mo Bamba
2019-2020,Orlando Magic,C,62,0,878,132,286,0.462,37,107,0.346,95,179,0.531,0.526,31,46,0.674,100,202,302,42,23,86,42,116,332,Mo Bamba
2020-2021,Orlando Magic,C,46,5,725,142,301,0.472,38,118,0.322,104,183,0.568,0.535,45,66,0.682,76,189,265,35,14,58,36,87,367,Mo Bamba
2021-2022,Orlando Magic,C,71,69,1824,296,617,0.48,107,281,0.381,189,336,0.563,0.566,57,73,0.781,148,424,572,85,38,118,77,182,756,Mo Bamba
2022-2023,Total,C,49,7,769,117,241,0.485,48,124,0.387,69,117,0.59,0.585,41,62,0.661,58,167,225,46,13,43,30,105,323,Mo Bamba
2022-2023,Orlando Magic,C,40,6,681,106,214,0.495,43,108,0.398,63,106,0.594,0.596,35,51,0.686,47,137,184,42,12,38,22,86,290,Mo Bamba
2022-2023,Los Angeles Lakers,C,9,1,88,11,27,0.407,5,16,0.313,6,11,0.545,0.5,6,11,0.545,11,30,41,4,1,5,8,19,33,Mo Bamba
2023-2024,Philadelphia 76ers,C,57,17,740,97,198,0.49,25,64,0.391,72,134,0.537,0.553,34,50,0.68,77,161,238,41,22,60,39,101,253,Mo Bamba
2024-2025,Los Angeles Clippers,C,16,0,205,23,58,0.397,6,27,0.222,17,31,0.548,0.448,9,13,0.692,11,49,60,11,8,19,10,33,61,Mo Bamba
2022-2023,Orlando Magic,PF,72,72,2430,479,1122,0.427,85,285,0.298,394,837,0.471,0.465,394,534,0.738,84,413,497,269,60,39,200,160,1437,Paolo Banchero
2023-2024,Orlando Magic,PF,80,80,2799,640,1407,0.455,119,351,0.339,521,1056,0.493,0.497,405,559,0.725,82,472,554,431,71,47,247,153,1804,Paolo Banchero
2024-2025,Orlando Magic,PF,5,5,182,48,97,0.495,11,32,0.344,37,65,0.569,0.552,38,59,0.644,12,32,44,28,3,4,11,13,145,Paolo Banchero
2020-2021,Memphis Grizzlies,SG,68,17,1519,234,499,0.469,117,271,0.432,117,228,0.513,0.586,40,49,0.816,31,179,210,118,41,16,59,125,625,Desmond Bane
2021-2022,Memphis Grizzlies,SG,76,76,2266,508,1101,0.461,228,523,0.436,280,578,0.484,0.565,140,155,0.903,46,288,334,208,92,29,111,196,1384,Desmond Bane
2022-2023,Memphis Grizzlies,SG,58,58,1841,450,939,0.479,166,407,0.408,284,532,0.534,0.568,181,205,0.883,43,248,291,254,56,22,126,150,1247,Desmond Bane
2023-2024,Memphis Grizzlies,SG,42,42,1443,360,776,0.464,137,360,0.381,223,416,0.536,0.552,140,161,0.87,36,149,185,230,43,22,112,120,997,Desmond Bane
2024-2025,Memphis Grizzlies,SG,24,23,676,137,296,0.463,48,136,0.353,89,160,0.556,0.544,48,56,0.857,20,120,140,116,29,11,53,63,370,Desmond Bane
2021-2022,Toronto Raptors,PG,64,1,696,83,202,0.411,13,51,0.255,70,151,0.464,0.443,26,44,0.591,38,86,124,99,28,10,53,68,205,Dalano Banton
2022-2023,Toronto Raptors,PG,31,2,279,55,130,0.423,15,51,0.294,40,79,0.506,0.481,17,24,0.708,11,34,45,36,13,13,18,34,142,Dalano Banton
2023-2024,Total,PG,54,9,1047,202,500,0.404,59,199,0.296,143,301,0.475,0.463,94,120,0.783,41,137,178,127,33,20,77,64,557,Dalano Banton
2023-2024,Boston Celtics,PG,24,1,171,19,51,0.373,2,16,0.125,17,35,0.486,0.392,16,20,0.8,12,23,35,19,5,3,10,20,56,Dalano Banton
2023-2024,Portland Trail Blazers,PG,30,8,876,183,449,0.408,57,183,0.311,126,266,0.474,0.471,78,100,0.78,29,114,143,108,28,17,67,44,501,Dalano Banton
2024-2025,Portland Trail Blazers,PG,25,0,413,85,202,0.421,31,87,0.356,54,115,0.47,0.498,37,56,0.661,9,47,56,66,22,13,43,27,238,Dalano Banton
2021-2022,Atlanta Hawks,PG,3,0,13,0,4,0,0,0,0,4,0,0,0,4,0,1,2,3,3,0,0,1,1,0,0,Cat Barber
2022-2023,San Antonio Spurs,PF,28,0,408,46,86,0.535,0,4,0,46,82,0.561,0.535,18,25,0.72,46,56,102,24,10,19,15,56,110,Dominick Barlow
2023-2024,San Antonio Spurs,PF,33,1,420,56,113,0.496,3,9,0.333,53,104,0.51,0.509,29,42,0.69,45,68,113,36,12,14,9,47,144,Dominick Barlow
2024-2025,Atlanta Hawks,SF,3,0,16,1,2,0.5,1,1,1,0,1,0,0.75,1,2,0.5,0,1,1,0,1,0,0,2,4,Dominick Barlow
2012-2013,Golden State Warriors,SF,81,81,2058,276,628,0.439,52,145,0.359,224,483,0.464,0.481,144,190,0.758,53,280,333,98,52,14,101,140,748,Harrison Barnes
2013-2014,Golden State Warriors,SF,78,24,2204,271,679,0.399,66,190,0.347,205,489,0.419,0.448,130,181,0.718,66,245,311,116,65,20,84,158,738,Harrison Barnes
2014-2015,Golden State Warriors,SF,82,82,2318,316,656,0.482,87,215,0.405,229,441,0.519,0.548,108,150,0.72,117,336,453,116,61,19,71,146,827,Harrison Barnes
2015-2016,Golden State Warriors,SF,66,59,2042,295,633,0.466,82,214,0.383,213,419,0.508,0.531,102,134,0.761,77,248,325,117,41,10,57,136,774,Harrison Barnes
2016-2017,Dallas Mavericks,PF,79,79,2803,599,1280,0.468,78,222,0.351,521,1058,0.492,0.498,242,281,0.861,93,301,394,116,65,15,102,128,1518,Harrison Barnes
2017-2018,Dallas Mavericks,PF,77,77,2634,537,1208,0.445,119,333,0.357,418,875,0.478,0.494,259,313,0.827,77,391,468,152,49,14,118,94,1452,Harrison Barnes
2018-2019,Total,PF,77,77,2533,431,1027,0.42,174,441,0.395,257,586,0.439,0.504,229,278,0.824,57,304,361,115,50,13,98,122,1265,Harrison Barnes
2018-2019,Dallas Mavericks,PF,49,49,1584,290,717,0.404,121,311,0.389,169,406,0.416,0.489,165,198,0.833,36,171,207,62,33,11,68,79,866,Harrison Barnes
2018-2019,Sacramento Kings,SF,28,28,949,141,310,0.455,53,130,0.408,88,180,0.489,0.54,64,80,0.8,21,133,154,53,17,2,30,43,399,Harrison Barnes
2019-2020,Sacramento Kings,PF,72,72,2482,365,793,0.46,102,268,0.381,263,525,0.501,0.525,214,267,0.801,77,278,355,159,43,12,88,93,1046,Harrison Barnes
2020-2021,Sacramento Kings,PF,58,58,2102,319,642,0.497,100,256,0.391,219,386,0.567,0.575,195,235,0.83,64,321,385,201,43,11,93,75,933,Harrison Barnes
2021-2022,Sacramento Kings,PF,77,77,2580,391,834,0.469,142,360,0.394,249,474,0.525,0.554,341,413,0.826,82,350,432,186,53,14,118,94,1265,Harrison Barnes
2022-2023,Sacramento Kings,PF,82,82,2662,374,791,0.473,132,353,0.374,242,438,0.553,0.556,350,413,0.847,87,279,366,128,57,10,86,103,1230,Harrison Barnes
2023-2024,Sacramento Kings,PF,82,82,2381,347,732,0.474,149,385,0.387,198,347,0.571,0.576,157,196,0.801,67,182,249,99,54,12,58,98,1000,Harrison Barnes
2024-2025,San Antonio Spurs,PF,31,31,853,105,225,0.467,42,105,0.4,63,120,0.525,0.56,66,84,0.786,47,71,118,47,9,6,22,25,318,Harrison Barnes
2021-2022,Toronto Raptors,PF,74,74,2617,459,932,0.492,58,193,0.301,401,739,0.543,0.524,158,215,0.735,195,362,557,256,80,55,136,192,1134,Scottie Barnes
2022-2023,Toronto Raptors,SF,77,76,2678,463,1016,0.456,63,224,0.281,400,792,0.505,0.487,190,246,0.772,179,333,512,371,83,61,154,170,1179,Scottie Barnes
2023-2024,Toronto Raptors,SG,60,60,2094,447,942,0.475,101,296,0.341,346,646,0.536,0.528,196,251,0.781,141,353,494,363,75,88,165,118,1191,Scottie Barnes
2024-2025,Toronto Raptors,PF,18,18,612,133,296,0.449,30,106,0.283,103,190,0.542,0.5,64,88,0.727,33,107,140,130,23,12,63,43,360,Scottie Barnes
2019-2020,New York Knicks,SG,56,55,1704,292,727,0.402,63,197,0.32,229,530,0.432,0.445,156,254,0.614,50,229,279,143,55,17,124,122,803,RJ Barrett
2020-2021,New York Knicks,SG,72,72,2511,467,1060,0.441,124,309,0.401,343,751,0.457,0.499,206,276,0.746,68,346,414,217,53,20,139,188,1264,RJ Barrett
2021-2022,New York Knicks,SF,70,70,2417,487,1194,0.408,138,404,0.342,349,790,0.442,0.466,290,406,0.714,66,342,408,208,43,16,151,142,1402,RJ Barrett
2022-2023,New York Knicks,SG,73,73,2475,510,1176,0.434,121,390,0.31,389,786,0.495,0.485,290,392,0.74,60,308,368,201,31,15,164,179,1431,RJ Barrett
2023-2024,Total,SG,58,58,1838,436,880,0.495,90,250,0.36,346,630,0.549,0.547,208,291,0.715,53,262,315,193,31,22,126,129,1170,RJ Barrett
2023-2024,New York Knicks,SG,26,26,766,164,388,0.423,43,130,0.331,121,258,0.469,0.478,103,124,0.831,19,92,111,63,12,9,47,45,474,RJ Barrett
2023-2024,Toronto Raptors,SG,32,32,1072,272,492,0.553,47,120,0.392,225,372,0.605,0.601,105,167,0.629,34,170,204,130,19,13,79,84,696,RJ Barrett
2024-2025,Toronto Raptors,SG,26,26,891,224,486,0.461,51,146,0.349,173,340,0.509,0.513,116,160,0.725,25,152,177,163,18,11,88,65,615,RJ Barrett
2021-2022,Phoenix Suns,SF,2,0,7,2,6,0.333,0,2,0,2,4,0.5,0.333,2,2,1,2,2,4,0,1,0,2,2,6,Paris Bass
2021-2022,Philadelphia 76ers,C,23,0,168,30,47,0.638,0,4,0,30,43,0.698,0.638,9,12,0.75,22,40,62,7,5,17,8,32,69,Charles Bassey
2022-2023,San Antonio Spurs,C,35,2,508,87,135,0.644,3,8,0.375,84,127,0.661,0.656,22,37,0.595,75,118,193,48,16,33,41,74,199,Charles Bassey
2023-2024,San Antonio Spurs,C,19,0,205,29,40,0.725,0,1,0,29,39,0.744,0.725,5,6,0.833,23,53,76,21,8,17,15,31,63,Charles Bassey
2024-2025,San Antonio Spurs,C,20,0,219,43,75,0.573,0,0,,43,75,0.573,0.573,13,23,0.565,32,56,88,9,7,22,15,27,99,Charles Bassey
2023-2024,Cleveland Cavaliers,SF,15,0,133,15,49,0.306,10,33,0.303,5,16,0.313,0.408,1,4,0.25,1,13,14,10,1,2,8,5,41,Emoni Bates
2018-2019,Minnesota Timberwolves,SF,30,3,503,60,142,0.423,13,52,0.25,47,90,0.522,0.468,18,28,0.643,16,67,83,17,18,14,14,29,151,Keita Bates-Diop
2019-2020,Total,SF,44,0,744,100,234,0.427,34,103,0.33,66,131,0.504,0.5,54,75,0.72,25,102,127,30,19,24,17,43,288,Keita Bates-Diop
2019-2020,Minnesota Timberwolves,PF,37,0,646,87,206,0.422,31,94,0.33,56,112,0.5,0.498,46,65,0.708,21,89,110,30,17,20,14,36,251,Keita Bates-Diop
2019-2020,Denver Nuggets,SF,7,0,98,13,28,0.464,3,9,0.333,10,19,0.526,0.518,8,10,0.8,4,13,17,0,2,4,3,7,37,Keita Bates-Diop
2020-2021,San Antonio Spurs,SF,30,0,245,30,67,0.448,5,17,0.294,25,50,0.5,0.485,14,21,0.667,9,40,49,12,11,5,7,11,79,Keita Bates-Diop
2021-2022,San Antonio Spurs,SF,59,14,957,136,263,0.517,17,55,0.309,119,208,0.572,0.549,46,61,0.754,62,169,231,41,27,14,45,61,335,Keita Bates-Diop
2022-2023,San Antonio Spurs,PF,67,42,1452,236,465,0.508,56,142,0.394,180,323,0.557,0.568,119,150,0.793,65,183,248,103,46,20,56,63,647,Keita Bates-Diop
2023-2024,Total,SF,53,8,665,72,166,0.434,21,69,0.304,51,97,0.526,0.497,32,42,0.762,31,79,110,38,25,22,15,35,197,Keita Bates-Diop
2023-2024,Phoenix Suns,SF,39,8,597,64,150,0.427,20,64,0.313,44,86,0.512,0.493,26,36,0.722,30,71,101,34,22,20,13,33,174,Keita Bates-Diop
2023-2024,Brooklyn Nets,SF,14,0,68,8,16,0.5,1,5,0.2,7,11,0.636,0.531,6,6,1,1,8,9,4,3,2,2,2,23,Keita Bates-Diop
2024-2025,Toronto Raptors,SF,28,0,391,59,124,0.476,39,93,0.419,20,31,0.645,0.633,12,14,0.857,16,38,54,28,4,4,11,34,169,Jamison Battle
2008-2009,Portland Trail Blazers,SF,79,76,1454,161,361,0.446,62,168,0.369,99,193,0.513,0.532,42,52,0.808,84,136,220,74,50,40,50,139,426,Nicolas Batum
2009-2010,Portland Trail Blazers,SF,37,25,918,139,268,0.519,54,132,0.409,85,136,0.625,0.619,43,51,0.843,32,109,141,44,24,25,27,83,375,Nicolas Batum
2010-2011,Portland Trail Blazers,SF,80,67,2522,367,807,0.455,118,342,0.345,249,465,0.535,0.528,138,164,0.841,109,252,361,123,68,49,83,194,990,Nicolas Batum
2011-2012,Portland Trail Blazers,SF,59,34,1791,289,641,0.451,107,274,0.391,182,367,0.496,0.534,133,159,0.836,81,190,271,84,57,60,90,105,818,Nicolas Batum
2012-2013,Portland Trail Blazers,SF,73,73,2807,352,833,0.423,165,444,0.372,187,389,0.481,0.522,178,210,0.848,97,315,412,360,91,83,190,139,1047,Nicolas Batum
2013-2014,Portland Trail Blazers,SF,82,82,2956,381,819,0.465,145,402,0.361,236,417,0.566,0.554,163,203,0.803,116,495,611,420,75,57,208,156,1070,Nicolas Batum
2014-2015,Portland Trail Blazers,SF,71,71,2380,240,600,0.4,100,309,0.324,140,291,0.481,0.483,84,98,0.857,62,354,416,341,78,40,132,106,664,Nicolas Batum
2015-2016,Charlotte Hornets,SF,70,70,2448,372,873,0.426,139,399,0.348,233,474,0.492,0.506,163,192,0.849,55,373,428,403,65,43,205,114,1046,Nicolas Batum
2016-2017,Charlotte Hornets,SG,77,77,2617,393,975,0.403,135,405,0.333,258,570,0.453,0.472,243,284,0.856,46,435,481,456,86,29,194,109,1164,Nicolas Batum
2017-2018,Charlotte Hornets,SG,64,64,1981,270,650,0.415,92,274,0.336,178,376,0.473,0.486,108,130,0.831,57,249,306,349,65,23,131,72,740,Nicolas Batum
2018-2019,Charlotte Hornets,SF,75,72,2354,253,562,0.45,116,298,0.389,137,264,0.519,0.553,77,89,0.865,71,319,390,247,71,43,117,140,699,Nicolas Batum
2019-2020,Charlotte Hornets,SF,22,3,505,28,81,0.346,14,49,0.286,14,32,0.438,0.432,9,10,0.9,25,75,100,66,17,8,22,41,79,Nicolas Batum
2020-2021,Los Angeles Clippers,SF,67,38,1835,191,412,0.464,110,272,0.404,81,140,0.579,0.597,48,58,0.828,50,266,316,148,69,37,53,102,540,Nicolas Batum
2021-2022,Los Angeles Clippers,PF,59,54,1463,179,387,0.463,108,270,0.4,71,117,0.607,0.602,25,38,0.658,29,225,254,100,58,42,40,80,491,Nicolas Batum
2022-2023,Los Angeles Clippers,PF,78,19,1709,160,381,0.42,124,317,0.391,36,64,0.563,0.583,34,48,0.708,62,237,299,121,54,44,50,149,478,Nicolas Batum
2023-2024,Total,PF,60,38,1529,116,256,0.453,73,185,0.395,43,71,0.606,0.596,15,21,0.714,70,178,248,128,48,38,40,109,320,Nicolas Batum
2023-2024,Los Angeles Clippers,PF,3,0,54,3,8,0.375,2,7,0.286,1,1,1,0.5,0,0,,0,7,7,5,3,4,1,5,8,Nicolas Batum
2023-2024,Philadelphia 76ers,PF,57,38,1475,113,248,0.456,71,178,0.399,42,70,0.6,0.599,15,21,0.714,70,171,241,123,45,34,39,104,312,Nicolas Batum
2024-2025,Los Angeles Clippers,PF,31,1,573,37,96,0.385,30,78,0.385,7,18,0.389,0.542,10,13,0.769,21,65,86,50,15,14,17,43,114,Nicolas Batum
2012-2013,Golden State Warriors,SG,61,0,267,43,116,0.371,10,34,0.294,33,82,0.402,0.414,27,44,0.614,5,17,22,22,17,4,18,27,123,Kent Bazemore
2013-2014,Total,SG,67,15,911,147,343,0.429,43,128,0.336,104,215,0.484,0.491,66,109,0.606,10,107,117,91,43,13,79,102,403,Kent Bazemore
2013-2014,Golden State Warriors,SG,44,0,268,36,97,0.371,10,39,0.256,26,58,0.448,0.423,19,36,0.528,5,35,40,20,12,6,28,42,101,Kent Bazemore
2013-2014,Los Angeles Lakers,SG,23,15,643,111,246,0.451,33,89,0.371,78,157,0.497,0.518,47,73,0.644,5,72,77,71,31,7,51,60,302,Kent Bazemore
2014-2015,Atlanta Hawks,SG,75,10,1324,141,331,0.426,48,132,0.364,93,199,0.467,0.498,60,100,0.6,21,201,222,78,52,33,73,127,390,Kent Bazemore
2015-2016,Atlanta Hawks,SF,75,68,2083,320,725,0.441,109,305,0.357,211,420,0.502,0.517,123,151,0.815,28,351,379,171,98,38,138,176,872,Kent Bazemore
2016-2017,Atlanta Hawks,SF,73,64,1963,295,721,0.409,92,266,0.346,203,455,0.446,0.473,119,168,0.708,45,186,231,177,91,52,125,165,801,Kent Bazemore
2017-2018,Atlanta Hawks,SG,65,65,1789,284,676,0.42,108,274,0.394,176,402,0.438,0.5,160,201,0.796,25,223,248,228,100,45,157,147,836,Kent Bazemore
2018-2019,Atlanta Hawks,SG,67,35,1643,278,691,0.402,96,300,0.32,182,391,0.465,0.472,127,175,0.726,37,224,261,152,89,42,121,170,779,Kent Bazemore
2019-2020,Total,SF,68,21,1688,200,534,0.375,84,244,0.344,116,290,0.4,0.453,113,147,0.769,27,267,294,93,74,40,91,196,597,Kent Bazemore
2019-2020,Portland Trail Blazers,SF,43,21,1111,113,326,0.347,56,171,0.327,57,155,0.368,0.433,58,72,0.806,13,159,172,61,45,31,60,121,340,Kent Bazemore
2019-2020,Sacramento Kings,SF,25,0,577,87,208,0.418,28,73,0.384,59,135,0.437,0.486,55,75,0.733,14,108,122,32,29,9,31,75,257,Kent Bazemore
2020-2021,Golden State Warriors,SF,67,18,1333,176,392,0.449,75,184,0.408,101,208,0.486,0.545,54,78,0.692,26,203,229,108,69,33,82,158,481,Kent Bazemore
2021-2022,Los Angeles Lakers,SF,39,14,545,45,139,0.324,29,80,0.363,16,59,0.271,0.428,13,17,0.765,13,56,69,34,25,9,21,70,132,Kent Bazemore
2019-2020,Oklahoma City Thunder,PF,61,9,1130,125,317,0.394,49,141,0.348,76,176,0.432,0.472,43,62,0.694,30,216,246,41,23,41,45,55,342,Darius Bazley
2020-2021,Oklahoma City Thunder,PF,55,55,1714,273,690,0.396,83,286,0.29,190,404,0.47,0.456,125,178,0.702,51,345,396,99,29,25,122,60,754,Darius Bazley
2021-2022,Oklahoma City Thunder,PF,69,53,1924,274,649,0.422,80,269,0.297,194,380,0.511,0.484,117,170,0.688,71,365,436,97,58,70,90,68,745,Darius Bazley
2022-2023,Total,C,43,1,616,83,183,0.454,20,53,0.377,63,130,0.485,0.508,38,70,0.543,34,104,138,38,22,34,27,44,224,Darius Bazley
2022-2023,Oklahoma City Thunder,C,36,1,555,71,158,0.449,18,45,0.4,53,113,0.469,0.506,36,65,0.554,29,93,122,32,19,29,22,35,196,Darius Bazley
2022-2023,Phoenix Suns,C,7,0,61,12,25,0.48,2,8,0.25,10,17,0.588,0.52,2,5,0.4,5,11,16,6,3,5,5,9,28,Darius Bazley
2023-2024,Total,PF,9,0,152,18,30,0.6,2,8,0.25,16,22,0.727,0.633,10,12,0.833,8,20,28,7,6,7,8,3,48,Darius Bazley
2023-2024,Philadelphia 76ers,PF,3,0,10,0,1,0,0,0,,0,1,0,0,0,0,,0,1,1,2,0,0,1,0,0,Darius Bazley
2023-2024,Utah Jazz,PF,6,0,142,18,29,0.621,2,8,0.25,16,21,0.762,0.655,10,12,0.833,8,19,27,5,6,7,7,3,48,Darius Bazley
2012-2013,Washington Wizards,SG,56,46,1745,282,687,0.41,91,236,0.386,191,451,0.424,0.477,125,159,0.786,43,168,211,137,50,29,90,113,780,Bradley Beal
2013-2014,Washington Wizards,SG,73,73,2530,481,1149,0.419,138,343,0.402,343,806,0.426,0.479,149,189,0.788,54,219,273,243,71,18,128,153,1249,Bradley Beal
2014-2015,Washington Wizards,SG,63,59,2107,363,851,0.427,106,259,0.409,257,592,0.434,0.489,130,166,0.783,57,184,241,194,76,18,123,136,962,Bradley Beal
2015-2016,Washington Wizards,SG,55,35,1708,359,799,0.449,105,271,0.387,254,528,0.481,0.515,135,176,0.767,41,147,188,162,54,11,112,117,958,Bradley Beal
2016-2017,Washington Wizards,SG,77,77,2684,637,1322,0.482,223,552,0.404,414,770,0.538,0.566,282,342,0.825,53,187,240,267,83,21,156,169,1779,Bradley Beal
2017-2018,Washington Wizards,SG,82,82,2977,683,1484,0.46,199,530,0.375,484,954,0.507,0.527,292,369,0.791,61,302,363,373,96,36,214,160,1857,Bradley Beal
2018-2019,Washington Wizards,SG,82,82,3028,764,1609,0.475,209,596,0.351,555,1013,0.548,0.54,362,448,0.808,89,322,411,448,121,58,224,226,2099,Bradley Beal
2019-2020,Washington Wizards,SG,57,57,2053,593,1303,0.455,170,481,0.353,423,822,0.515,0.52,385,457,0.842,52,190,242,347,71,23,194,126,1741,Bradley Beal
2020-2021,Washington Wizards,SG,60,60,2147,670,1382,0.485,130,373,0.349,540,1009,0.535,0.532,408,459,0.889,72,211,283,265,69,22,187,140,1878,Bradley Beal
2021-2022,Washington Wizards,SG,40,40,1439,348,771,0.451,63,210,0.3,285,561,0.508,0.492,169,203,0.833,38,151,189,265,36,15,135,95,928,Bradley Beal
2022-2023,Washington Wizards,SG,50,50,1673,444,878,0.506,80,219,0.365,364,659,0.552,0.551,192,228,0.842,41,155,196,271,45,33,145,107,1160,Bradley Beal
2023-2024,Phoenix Suns,SG,53,53,1767,377,735,0.513,101,235,0.43,276,500,0.552,0.582,109,134,0.813,54,178,232,265,52,27,131,127,964,Bradley Beal
2024-2025,Phoenix Suns,SG,20,20,683,144,292,0.493,45,115,0.391,99,177,0.559,0.57,37,48,0.771,15,61,76,64,24,14,48,56,370,Bradley Beal
2016-2017,Denver Nuggets,SG,22,1,165,33,73,0.452,9,28,0.321,24,45,0.533,0.514,8,10,0.8,5,12,17,11,7,0,8,10,83,Malik Beasley
2017-2018,Denver Nuggets,SG,62,0,583,73,178,0.41,28,82,0.341,45,96,0.469,0.489,22,33,0.667,14,57,71,31,15,7,24,36,196,Malik Beasley
2018-2019,Denver Nuggets,SG,81,18,1879,349,737,0.474,163,405,0.402,186,332,0.56,0.584,56,66,0.848,35,165,200,97,55,10,55,116,917,Malik Beasley
2019-2020,Total,SG,55,14,1209,227,534,0.425,107,276,0.388,120,258,0.465,0.525,54,66,0.818,18,130,148,75,40,8,57,77,615,Malik Beasley
2019-2020,Denver Nuggets,SG,41,0,746,117,301,0.389,58,161,0.36,59,140,0.421,0.485,33,38,0.868,9,68,77,48,31,6,36,50,325,Malik Beasley
2019-2020,Minnesota Timberwolves,SG,14,14,463,110,233,0.472,49,115,0.426,61,118,0.517,0.577,21,28,0.75,9,62,71,27,9,2,21,27,290,Malik Beasley
2020-2021,Minnesota Timberwolves,SG,37,36,1214,264,600,0.44,128,321,0.399,136,279,0.487,0.547,68,80,0.85,28,134,162,88,30,7,60,62,724,Malik Beasley
2021-2022,Minnesota Timberwolves,SG,79,18,1976,332,850,0.391,240,637,0.377,92,213,0.432,0.532,49,60,0.817,26,201,227,116,43,12,43,88,953,Malik Beasley
2022-2023,Total,SG,81,27,2093,370,937,0.395,235,658,0.357,135,279,0.484,0.52,50,65,0.769,35,248,283,124,65,9,90,107,1025,Malik Beasley
2022-2023,Utah Jazz,SG,55,13,1472,265,669,0.396,169,471,0.359,96,198,0.485,0.522,37,44,0.841,27,170,197,93,44,8,60,75,736,Malik Beasley
2022-2023,Los Angeles Lakers,SG,26,14,621,105,268,0.392,66,187,0.353,39,81,0.481,0.515,13,21,0.619,8,78,86,31,21,1,30,32,289,Malik Beasley
2023-2024,Milwaukee Bucks,SG,79,77,2337,320,722,0.443,224,542,0.413,96,180,0.533,0.598,25,35,0.714,41,249,290,108,59,9,54,158,889,Malik Beasley
2024-2025,Detroit Pistons,SG,31,8,882,182,420,0.433,122,290,0.421,60,130,0.462,0.579,33,46,0.717,17,78,95,59,25,2,32,40,519,Malik Beasley
2022-2023,Milwaukee Bucks,SF,52,11,701,96,243,0.395,47,142,0.331,49,101,0.485,0.492,27,37,0.73,38,77,115,35,21,7,45,71,266,MarJon Beauchamp
2023-2024,Milwaukee Bucks,SF,48,1,608,81,166,0.488,30,75,0.4,51,91,0.56,0.578,19,28,0.679,22,77,99,31,13,7,27,54,211,MarJon Beauchamp
2024-2025,Milwaukee Bucks,SF,14,0,53,9,22,0.409,3,11,0.273,6,11,0.545,0.477,5,6,0.833,2,11,13,2,1,0,11,4,26,MarJon Beauchamp
2024-2025,Total,PG,6,0,23,1,4,0.25,0,2,0,1,2,0.5,0.25,0,0,1,0,1,2,1,0,2,3,2,0,Reece Beekman
2024-2025,Golden State Warriors,PG,2,0,4,1,1,1,0,0,,1,1,1,1,0,0,1,0,1,1,1,0,0,1,2,0,Reece Beekman
2024-2025,Brooklyn Nets,PG,4,0,19,0,3,0,0,2,0,0,1,0,0,0,0,0,0,0,1,0,0,2,2,0,0,Reece Beekman
2017-2018,Golden State Warriors,C,57,13,809,116,185,0.627,0,4,0,116,181,0.641,0.627,30,44,0.682,60,147,207,102,35,56,51,92,262,Jordan Bell
2018-2019,Golden State Warriors,C,68,3,788,99,192,0.516,0,2,0,99,190,0.521,0.516,25,41,0.61,55,129,184,76,20,51,42,80,223,Jordan Bell
2019-2020,Total,C,29,0,256,35,67,0.522,4,12,0.333,31,55,0.564,0.552,19,31,0.613,30,51,81,16,3,10,21,19,93,Jordan Bell
2019-2020,Minnesota Timberwolves,C,27,0,235,32,60,0.533,2,9,0.222,30,51,0.588,0.55,17,29,0.586,28,50,78,14,2,10,18,17,83,Jordan Bell
2019-2020,Memphis Grizzlies,C,2,0,21,3,7,0.429,2,3,0.667,1,4,0.25,0.571,2,2,1,2,1,3,2,1,0,3,2,10,Jordan Bell
2020-2021,Total,C,6,1,82,7,22,0.318,0,2,0,7,20,0.35,0.318,1,2,0.5,7,17,24,7,3,5,4,7,15,Jordan Bell
2020-2021,Washington Wizards,C,5,1,67,7,20,0.35,0,2,0,7,18,0.389,0.35,0,0,,6,13,19,5,3,3,3,5,14,Jordan Bell
2020-2021,Golden State Warriors,C,1,0,15,0,2,0,0,0,,0,2,0,0,1,2,0.5,1,4,5,2,0,2,1,2,1,Jordan Bell
2021-2022,Chicago Bulls,C,1,0,2,0,0,,0,0,,0,0,,,0,0,,1,0,1,0,1,0,0,2,0,Jordan Bell
2016-2017,Atlanta Hawks,SF,38,1,371,47,98,0.48,1,18,0.056,46,80,0.575,0.485,6,16,0.375,14,45,59,28,8,5,16,21,101,DeAndre' Bembry
2017-2018,Atlanta Hawks,SF,26,3,455,53,128,0.414,11,30,0.367,42,98,0.429,0.457,19,33,0.576,8,64,72,49,21,12,47,38,136,DeAndre' Bembry
2018-2019,Atlanta Hawks,SG,82,15,1931,275,616,0.446,50,173,0.289,225,443,0.508,0.487,87,136,0.64,54,304,358,202,105,41,142,190,687,DeAndre' Bembry
2019-2020,Atlanta Hawks,SG,43,4,915,104,228,0.456,15,65,0.231,89,163,0.546,0.489,26,48,0.542,34,118,152,81,55,19,60,84,249,DeAndre' Bembry
2020-2021,Toronto Raptors,SF,51,12,972,117,228,0.513,14,53,0.264,103,175,0.589,0.544,45,66,0.682,33,113,146,107,53,18,71,87,293,DeAndre' Bembry
2021-2022,Total,SF,56,20,1026,124,221,0.561,15,36,0.417,109,185,0.589,0.595,21,35,0.6,42,121,163,66,49,25,31,113,284,DeAndre' Bembry
2021-2022,Brooklyn Nets,SF,48,20,949,121,213,0.568,15,36,0.417,106,177,0.599,0.603,21,35,0.6,38,114,152,60,47,25,30,104,278,DeAndre' Bembry
2021-2022,Milwaukee Bucks,SF,8,0,77,3,8,0.375,0,0,,3,8,0.375,0.375,0,0,,4,7,11,6,2,0,1,9,6,DeAndre' Bembry
2023-2024,Washington Wizards,SG,19,0,149,29,64,0.453,11,29,0.379,18,35,0.514,0.539,5,9,0.556,10,16,26,16,3,1,8,14,74,Jules Bernard
2016-2017,San Antonio Spurs,PF,67,6,808,103,234,0.44,69,173,0.399,34,61,0.557,0.588,28,34,0.824,22,76,98,46,20,28,32,75,303,Dāvis Bertāns
2017-2018,San Antonio Spurs,PF,77,10,1086,161,366,0.44,94,252,0.373,67,114,0.588,0.568,40,49,0.816,18,135,153,74,26,28,36,93,456,Dāvis Bertāns
2018-2019,San Antonio Spurs,PF,76,12,1632,204,453,0.45,145,338,0.429,59,115,0.513,0.61,53,60,0.883,23,241,264,100,35,33,43,133,606,Dāvis Bertāns
2019-2020,Washington Wizards,PF,54,4,1583,265,610,0.434,200,472,0.424,65,138,0.471,0.598,104,122,0.852,35,210,245,92,37,33,59,139,834,Dāvis Bertāns
2020-2021,Washington Wizards,PF,57,7,1464,193,478,0.404,169,428,0.395,24,50,0.48,0.581,100,115,0.87,18,150,168,49,33,13,33,136,655,Dāvis Bertāns
2021-2022,Total,PF,56,0,807,99,275,0.36,77,230,0.335,22,45,0.489,0.5,36,40,0.9,12,105,117,31,17,12,19,85,311,Dāvis Bertāns
2021-2022,Washington Wizards,PF,34,0,501,60,171,0.351,46,144,0.319,14,27,0.519,0.485,28,30,0.933,6,55,61,16,11,6,14,55,194,Dāvis Bertāns
2021-2022,Dallas Mavericks,PF,22,0,306,39,104,0.375,31,86,0.36,8,18,0.444,0.524,8,10,0.8,6,50,56,15,6,6,5,30,117,Dāvis Bertāns
2022-2023,Dallas Mavericks,PF,45,1,492,69,160,0.431,55,141,0.39,14,19,0.737,0.603,13,15,0.867,10,43,53,21,11,8,10,53,206,Dāvis Bertāns
2023-2024,Total,PF,43,1,674,92,234,0.393,76,200,0.38,16,34,0.471,0.556,30,33,0.909,9,52,61,35,26,12,18,56,290,Dāvis Bertāns
2023-2024,Oklahoma City Thunder,PF,15,0,91,10,26,0.385,10,24,0.417,0,2,0,0.577,14,15,0.933,2,8,10,9,3,3,1,10,44,Dāvis Bertāns
2023-2024,Charlotte Hornets,PF,28,1,583,82,208,0.394,66,176,0.375,16,32,0.5,0.553,16,18,0.889,7,44,51,26,23,9,17,46,246,Dāvis Bertāns
2012-2013,Houston Rockets,PG,41,0,713,79,189,0.418,36,96,0.375,43,93,0.462,0.513,34,41,0.829,45,64,109,117,37,21,44,83,228,Patrick Beverley
2013-2014,Houston Rockets,PG,56,55,1751,199,481,0.414,92,255,0.361,107,226,0.473,0.509,83,102,0.814,72,124,196,151,77,23,66,174,573,Patrick Beverley
2014-2015,Houston Rockets,PG,56,55,1727,204,532,0.383,115,323,0.356,89,209,0.426,0.492,45,60,0.75,67,170,237,192,59,23,83,182,568,Patrick Beverley
2015-2016,Houston Rockets,PG,71,63,2041,258,594,0.434,124,310,0.4,134,284,0.472,0.539,60,88,0.682,73,177,250,239,94,26,91,234,700,Patrick Beverley
2016-2017,Houston Rockets,SG,67,67,2058,228,543,0.42,110,288,0.382,118,255,0.463,0.521,73,95,0.768,95,298,393,281,99,25,100,222,639,Patrick Beverley
2017-2018,Los Angeles Clippers,SG,11,11,334,48,119,0.403,24,60,0.4,24,59,0.407,0.504,14,17,0.824,16,29,45,32,19,5,25,34,134,Patrick Beverley
2018-2019,Los Angeles Clippers,PG,78,49,2137,194,477,0.407,112,282,0.397,82,195,0.421,0.524,96,123,0.78,76,312,388,300,67,43,85,265,596,Patrick Beverley
2019-2020,Los Angeles Clippers,PG,51,50,1342,147,341,0.431,80,206,0.388,67,135,0.496,0.548,31,47,0.66,57,209,266,183,54,25,66,156,405,Patrick Beverley
2020-2021,Los Angeles Clippers,PG,37,34,832,93,220,0.423,56,141,0.397,37,79,0.468,0.55,36,45,0.8,29,90,119,76,29,28,34,108,278,Patrick Beverley
2021-2022,Minnesota Timberwolves,PG,58,54,1476,177,436,0.406,83,242,0.343,94,194,0.485,0.501,96,133,0.722,62,178,240,268,67,52,73,174,533,Patrick Beverley
2022-2023,Total,PG,67,67,1816,144,360,0.4,80,239,0.335,64,121,0.529,0.511,47,65,0.723,44,203,247,194,63,41,60,187,415,Patrick Beverley
2022-2023,Los Angeles Lakers,SG,45,45,1211,97,241,0.402,55,158,0.348,42,83,0.506,0.517,39,50,0.78,24,116,140,118,40,25,42,124,288,Patrick Beverley
2022-2023,Chicago Bulls,PG,22,22,605,47,119,0.395,25,81,0.309,22,38,0.579,0.5,8,15,0.533,20,87,107,76,23,16,18,63,127,Patrick Beverley
2023-2024,Total,PG,73,13,1462,158,379,0.417,61,181,0.337,97,198,0.49,0.497,74,90,0.822,49,190,239,212,43,31,65,128,451,Patrick Beverley
2023-2024,Philadelphia 76ers,PG,47,5,919,104,241,0.432,35,109,0.321,69,132,0.523,0.504,51,63,0.81,30,115,145,144,24,18,49,83,294,Patrick Beverley
2023-2024,Milwaukee Bucks,PG,26,8,543,54,138,0.391,26,72,0.361,28,66,0.424,0.486,23,27,0.852,19,75,94,68,19,13,16,45,157,Patrick Beverley
2020-2021,Detroit Pistons,SF,70,53,1909,279,691,0.404,175,460,0.38,104,231,0.45,0.53,124,147,0.844,43,275,318,95,52,14,60,110,857,Saddiq Bey
2021-2022,Detroit Pistons,SF,82,82,2704,450,1136,0.396,211,610,0.346,239,526,0.454,0.489,210,254,0.827,107,334,441,233,73,16,96,128,1321,Saddiq Bey
2022-2023,Total,SF,77,37,2129,353,836,0.422,151,418,0.361,202,418,0.483,0.513,205,238,0.861,98,264,362,118,70,13,71,123,1062,Saddiq Bey
2022-2023,Detroit Pistons,SF,52,30,1500,245,606,0.404,101,293,0.345,144,313,0.46,0.488,180,209,0.861,59,183,242,84,50,12,54,86,771,Saddiq Bey
2022-2023,Atlanta Hawks,SF,25,7,629,108,230,0.47,50,125,0.4,58,105,0.552,0.578,25,29,0.862,39,81,120,34,20,1,17,37,291,Saddiq Bey
2023-2024,Atlanta Hawks,SF,63,51,2062,290,697,0.416,113,358,0.316,177,339,0.522,0.497,170,203,0.837,167,244,411,92,51,11,54,88,863,Saddiq Bey
2020-2021,Dallas Mavericks,SF,18,0,71,7,22,0.318,1,4,0.25,6,18,0.333,0.341,3,5,0.6,8,11,19,3,0,1,3,6,18,Tyler Bey
2017-2018,Orlando Magic,C,42,0,578,68,126,0.54,0,0,,68,126,0.54,0.54,42,61,0.689,70,110,180,34,15,21,21,56,178,Khem Birch
2018-2019,Orlando Magic,C,50,1,643,91,151,0.603,0,1,0,91,150,0.607,0.603,58,83,0.699,79,111,190,38,18,29,20,72,240,Khem Birch
2019-2020,Orlando Magic,C,48,24,922,73,143,0.51,0,1,0,73,142,0.514,0.51,66,101,0.653,91,129,220,50,20,23,31,91,212,Khem Birch
2020-2021,Total,C,67,22,1529,189,380,0.497,13,52,0.25,176,328,0.537,0.514,91,129,0.705,174,213,387,89,48,50,44,113,482,Khem Birch
2020-2021,Orlando Magic,C,48,5,952,94,209,0.45,4,21,0.19,90,188,0.479,0.459,63,85,0.741,117,126,243,53,32,28,23,67,255,Khem Birch
2020-2021,Toronto Raptors,C,19,17,577,95,171,0.556,9,31,0.29,86,140,0.614,0.582,28,44,0.636,57,87,144,36,16,22,21,46,227,Khem Birch
2021-2022,Toronto Raptors,C,55,28,991,97,200,0.485,0,14,0,97,186,0.522,0.485,53,71,0.746,122,117,239,56,30,26,29,104,247,Khem Birch
2022-2023,Toronto Raptors,C,20,0,162,19,32,0.594,1,2,0.5,18,30,0.6,0.609,4,5,0.8,8,17,25,7,5,5,8,24,43,Khem Birch
2019-2020,Indiana Pacers,C,54,2,471,70,150,0.467,8,42,0.19,62,108,0.574,0.493,24,33,0.727,25,81,106,23,10,37,28,65,172,Goga Bitadze
2020-2021,Indiana Pacers,C,45,3,561,83,194,0.428,20,79,0.253,63,115,0.548,0.479,45,61,0.738,60,90,150,37,9,60,17,94,231,Goga Bitadze
2021-2022,Indiana Pacers,C,50,16,729,131,252,0.52,23,80,0.288,108,172,0.628,0.565,64,94,0.681,79,98,177,55,21,42,46,107,349,Goga Bitadze
2022-2023,Total,C,38,1,457,69,125,0.552,6,26,0.231,63,99,0.636,0.576,23,42,0.548,61,76,137,39,16,26,22,64,167,Goga Bitadze
2022-2023,Indiana Pacers,C,21,0,202,27,52,0.519,4,14,0.286,23,38,0.605,0.558,11,24,0.458,25,24,49,18,9,10,12,34,69,Goga Bitadze
2022-2023,Orlando Magic,C,17,1,255,42,73,0.575,2,12,0.167,40,61,0.656,0.589,12,18,0.667,36,52,88,21,7,16,10,30,98,Goga Bitadze
2023-2024,Orlando Magic,C,62,33,957,126,209,0.603,2,14,0.143,124,195,0.636,0.608,57,87,0.655,109,177,286,79,32,72,44,107,311,Goga Bitadze
2024-2025,Orlando Magic,C,28,25,684,114,176,0.648,1,13,0.077,113,163,0.693,0.651,40,53,0.755,84,151,235,56,24,47,43,69,269,Goga Bitadze
2023-2024,Chicago Bulls,SG,23,1,268,32,84,0.381,12,44,0.273,20,40,0.5,0.452,4,5,0.8,6,26,32,13,3,2,10,24,80,Onuralp Bitim
2011-2012,Charlotte Hornets,C,63,41,1455,129,278,0.464,0,0,,129,278,0.464,0.464,69,143,0.483,113,255,368,27,20,115,71,145,327,Bismack Biyombo
2012-2013,Charlotte Hornets,C,80,65,2186,156,346,0.451,0,0,,156,346,0.451,0.451,74,142,0.521,194,388,582,35,28,143,82,195,386,Bismack Biyombo
2013-2014,Charlotte Hornets,C,77,9,1072,88,144,0.611,0,0,,88,144,0.611,0.611,46,89,0.517,105,261,366,8,7,86,40,124,222,Bismack Biyombo
2014-2015,Charlotte Hornets,C,64,21,1243,101,186,0.543,0,0,,101,186,0.543,0.543,102,175,0.583,159,248,407,16,18,99,52,140,304,Bismack Biyombo
2015-2016,Toronto Raptors,C,82,22,1808,156,288,0.542,0,1,0,156,287,0.544,0.542,142,226,0.628,182,473,655,29,19,133,71,225,454,Bismack Biyombo
2016-2017,Orlando Magic,C,81,27,1793,179,339,0.528,0,0,,179,339,0.528,0.528,125,234,0.534,157,410,567,74,25,91,95,202,483,Bismack Biyombo
2017-2018,Orlando Magic,C,82,25,1495,183,352,0.52,0,1,0,183,351,0.521,0.52,102,157,0.65,144,324,468,66,21,95,84,158,468,Bismack Biyombo
2018-2019,Charlotte Hornets,C,54,32,783,89,156,0.571,0,0,,89,156,0.571,0.571,58,91,0.637,81,166,247,33,11,41,34,103,236,Bismack Biyombo
2019-2020,Charlotte Hornets,C,53,29,1029,151,278,0.543,0,0,,151,278,0.543,0.543,91,151,0.603,120,188,308,50,10,49,48,116,393,Bismack Biyombo
2020-2021,Charlotte Hornets,C,66,36,1349,142,242,0.587,0,1,0,142,241,0.589,0.587,47,105,0.448,137,210,347,81,17,74,71,141,331,Bismack Biyombo
2021-2022,Phoenix Suns,C,36,3,506,86,145,0.593,0,0,,86,145,0.593,0.593,38,71,0.535,63,104,167,23,12,26,25,70,210,Bismack Biyombo
2022-2023,Phoenix Suns,C,61,14,874,119,206,0.578,0,0,,119,206,0.578,0.578,25,70,0.357,89,171,260,56,18,88,51,114,263,Bismack Biyombo
2023-2024,Total,C,40,27,791,74,131,0.565,0,0,,74,131,0.565,0.565,26,54,0.481,62,147,209,53,11,37,42,89,174,Bismack Biyombo
2023-2024,Memphis Grizzlies,C,30,27,718,67,119,0.563,0,0,,67,119,0.563,0.563,22,46,0.478,57,134,191,51,10,34,38,82,156,Bismack Biyombo
2023-2024,Oklahoma City Thunder,C,10,0,73,7,12,0.583,0,0,,7,12,0.583,0.583,4,8,0.5,5,13,18,2,1,3,4,7,18,Bismack Biyombo
2023-2024,Orlando Magic,PG,69,33,1164,115,247,0.466,37,94,0.394,78,153,0.51,0.54,49,80,0.613,33,106,139,91,35,21,56,110,316,Anthony Black
2024-2025,Orlando Magic,PG,33,3,791,98,238,0.412,21,79,0.266,77,159,0.484,0.456,64,85,0.753,19,70,89,117,30,22,73,75,281,Anthony Black
2023-2024,Charlotte Hornets,SF,26,3,284,25,52,0.481,9,20,0.45,16,32,0.5,0.567,10,15,0.667,9,39,48,24,8,11,6,19,69,Leaky Black
2022-2023,Detroit Pistons,SF,10,0,90,5,27,0.185,4,25,0.16,1,2,0.5,0.259,2,2,1,2,4,6,4,2,0,0,6,16,Buddy Boeheim
2023-2024,Detroit Pistons,SF,10,0,84,9,29,0.31,8,25,0.32,1,4,0.25,0.448,8,10,0.8,3,7,10,3,0,1,0,5,34,Buddy Boeheim
2017-2018,Sacramento Kings,SG,78,52,2175,344,772,0.446,129,329,0.392,215,443,0.485,0.529,100,119,0.84,31,192,223,258,72,16,125,172,917,Bogdan Bogdanović
2018-2019,Sacramento Kings,SG,70,17,1947,361,863,0.418,134,372,0.36,227,491,0.462,0.496,134,162,0.827,40,203,243,267,72,15,117,142,990,Bogdan Bogdanović
2019-2020,Sacramento Kings,SG,61,28,1766,337,766,0.44,164,441,0.372,173,325,0.532,0.547,86,116,0.741,26,181,207,207,64,15,102,133,924,Bogdan Bogdanović
2020-2021,Atlanta Hawks,SG,44,27,1305,267,565,0.473,146,333,0.438,121,232,0.522,0.602,40,44,0.909,20,140,160,147,49,13,54,99,720,Bogdan Bogdanović
2021-2022,Atlanta Hawks,SG,63,27,1848,342,794,0.431,169,459,0.368,173,335,0.516,0.537,97,115,0.843,29,221,250,194,68,14,70,132,950,Bogdan Bogdanović
2022-2023,Atlanta Hawks,SG,54,9,1508,273,611,0.447,146,360,0.406,127,251,0.506,0.566,64,77,0.831,23,142,165,150,43,18,65,86,756,Bogdan Bogdanović
2023-2024,Atlanta Hawks,SG,79,33,2401,471,1100,0.428,240,641,0.374,231,459,0.503,0.537,151,164,0.921,53,219,272,247,96,26,112,179,1333,Bogdan Bogdanović
2024-2025,Atlanta Hawks,SG,14,0,356,54,133,0.406,30,89,0.337,24,44,0.545,0.519,20,21,0.952,9,35,44,31,12,4,25,36,158,Bogdan Bogdanović
2014-2015,Brooklyn Nets,SF,78,28,1854,261,576,0.453,91,256,0.355,170,320,0.531,0.532,87,106,0.821,50,163,213,68,34,9,78,104,700,Bojan Bogdanović
2015-2016,Brooklyn Nets,SF,79,39,2115,324,749,0.433,129,338,0.382,195,411,0.474,0.519,110,132,0.833,36,219,255,99,29,5,115,119,887,Bojan Bogdanović
2016-2017,Total,SF,81,54,2083,376,845,0.445,144,392,0.367,232,453,0.512,0.53,217,243,0.893,37,240,277,111,34,7,131,146,1113,Bojan Bogdanović
2016-2017,Brooklyn Nets,SF,55,54,1482,269,611,0.44,99,277,0.357,170,334,0.509,0.521,146,167,0.874,23,174,197,90,24,3,93,99,783,Bojan Bogdanović
2016-2017,Washington Wizards,SF,26,0,601,107,234,0.457,45,115,0.391,62,119,0.521,0.553,71,76,0.934,14,66,80,21,10,4,38,47,330,Bojan Bogdanović
2017-2018,Indiana Pacers,SF,80,80,2464,404,852,0.474,155,386,0.402,249,466,0.534,0.565,178,205,0.868,30,240,270,119,55,8,106,129,1141,Bojan Bogdanović
2018-2019,Indiana Pacers,SF,81,81,2573,522,1051,0.497,164,386,0.425,358,665,0.538,0.575,246,305,0.807,33,300,333,161,69,1,134,138,1454,Bojan Bogdanović
2019-2020,Utah Jazz,SF,63,63,2083,418,935,0.447,189,457,0.414,229,478,0.479,0.548,250,277,0.903,39,220,259,131,34,7,159,110,1275,Bojan Bogdanović
2020-2021,Utah Jazz,SF,72,72,2216,406,925,0.439,180,461,0.39,226,464,0.487,0.536,233,265,0.879,40,241,281,136,45,4,128,115,1225,Bojan Bogdanović
2021-2022,Utah Jazz,PF,69,69,2131,422,928,0.455,181,468,0.387,241,460,0.524,0.552,223,260,0.858,58,238,296,120,34,1,118,116,1248,Bojan Bogdanović
2022-2023,Detroit Pistons,PF,59,59,1893,430,882,0.488,145,353,0.411,285,529,0.539,0.57,268,303,0.884,36,187,223,152,34,8,135,113,1273,Bojan Bogdanović
2023-2024,Total,PF,57,27,1478,309,681,0.454,133,334,0.398,176,347,0.507,0.551,117,149,0.785,22,130,152,97,30,5,101,95,868,Bojan Bogdanović
2023-2024,Detroit Pistons,PF,28,27,921,199,425,0.468,86,207,0.415,113,218,0.518,0.569,81,104,0.779,13,81,94,71,23,4,63,57,565,Bojan Bogdanović
2023-2024,New York Knicks,SF,29,0,557,110,256,0.43,47,127,0.37,63,129,0.488,0.521,36,45,0.8,9,49,58,26,7,1,38,38,303,Bojan Bogdanović
2019-2020,Denver Nuggets,PF,7,0,87,14,28,0.5,4,9,0.444,10,19,0.526,0.571,8,10,0.8,5,14,19,6,2,6,10,11,40,Bol Bol
2020-2021,Denver Nuggets,PF,32,2,160,25,58,0.431,9,24,0.375,16,34,0.471,0.509,10,15,0.667,0,24,24,7,3,10,13,14,69,Bol Bol
2021-2022,Denver Nuggets,PF,14,0,81,15,27,0.556,1,4,0.25,14,23,0.609,0.574,2,5,0.4,4,16,20,5,1,2,4,4,33,Bol Bol
2022-2023,Orlando Magic,PF,70,33,1505,261,478,0.546,30,113,0.265,231,365,0.633,0.577,82,108,0.759,69,336,405,69,30,85,112,92,634,Bol Bol
2023-2024,Phoenix Suns,PF,43,0,469,93,151,0.616,22,52,0.423,71,99,0.717,0.689,15,19,0.789,32,105,137,17,10,25,19,42,223,Bol Bol
2024-2025,Phoenix Suns,PF,7,0,37,9,15,0.6,1,5,0.2,8,10,0.8,0.633,4,6,0.667,4,7,11,1,0,0,3,1,23,Bol Bol
2019-2020,Cleveland Cavaliers,C,1,0,3,0,0,,0,0,,0,0,,,0,0,,0,2,2,0,1,0,0,1,0,Marques Bolden
2020-2021,Cleveland Cavaliers,C,6,0,29,1,3,0.333,0,0,,1,3,0.333,0.333,5,8,0.625,3,3,6,0,2,2,2,0,7,Marques Bolden
2023-2024,Total,C,11,2,121,17,25,0.68,0,1,0,17,24,0.708,0.68,3,4,0.75,10,24,34,4,3,7,3,10,37,Marques Bolden
2023-2024,Milwaukee Bucks,C,2,0,3,0,0,,0,0,,0,0,,,0,0,,0,2,2,0,0,0,0,1,0,Marques Bolden
2023-2024,Charlotte Hornets,C,9,2,118,17,25,0.68,0,1,0,17,24,0.708,0.68,3,4,0.75,10,22,32,4,3,7,3,9,37,Marques Bolden
2021-2022,Minnesota Timberwolves,SF,35,2,241,17,54,0.315,5,18,0.278,12,36,0.333,0.361,11,13,0.846,16,27,43,21,6,0,13,26,50,Leandro Bolmaro
2022-2023,Utah Jazz,SF,14,0,68,3,20,0.15,0,4,0,3,16,0.188,0.15,0,0,,4,3,7,7,3,1,7,10,6,Leandro Bolmaro
2024-2025,Philadelphia 76ers,C,15,0,102,9,14,0.643,0,0,9,14,0.643,0.643,6,7,0.857,9,18,27,1,0,6,6,16,24,0,Adem Bona
2019-2020,Detroit Pistons,PG,10,0,53,5,20,0.25,2,10,0.2,3,10,0.3,0.3,0,0,0,4,4,8,1,0,2,6,12,0,Jordan Bone
2020-2021,Orlando Magic,PG,14,0,196,23,54,0.426,10,32,0.313,13,22,0.591,0.519,0,0,4,20,24,18,2,0,3,11,56,0,Jordan Bone
2015-2016,Phoenix Suns,SG,76,51,2108,367,867,0.423,99,289,0.343,268,578,0.464,0.48,215,256,0.84,27,160,187,200,44,20,160,225,1048,Devin Booker
2016-2017,Phoenix Suns,SG,78,78,2730,606,1431,0.423,147,405,0.363,459,1026,0.447,0.475,367,441,0.832,46,203,249,268,72,21,241,242,1726,Devin Booker
2017-2018,Phoenix Suns,SG,54,54,1865,455,1054,0.432,147,384,0.383,308,670,0.46,0.501,289,329,0.878,26,218,244,253,47,14,194,168,1346,Devin Booker
2018-2019,Phoenix Suns,SG,64,64,2242,586,1255,0.467,135,414,0.326,451,841,0.536,0.521,393,454,0.866,39,226,265,433,56,13,264,200,1700,Devin Booker
2019-2020,Phoenix Suns,SG,70,70,2512,627,1283,0.489,141,398,0.354,486,885,0.549,0.544,468,509,0.919,29,268,297,456,49,18,264,213,1863,Devin Booker
2020-2021,Phoenix Suns,SG,67,67,2270,623,1287,0.484,126,371,0.34,497,916,0.543,0.533,340,392,0.867,34,247,281,289,53,16,207,181,1712,Devin Booker
2021-2022,Phoenix Suns,SG,68,68,2345,662,1421,0.466,183,478,0.383,479,943,0.508,0.53,315,363,0.868,45,297,342,329,77,26,162,180,1822,Devin Booker
2022-2023,Phoenix Suns,SG,53,53,1835,527,1067,0.494,111,316,0.351,416,751,0.554,0.546,306,358,0.855,46,194,240,293,51,18,145,159,1471,Devin Booker
2023-2024,Phoenix Suns,PG,68,68,2447,642,1305,0.492,152,418,0.364,490,887,0.552,0.55,405,457,0.886,56,252,308,472,61,28,178,206,1841,Devin Booker
2024-2025,Phoenix Suns,SG,26,26,951,207,472,0.439,69,200,0.345,138,272,0.507,0.512,169,188,0.899,30,65,95,166,29,9,59,57,652,Devin Booker
2021-2022,Los Angeles Clippers,SG,51,0,760,125,325,0.385,34,111,0.306,91,214,0.425,0.437,59,72,0.819,17,94,111,51,26,13,31,43,343,Brandon Boston Jr.
2022-2023,Los Angeles Clippers,SF,22,1,248,51,122,0.418,12,29,0.414,39,93,0.419,0.467,29,38,0.763,7,23,30,20,9,0,12,21,143,Brandon Boston Jr.
2023-2024,Los Angeles Clippers,SF,32,0,345,65,161,0.404,14,52,0.269,51,109,0.468,0.447,23,33,0.697,19,33,52,13,11,8,24,40,167,Brandon Boston Jr.
2024-2025,New Orleans Pelicans,SG,29,10,748,128,289,0.443,37,106,0.349,91,183,0.497,0.507,49,61,0.803,18,81,99,82,43,7,42,51,342,Brandon Boston Jr.
2017-2018,Golden State Warriors,PF,1,0,1,0,1,0,0,1,0,0,0,,0,0,0,,0,1,1,0,0,0,0,0,0,Chris Boucher
2018-2019,Toronto Raptors,PF,28,0,163,34,76,0.447,12,37,0.324,22,39,0.564,0.526,13,15,0.867,16,40,56,2,6,24,7,31,93,Chris Boucher
2019-2020,Toronto Raptors,C,62,0,819,141,299,0.472,38,118,0.322,103,181,0.569,0.535,91,116,0.784,107,170,277,26,22,61,28,114,411,Chris Boucher
2020-2021,Toronto Raptors,C,60,14,1453,288,560,0.514,90,235,0.383,198,325,0.609,0.595,152,193,0.788,117,287,404,63,35,111,46,166,818,Chris Boucher
2021-2022,Toronto Raptors,SF,80,9,1690,268,577,0.464,68,229,0.297,200,348,0.575,0.523,150,193,0.777,179,315,494,25,49,75,42,174,754,Chris Boucher
2022-2023,Toronto Raptors,PF,76,0,1523,261,529,0.493,62,189,0.328,199,340,0.585,0.552,128,168,0.762,157,264,421,29,47,64,41,143,712,Chris Boucher
2023-2024,Toronto Raptors,PF,50,0,705,110,217,0.507,31,94,0.33,79,123,0.642,0.578,71,92,0.772,62,145,207,23,14,24,28,68,322,Chris Boucher
2024-2025,Toronto Raptors,PF,28,0,512,105,225,0.467,33,109,0.303,72,116,0.621,0.54,46,60,0.767,40,85,125,20,17,20,21,41,289,Chris Boucher
2021-2022,Charlotte Hornets,SG,31,0,304,49,141,0.348,17,49,0.347,32,92,0.348,0.408,27,31,0.871,22,30,52,26,7,1,15,29,142,James Bouknight
2022-2023,Charlotte Hornets,SG,34,0,515,69,193,0.358,33,109,0.303,36,84,0.429,0.443,20,30,0.667,8,64,72,41,14,5,32,49,191,James Bouknight
2023-2024,Charlotte Hornets,SG,14,0,81,18,41,0.439,13,30,0.433,5,11,0.455,0.598,1,2,0.5,1,8,9,6,1,1,2,3,50,James Bouknight
2022-2023,Total,PG,5,0,71,6,14,0.429,2,6,0.333,4,8,0.5,0.5,1,2,0.5,1,5,6,4,4,2,4,6,15,Jamaree Bouyea
2022-2023,Miami Heat,PG,4,0,65,6,13,0.462,2,5,0.4,4,8,0.5,0.538,1,2,0.5,1,4,5,4,4,2,4,5,15,Jamaree Bouyea
2022-2023,Washington Wizards,PG,1,0,6,0,1,0,0,1,0,0,0,,0,0,0,,0,1,1,0,0,0,0,1,0,Jamaree Bouyea
2023-2024,Total,PG,9,0,95,10,28,0.357,1,9,0.111,9,19,0.474,0.375,0,0,,3,16,19,11,1,0,9,10,21,Jamaree Bouyea
2023-2024,Portland Trail Blazers,PG,6,0,57,5,21,0.238,0,8,0,5,13,0.385,0.238,0,0,,2,8,10,8,0,0,8,3,10,Jamaree Bouyea
2023-2024,San Antonio Spurs,PG,3,0,38,5,7,0.714,1,1,1,4,6,0.667,0.786,0,0,,1,8,9,3,1,0,1,7,11,Jamaree Bouyea
2019-2020,Golden State Warriors,PG,45,12,1015,134,321,0.417,33,107,0.308,101,214,0.472,0.469,34,41,0.829,24,97,121,131,44,10,70,102,335,Ky Bowman
2017-2018,Utah Jazz,C,9,0,29,3,11,0.273,0,1,0,3,10,0.3,0.273,2,2,1,4,7,11,1,0,0,0,1,8,Tony Bradley
2018-2019,Utah Jazz,C,3,0,36,8,16,0.5,0,0,,8,16,0.5,0.5,1,2,0.5,9,6,15,1,2,2,3,6,17,Tony Bradley
2019-2020,Utah Jazz,C,58,3,663,126,189,0.667,3,3,1,123,186,0.661,0.675,30,46,0.652,111,156,267,23,14,33,30,115,285,Tony Bradley
2020-2021,Total,C,42,8,684,131,197,0.665,0,3,0,131,194,0.675,0.665,38,55,0.691,85,154,239,37,15,30,33,61,300,Tony Bradley
2020-2021,Philadelphia 76ers,C,20,8,287,51,75,0.68,0,1,0,51,74,0.689,0.68,7,11,0.636,39,65,104,17,6,13,6,28,109,Tony Bradley
2020-2021,Oklahoma City Thunder,C,22,0,397,80,122,0.656,0,2,0,80,120,0.667,0.656,31,44,0.705,46,89,135,20,9,17,27,33,191,Tony Bradley
2021-2022,Chicago Bulls,C,55,7,549,72,123,0.585,0,0,,72,123,0.585,0.585,19,29,0.655,67,119,186,27,10,33,34,62,163,Tony Bradley
2022-2023,Chicago Bulls,C,12,0,33,6,12,0.5,3,5,0.6,3,7,0.429,0.625,4,4,1,1,10,11,1,1,1,1,2,19,Tony Bradley
2022-2023,San Antonio Spurs,SG,66,32,1550,269,611,0.44,77,255,0.302,192,356,0.539,0.503,58,70,0.829,28,153,181,127,33,7,76,115,673,Malaki Branham
2023-2024,San Antonio Spurs,PG,75,29,1594,271,628,0.432,93,268,0.347,178,360,0.494,0.506,55,63,0.873,28,120,148,156,27,8,91,94,690,Malaki Branham
2024-2025,San Antonio Spurs,SG,21,0,254,44,101,0.436,17,44,0.386,27,57,0.474,0.52,17,20,0.85,3,27,30,26,7,2,26,14,122,Malaki Branham
2019-2020,Utah Jazz,PF,9,0,96,10,28,0.357,3,13,0.231,7,15,0.467,0.411,1,2,0.5,2,18,20,11,3,5,7,7,24,Jarrell Brantley
2020-2021,Utah Jazz,PF,28,0,138,25,52,0.481,12,28,0.429,13,24,0.542,0.596,2,2,1,9,18,27,15,7,2,8,17,64,Jarrell Brantley
2022-2023,Utah Jazz,PF,4,0,39,8,14,0.571,4,9,0.444,4,5,0.8,0.714,2,2,1,1,5,6,3,0,2,2,3,22,Jarrell Brantley
2022-2023,Denver Nuggets,SG,76,6,1181,143,289,0.495,34,96,0.354,109,193,0.565,0.554,40,64,0.625,48,133,181,59,41,17,35,101,360,Christian Braun
2023-2024,Denver Nuggets,SG,82,4,1655,222,483,0.46,63,164,0.384,159,319,0.498,0.525,93,134,0.694,79,227,306,132,42,35,55,137,600,Christian Braun
2024-2025,Denver Nuggets,SG,28,28,946,151,274,0.551,28,74,0.378,123,200,0.615,0.602,64,82,0.78,35,103,138,56,34,16,36,62,394,Christian Braun
2019-2020,New York Knicks,SF,9,0,53,6,22,0.273,1,9,0.111,5,13,0.385,0.295,4,5,0.8,2,3,5,4,0,1,2,3,17,Ignas Brazdeikis
2020-2021,Total,SF,13,0,249,35,83,0.422,11,28,0.393,24,55,0.436,0.488,10,14,0.714,11,34,45,17,4,3,12,22,91,Ignas Brazdeikis
2020-2021,New York Knicks,SF,4,0,7,0,1,0,0,0,,0,1,0,0,2,2,1,1,1,2,1,0,0,1,0,2,Ignas Brazdeikis
2020-2021,Philadelphia 76ers,SF,1,0,8,0,3,0,0,1,0,0,2,0,0,0,0,,0,2,2,0,0,0,0,0,0,Ignas Brazdeikis
2020-2021,Orlando Magic,SF,8,0,234,35,79,0.443,11,27,0.407,24,52,0.462,0.513,8,12,0.667,10,31,41,16,4,3,11,22,89,Ignas Brazdeikis
2021-2022,Orlando Magic,SF,42,1,536,81,188,0.431,27,87,0.31,54,101,0.535,0.503,21,32,0.656,23,49,72,37,10,3,17,48,210,Ignas Brazdeikis
2024-2025,Phoenix Suns,SF,4,0,17,0,3,0,0,3,0,0,0,0,1,2,0.5,0,3,3,0,0,0,2,0,1,0,Jalen Bridges
2018-2019,Phoenix Suns,SF,82,56,2417,242,563,0.43,105,313,0.335,137,250,0.548,0.523,95,118,0.805,56,208,264,173,129,38,70,201,684,Mikal Bridges
2019-2020,Phoenix Suns,SF,73,32,2042,247,484,0.51,70,194,0.361,177,290,0.61,0.583,103,122,0.844,66,226,292,129,102,46,73,163,667,Mikal Bridges
2020-2021,Phoenix Suns,SF,72,72,2348,363,669,0.543,134,315,0.425,229,354,0.647,0.643,110,131,0.84,76,233,309,152,76,63,57,116,970,Mikal Bridges
2021-2022,Phoenix Suns,SF,82,82,2854,458,858,0.534,115,312,0.369,343,546,0.628,0.601,131,157,0.834,74,273,347,185,96,36,68,150,1162,Mikal Bridges
2022-2023,Total,SG,83,83,2963,593,1267,0.468,169,442,0.382,424,825,0.514,0.535,316,353,0.895,79,285,364,273,91,61,127,159,1671,Mikal Bridges
2022-2023,Phoenix Suns,SF,56,56,2040,354,764,0.463,101,261,0.387,253,503,0.503,0.529,156,174,0.897,56,187,243,201,65,45,78,115,965,Mikal Bridges
2022-2023,Brooklyn Nets,SG,27,27,923,239,503,0.475,68,181,0.376,171,322,0.531,0.543,160,179,0.894,23,98,121,72,26,16,49,44,706,Mikal Bridges
2023-2024,Brooklyn Nets,SF,82,82,2854,564,1294,0.436,220,592,0.372,344,702,0.49,0.521,258,317,0.814,68,304,372,299,81,30,164,116,1606,Mikal Bridges
2024-2025,New York Knicks,SF,31,31,1207,231,460,0.502,76,206,0.369,155,254,0.61,0.585,23,33,0.697,27,74,101,103,35,16,49,41,561,Mikal Bridges
2018-2019,Charlotte Hornets,SF,80,25,1696,237,511,0.464,65,200,0.325,172,311,0.553,0.527,58,77,0.753,67,256,323,95,55,49,50,111,597,Miles Bridges
2019-2020,Charlotte Hornets,SF,65,64,1995,319,753,0.424,99,300,0.33,220,453,0.486,0.489,106,131,0.809,88,274,362,114,40,48,95,132,843,Miles Bridges
2020-2021,Charlotte Hornets,PF,66,19,1932,313,622,0.503,116,290,0.4,197,332,0.593,0.596,98,113,0.867,81,316,397,147,44,52,106,143,840,Miles Bridges
2021-2022,Charlotte Hornets,PF,80,80,2837,596,1214,0.491,154,465,0.331,442,749,0.59,0.554,267,333,0.802,90,469,559,300,74,67,150,193,1613,Miles Bridges
2023-2024,Charlotte Hornets,SF,69,67,2581,559,1210,0.462,157,450,0.349,402,760,0.529,0.527,174,211,0.825,71,434,505,231,65,33,138,118,1449,Miles Bridges
2024-2025,Charlotte Hornets,PF,17,17,507,105,244,0.43,33,109,0.303,72,135,0.533,0.498,48,55,0.873,15,109,124,54,10,10,29,22,291,Miles Bridges
2020-2021,Indiana Pacers,C,5,0,29,5,8,0.625,0,0,5,8,0.625,0.625,3,3,1,2,6,8,1,0,5,4,4,13,0,Amida Brimah
2019-2020,Toronto Raptors,SF,19,0,135,13,36,0.361,3,15,0.2,10,21,0.476,0.403,8,10,0.8,9,17,26,7,4,1,7,18,37,Oshae Brissett
2020-2021,Indiana Pacers,SF,21,16,519,73,151,0.483,33,78,0.423,40,73,0.548,0.593,50,65,0.769,29,86,115,18,19,20,10,32,229,Oshae Brissett
2021-2022,Indiana Pacers,SF,67,25,1564,208,506,0.411,83,237,0.35,125,269,0.465,0.493,114,164,0.695,108,250,358,72,44,29,54,116,613,Oshae Brissett
2022-2023,Indiana Pacers,PF,65,2,1083,123,319,0.386,48,155,0.31,75,164,0.457,0.461,104,145,0.717,62,156,218,44,33,13,34,79,398,Oshae Brissett
2023-2024,Boston Celtics,SF,55,1,630,68,153,0.444,15,55,0.273,53,98,0.541,0.493,50,83,0.602,61,99,160,44,19,8,20,54,201,Oshae Brissett
2023-2024,New Orleans Pelicans,PG,1,0,3,2,5,0.4,0,1,0,2,4,0.5,0.4,0,0,1,1,2,0,0,0,0,0,4,0,Izaiah Brockington
2016-2017,Milwaukee Bucks,SG,75,28,1982,290,635,0.457,78,193,0.404,212,442,0.48,0.518,109,126,0.865,47,166,213,317,84,12,113,140,767,Malcolm Brogdon
2017-2018,Milwaukee Bucks,PG,48,20,1436,244,503,0.485,62,161,0.385,182,342,0.532,0.547,75,85,0.882,23,133,156,152,41,13,66,128,625,Malcolm Brogdon
2018-2019,Milwaukee Bucks,SG,64,64,1832,378,748,0.505,104,244,0.426,274,504,0.544,0.575,141,152,0.928,65,223,288,205,46,13,91,102,1001,Malcolm Brogdon
2019-2020,Indiana Pacers,PG,54,54,1666,326,744,0.438,75,230,0.326,251,514,0.488,0.489,166,186,0.892,46,216,262,381,35,10,131,98,893,Malcolm Brogdon
2020-2021,Indiana Pacers,PG,56,56,1930,444,980,0.453,145,374,0.388,299,606,0.493,0.527,153,177,0.864,58,236,294,329,49,15,115,110,1186,Malcolm Brogdon
2021-2022,Indiana Pacers,PG,36,36,1206,243,543,0.448,58,186,0.312,185,357,0.518,0.501,143,167,0.856,33,152,185,212,30,14,77,71,687,Malcolm Brogdon
2022-2023,Boston Celtics,PG,67,0,1744,354,732,0.484,132,297,0.444,222,435,0.51,0.574,160,184,0.87,42,238,280,248,45,18,98,109,1000,Malcolm Brogdon
2023-2024,Portland Trail Blazers,PG,39,25,1121,218,496,0.44,82,199,0.412,136,297,0.458,0.522,95,116,0.819,28,120,148,214,27,8,60,58,613,Malcolm Brogdon
2024-2025,Washington Wizards,PG,13,10,321,64,139,0.46,11,33,0.333,53,106,0.5,0.5,38,45,0.844,12,42,54,43,7,4,21,22,177,Malcolm Brogdon
2020-2021,Houston Rockets,SG,20,5,520,78,192,0.406,60,157,0.382,18,35,0.514,0.563,7,12,0.583,10,58,68,30,12,5,22,34,223,Armoni Brooks
2021-2022,Total,SG,54,11,844,98,289,0.339,74,249,0.297,24,40,0.6,0.467,18,21,0.857,20,83,103,62,28,11,27,74,288,Armoni Brooks
2021-2022,Houston Rockets,SG,41,8,690,87,251,0.347,64,213,0.3,23,38,0.605,0.474,16,19,0.842,12,69,81,49,21,8,23,60,254,Armoni Brooks
2021-2022,Toronto Raptors,PG,13,3,154,11,38,0.289,10,36,0.278,1,2,0.5,0.421,2,2,1,8,14,22,13,7,3,4,14,34,Armoni Brooks
2023-2024,Brooklyn Nets,PG,10,0,104,15,46,0.326,11,32,0.344,4,14,0.286,0.446,1,2,0.5,7,11,18,5,1,1,3,3,42,Armoni Brooks
2017-2018,Memphis Grizzlies,SF,82,74,2350,340,772,0.44,94,264,0.356,246,508,0.484,0.501,124,166,0.747,49,208,257,135,73,17,124,233,898,Dillon Brooks
2018-2019,Memphis Grizzlies,SF,18,0,330,49,122,0.402,15,40,0.375,34,82,0.415,0.463,22,30,0.733,9,22,31,16,10,4,19,50,135,Dillon Brooks
2019-2020,Memphis Grizzlies,SG,73,73,2112,435,1068,0.407,147,411,0.358,288,657,0.438,0.476,164,203,0.808,68,175,243,150,63,27,124,278,1181,Dillon Brooks
2020-2021,Memphis Grizzlies,SF,67,67,1997,432,1031,0.419,128,372,0.344,304,659,0.461,0.481,159,195,0.815,53,143,196,157,78,26,119,237,1151,Dillon Brooks
2021-2022,Memphis Grizzlies,SF,32,31,885,227,526,0.432,46,149,0.309,181,377,0.48,0.475,90,106,0.849,29,73,102,88,36,8,50,105,590,Dillon Brooks
2022-2023,Memphis Grizzlies,SF,73,73,2214,392,991,0.396,143,439,0.326,249,552,0.451,0.468,120,154,0.779,45,199,244,189,65,16,104,240,1047,Dillon Brooks
2023-2024,Houston Rockets,SF,72,72,2227,329,768,0.428,133,370,0.359,196,398,0.492,0.515,124,147,0.844,53,193,246,119,64,10,88,241,915,Dillon Brooks
2024-2025,Houston Rockets,SF,28,28,886,138,321,0.43,63,164,0.384,75,157,0.478,0.528,43,50,0.86,36,75,111,45,20,8,32,95,382,Dillon Brooks
2018-2019,Detroit Pistons,SG,74,56,1449,125,314,0.398,24,93,0.258,101,221,0.457,0.436,45,60,0.75,48,137,185,91,40,36,46,178,319,Bruce Brown
2019-2020,Detroit Pistons,PG,58,43,1634,198,447,0.443,33,96,0.344,165,351,0.47,0.48,88,119,0.739,61,213,274,230,63,29,100,162,517,Bruce Brown
2020-2021,Brooklyn Nets,PG,65,37,1451,235,423,0.556,17,59,0.288,218,364,0.599,0.576,86,117,0.735,111,238,349,104,58,28,54,145,573,Bruce Brown
2021-2022,Brooklyn Nets,SF,72,45,1774,256,506,0.506,38,94,0.404,218,412,0.529,0.543,97,128,0.758,100,245,345,148,77,52,56,176,647,Bruce Brown
2022-2023,Denver Nuggets,SF,80,31,2280,358,741,0.483,91,254,0.358,267,487,0.548,0.545,116,153,0.758,63,265,328,268,87,51,123,190,923,Bruce Brown
2023-2024,Total,SG,67,44,1866,278,582,0.478,53,164,0.323,225,418,0.538,0.523,117,142,0.824,53,231,284,192,59,17,86,148,726,Bruce Brown
2023-2024,Indiana Pacers,SG,33,33,981,149,314,0.475,33,101,0.327,116,213,0.545,0.527,67,82,0.817,25,129,154,100,35,8,41,81,398,Bruce Brown
2023-2024,Toronto Raptors,PG,34,11,885,129,268,0.481,20,63,0.317,109,205,0.532,0.519,50,60,0.833,28,102,130,92,24,9,45,67,328,Bruce Brown
2019-2020,Atlanta Hawks,SG,10,0,40,6,19,0.316,3,9,0.333,3,10,0.3,0.395,5,5,1,2,2,4,2,2,2,3,3,20,Charlie Brown Jr.
2020-2021,Oklahoma City Thunder,SG,9,1,152,13,43,0.302,5,21,0.238,8,22,0.364,0.36,9,10,0.9,3,14,17,9,4,2,6,19,40,Charlie Brown Jr.
2021-2022,Total,SG,22,2,177,10,39,0.256,1,12,0.083,9,27,0.333,0.269,9,10,0.9,14,18,32,6,10,4,5,18,30,Charlie Brown Jr.
2021-2022,Dallas Mavericks,SG,3,0,15,1,5,0.2,0,3,0,1,2,0.5,0.2,0,0,,0,1,1,1,2,1,0,2,2,Charlie Brown Jr.
2021-2022,Philadelphia 76ers,SG,19,2,162,9,34,0.265,1,9,0.111,8,25,0.32,0.279,9,10,0.9,14,17,31,5,8,3,5,16,28,Charlie Brown Jr.
2023-2024,New York Knicks,SG,8,0,37,2,10,0.2,2,7,0.286,0,3,0,0.3,0,0,,1,1,2,0,0,2,2,5,6,Charlie Brown Jr.
2021-2022,Total,SG,5,2,104,10,32,0.313,6,18,0.333,4,14,0.286,0.406,5,6,0.833,1,15,16,4,2,0,1,7,31,Chaundee Brown Jr.
2021-2022,Los Angeles Lakers,SF,2,0,21,1,7,0.143,0,3,0,1,4,0.25,0.143,0,0,,0,2,2,0,0,0,1,0,2,Chaundee Brown Jr.
2021-2022,Atlanta Hawks,SG,3,2,83,9,25,0.36,6,15,0.4,3,10,0.3,0.48,5,6,0.833,1,13,14,4,2,0,0,7,29,Chaundee Brown Jr.
2021-2022,Portland Trail Blazers,SF,48,6,640,81,190,0.426,19,61,0.311,62,129,0.481,0.476,44,65,0.677,38,97,135,35,26,24,36,90,225,Greg Brown III
2022-2023,Portland Trail Blazers,PF,16,0,93,11,28,0.393,1,7,0.143,10,21,0.476,0.411,5,12,0.417,2,17,19,3,4,5,6,13,28,Greg Brown III
2023-2024,Dallas Mavericks,PF,6,0,40,5,11,0.455,1,3,0.333,4,8,0.5,0.5,4,9,0.444,3,6,9,4,0,4,4,5,15,Greg Brown III
2016-2017,Boston Celtics,SF,78,20,1341,192,423,0.454,46,135,0.341,146,288,0.507,0.508,85,124,0.685,45,175,220,64,35,18,68,142,515,Jaylen Brown
2017-2018,Boston Celtics,SG,70,70,2152,373,803,0.465,121,306,0.395,252,497,0.507,0.54,150,233,0.644,66,280,346,114,70,26,124,181,1017,Jaylen Brown
2018-2019,Boston Celtics,SG,74,25,1913,368,792,0.465,95,276,0.344,273,516,0.529,0.525,133,202,0.658,65,248,313,100,69,32,99,186,964,Jaylen Brown
2019-2020,Boston Celtics,SG,57,57,1934,427,887,0.481,129,338,0.382,298,549,0.543,0.554,176,243,0.724,62,302,364,118,65,20,125,167,1159,Jaylen Brown
2020-2021,Boston Celtics,SG,58,58,1999,538,1111,0.484,163,411,0.397,375,700,0.536,0.558,191,250,0.764,71,276,347,195,72,32,158,168,1430,Jaylen Brown
2021-2022,Boston Celtics,SF,66,66,2220,576,1217,0.473,166,464,0.358,410,753,0.544,0.541,241,318,0.758,53,351,404,231,70,18,178,163,1559,Jaylen Brown
2022-2023,Boston Celtics,SF,67,67,2405,679,1383,0.491,163,487,0.335,516,896,0.576,0.55,263,344,0.765,78,381,459,232,75,26,197,172,1784,Jaylen Brown
2023-2024,Boston Celtics,SF,70,70,2343,627,1256,0.499,145,410,0.354,482,846,0.57,0.557,211,300,0.703,84,303,387,249,83,37,166,185,1610,Jaylen Brown
2024-2025,Boston Celtics,SF,26,26,928,232,510,0.455,63,188,0.335,169,322,0.525,0.517,113,153,0.739,38,117,155,120,36,8,72,62,640,Jaylen Brown
2022-2023,Indiana Pacers,SG,6,0,40,4,7,0.571,0,1,0,4,6,0.667,0.571,1,2,0.5,2,4,6,3,4,0,2,9,9,Kendall Brown
2023-2024,Indiana Pacers,SG,15,0,63,8,15,0.533,0,2,0,8,13,0.615,0.533,5,8,0.625,3,2,5,5,0,0,2,9,21,Kendall Brown
2023-2024,Los Angeles Clippers,PF,44,0,394,37,90,0.411,14,48,0.292,23,42,0.548,0.489,1,2,0.5,20,42,62,25,12,6,9,49,89,Kobe Brown
2024-2025,Los Angeles Clippers,PF,7,0,47,9,20,0.45,1,6,0.167,8,14,0.571,0.475,1,2,0.5,5,11,16,4,1,0,0,5,20,Kobe Brown
2019-2020,Portland Trail Blazers,C,9,0,33,4,10,0.4,0,0,4,10,0.4,0.4,3,8,0.375,3,11,14,1,1,1,3,7,11,0,Moses Brown
2020-2021,Oklahoma City Thunder,C,43,32,920,146,268,0.545,0,0,146,268,0.545,0.545,78,126,0.619,154,229,383,10,31,47,43,93,370,0,Moses Brown
2021-2022,Total,C,40,6,345,64,108,0.593,0,0,64,108,0.593,0.593,43,72,0.597,39,96,135,1,7,16,20,53,171,0,Moses Brown
2021-2022,Dallas Mavericks,C,26,1,169,27,50,0.54,0,0,27,50,0.54,0.54,27,43,0.628,16,45,61,1,3,9,14,28,81,0,Moses Brown
2021-2022,Cleveland Cavaliers,C,14,5,176,37,58,0.638,0,0,37,58,0.638,0.638,16,29,0.552,23,51,74,0,4,7,6,25,90,0,Moses Brown
2022-2023,Total,C,36,1,294,61,96,0.635,0,0,61,96,0.635,0.635,33,72,0.458,57,82,139,4,4,14,15,39,155,0,Moses Brown
2022-2023,Los Angeles Clippers,C,34,1,288,61,96,0.635,0,0,61,96,0.635,0.635,33,72,0.458,57,82,139,4,3,14,14,38,155,0,Moses Brown
2022-2023,Brooklyn Nets,C,2,0,6,0,0,,0,0,0,0,,,0,0,,0,0,0,0,1,0,1,1,0,0,Moses Brown
2023-2024,Portland Trail Blazers,C,22,5,200,33,65,0.508,0,0,33,65,0.508,0.508,9,31,0.29,37,49,86,7,5,7,11,27,75,0,Moses Brown
2024-2025,Indiana Pacers,C,9,0,46,13,20,0.65,0,0,13,20,0.65,0.65,3,5,0.6,4,9,13,0,2,1,6,6,29,0,Moses Brown
2017-2018,Milwaukee Bucks,SG,54,4,776,82,205,0.4,32,91,0.352,50,114,0.439,0.478,21,24,0.875,27,116,143,25,31,13,25,80,217,Sterling Brown
2018-2019,Milwaukee Bucks,SG,58,7,1034,145,312,0.465,53,147,0.361,92,165,0.558,0.55,29,42,0.69,29,155,184,84,25,8,46,88,372,Sterling Brown
2019-2020,Milwaukee Bucks,SF,52,1,767,95,256,0.371,44,136,0.324,51,120,0.425,0.457,32,40,0.8,31,152,183,51,29,7,42,54,266,Sterling Brown
2020-2021,Houston Rockets,SG,51,14,1229,150,335,0.448,91,215,0.423,59,120,0.492,0.584,25,31,0.806,38,186,224,72,38,12,41,97,416,Sterling Brown
2021-2022,Dallas Mavericks,SG,49,3,628,59,155,0.381,28,92,0.304,31,63,0.492,0.471,14,15,0.933,26,123,149,34,14,7,23,56,160,Sterling Brown
2022-2023,Los Angeles Lakers,SF,4,0,24,0,4,0,0,2,0,0,2,0,0,0,0,,3,5,8,2,3,0,0,4,0,Sterling Brown
2018-2019,Washington Wizards,SF,52,10,730,97,234,0.415,22,69,0.319,75,165,0.455,0.462,32,47,0.681,35,110,145,80,21,5,30,56,248,Troy Brown Jr.
2019-2020,Washington Wizards,SF,69,22,1782,273,622,0.439,61,179,0.341,212,443,0.479,0.488,109,139,0.784,76,307,383,178,85,7,79,132,716,Troy Brown Jr.
2020-2021,Total,SF,34,0,524,62,144,0.431,22,70,0.314,40,74,0.541,0.507,15,21,0.714,20,85,105,29,10,6,21,49,161,Troy Brown Jr.
2020-2021,Washington Wizards,SF,21,0,287,33,89,0.371,14,46,0.304,19,43,0.442,0.449,10,15,0.667,11,50,61,19,3,4,16,29,90,Troy Brown Jr.
2020-2021,Chicago Bulls,SF,13,0,237,29,55,0.527,8,24,0.333,21,31,0.677,0.6,5,6,0.833,9,35,44,10,7,2,5,20,71,Troy Brown Jr.
2021-2022,Chicago Bulls,SF,66,7,1055,108,258,0.419,47,133,0.353,61,125,0.488,0.51,20,26,0.769,39,164,203,66,36,5,26,62,283,Troy Brown Jr.
2022-2023,Los Angeles Lakers,SF,76,45,1860,200,465,0.43,107,281,0.381,93,184,0.505,0.545,34,39,0.872,62,246,308,95,59,16,49,120,541,Troy Brown Jr.
2023-2024,Total,SF,59,15,827,84,226,0.372,47,141,0.333,37,85,0.435,0.476,32,37,0.865,25,119,144,60,24,3,30,42,247,Troy Brown Jr.
2023-2024,Minnesota Timberwolves,SF,37,3,410,52,118,0.441,31,84,0.369,21,34,0.618,0.572,19,22,0.864,14,58,72,35,8,2,18,26,154,Troy Brown Jr.
2023-2024,Detroit Pistons,SF,22,12,417,32,108,0.296,16,57,0.281,16,51,0.314,0.37,13,15,0.867,11,61,72,25,16,1,12,16,93,Troy Brown Jr.
2018-2019,Dallas Mavericks,PG,73,38,1591,264,565,0.467,63,181,0.348,201,384,0.523,0.523,87,120,0.725,25,144,169,230,37,4,88,127,678,Jalen Brunson
2019-2020,Dallas Mavericks,PG,57,16,1022,181,388,0.466,43,120,0.358,138,268,0.515,0.522,61,75,0.813,22,112,134,188,22,4,66,74,466,Jalen Brunson
2020-2021,Dallas Mavericks,PG,68,12,1697,328,627,0.523,81,200,0.405,247,427,0.578,0.588,120,151,0.795,27,204,231,239,35,1,80,109,857,Jalen Brunson
2021-2022,Dallas Mavericks,SG,79,61,2524,506,1008,0.502,94,252,0.373,412,756,0.545,0.549,179,213,0.84,43,266,309,377,66,3,124,151,1285,Jalen Brunson
2022-2023,New York Knicks,PG,68,68,2379,587,1195,0.491,134,322,0.416,453,873,0.519,0.547,325,392,0.829,40,201,241,421,61,15,142,152,1633,Jalen Brunson
2023-2024,New York Knicks,PG,77,77,2726,790,1648,0.479,211,526,0.401,579,1122,0.516,0.543,421,497,0.847,43,235,278,519,70,13,186,144,2212,Jalen Brunson
2024-2025,New York Knicks,PG,31,31,1072,259,538,0.481,79,189,0.418,180,349,0.516,0.555,163,201,0.811,14,78,92,238,25,2,74,72,760,Jalen Brunson
2017-2018,Los Angeles Lakers,C,15,0,72,8,21,0.381,1,10,0.1,7,11,0.636,0.405,5,9,0.556,3,14,17,6,1,2,2,6,22,Thomas Bryant
2018-2019,Washington Wizards,C,72,53,1496,309,502,0.616,33,99,0.333,276,403,0.685,0.648,107,137,0.781,113,341,454,92,25,67,60,126,758,Thomas Bryant
2019-2020,Washington Wizards,C,46,36,1147,243,418,0.581,37,91,0.407,206,327,0.63,0.626,86,116,0.741,98,233,331,83,25,49,53,103,609,Thomas Bryant
2020-2021,Washington Wizards,C,10,10,271,59,91,0.648,9,21,0.429,50,70,0.714,0.698,16,24,0.667,18,43,61,15,4,8,11,31,143,Thomas Bryant
2021-2022,Washington Wizards,C,27,9,439,77,148,0.52,12,42,0.286,65,106,0.613,0.561,35,40,0.875,26,82,108,23,6,21,19,43,201,Thomas Bryant
2022-2023,Total,C,59,26,1081,230,369,0.623,26,59,0.441,204,310,0.658,0.659,93,126,0.738,86,253,339,31,16,30,38,102,579,Thomas Bryant
2022-2023,Los Angeles Lakers,C,41,25,876,197,301,0.654,22,50,0.44,175,251,0.697,0.691,80,108,0.741,67,212,279,29,14,23,28,77,496,Thomas Bryant
2022-2023,Denver Nuggets,C,18,1,205,33,68,0.485,4,9,0.444,29,59,0.492,0.515,13,18,0.722,19,41,60,2,2,7,10,25,83,Thomas Bryant
2023-2024,Miami Heat,C,38,4,441,86,149,0.577,4,22,0.182,82,127,0.646,0.591,41,47,0.872,40,101,141,23,10,16,21,46,217,Thomas Bryant
2024-2025,Total,C,16,0,183,23,49,0.469,11,29,0.379,12,20,0.6,0.582,13,13,1,11,42,53,7,4,12,4,13,70,Thomas Bryant
2024-2025,Miami Heat,C,10,0,115,12,28,0.429,6,17,0.353,6,11,0.545,0.536,11,11,1,6,26,32,4,1,9,2,9,41,Thomas Bryant
2024-2025,Indiana Pacers,C,6,0,68,11,21,0.524,5,12,0.417,6,9,0.667,0.643,2,2,1,5,16,21,3,3,3,2,4,29,Thomas Bryant
2021-2022,Memphis Grizzlies,SG,2,0,10,1,4,0.25,0,2,0,1,2,0.5,0.25,0,0,1,1,2,2,1,0,2,1,2,0,Shaq Buchanan
2023-2024,Atlanta Hawks,SG,17,0,196,34,92,0.37,9,40,0.225,25,52,0.481,0.418,4,8,0.5,6,27,33,27,7,5,10,20,81,Kobe Bufkin
2024-2025,Atlanta Hawks,SG,10,0,124,18,47,0.383,4,19,0.211,14,28,0.5,0.426,13,18,0.722,5,16,21,17,3,2,8,9,53,Kobe Bufkin
2013-2014,Los Angeles Clippers,SF,43,0,395,43,121,0.355,22,73,0.301,21,48,0.438,0.446,7,9,0.778,11,43,54,12,9,1,13,26,115,Reggie Bullock
2014-2015,Total,SF,36,2,338,24,70,0.343,15,46,0.326,9,24,0.375,0.45,6,9,0.667,1,49,50,8,10,4,8,19,69,Reggie Bullock
2014-2015,Los Angeles Clippers,SF,25,2,263,23,54,0.426,15,39,0.385,8,15,0.533,0.565,4,5,0.8,0,40,40,6,9,2,6,17,65,Reggie Bullock
2014-2015,Phoenix Suns,SF,11,0,75,1,16,0.063,0,7,0,1,9,0.111,0.063,2,4,0.5,1,9,10,2,1,2,2,2,4,Reggie Bullock
2015-2016,Detroit Pistons,SF,37,0,429,43,98,0.439,22,53,0.415,21,45,0.467,0.551,14,15,0.933,14,54,68,27,10,2,8,29,122,Reggie Bullock
2016-2017,Detroit Pistons,SF,31,5,467,54,128,0.422,28,73,0.384,26,55,0.473,0.531,5,7,0.714,13,51,64,29,18,3,10,22,141,Reggie Bullock
2017-2018,Detroit Pistons,SF,62,52,1732,267,546,0.489,125,281,0.445,142,265,0.536,0.603,39,49,0.796,27,127,154,95,47,13,47,70,698,Reggie Bullock
2018-2019,Total,SG,63,60,1879,245,594,0.412,148,393,0.377,97,201,0.483,0.537,73,85,0.859,22,151,173,129,40,12,65,109,711,Reggie Bullock
2018-2019,Detroit Pistons,SG,44,44,1355,182,441,0.413,114,294,0.388,68,147,0.463,0.542,56,64,0.875,20,103,123,109,24,5,54,79,534,Reggie Bullock
2018-2019,Los Angeles Lakers,SG,19,16,524,63,153,0.412,34,99,0.343,29,54,0.537,0.523,17,21,0.81,2,48,50,20,16,7,11,30,177,Reggie Bullock
2019-2020,New York Knicks,SG,29,19,684,90,224,0.402,37,111,0.333,53,113,0.469,0.484,17,21,0.81,13,55,68,42,25,3,19,56,234,Reggie Bullock
2020-2021,New York Knicks,SF,65,64,1949,248,561,0.442,163,398,0.41,85,163,0.521,0.587,50,55,0.909,16,207,223,99,52,11,45,146,709,Reggie Bullock
2021-2022,Dallas Mavericks,SF,68,37,1902,201,501,0.401,141,392,0.36,60,109,0.55,0.542,40,48,0.833,33,208,241,83,41,14,40,111,583,Reggie Bullock
2022-2023,Dallas Mavericks,SF,78,55,2364,192,470,0.409,151,397,0.38,41,73,0.562,0.569,26,37,0.703,32,251,283,108,54,13,36,166,561,Reggie Bullock
2023-2024,Houston Rockets,SF,44,0,417,34,82,0.415,27,67,0.403,7,15,0.467,0.579,1,1,1,6,67,73,15,12,5,10,29,96,Reggie Bullock
2013-2014,Utah Jazz,PG,70,68,2262,341,897,0.38,111,336,0.33,230,561,0.41,0.442,102,113,0.903,37,171,208,396,42,6,131,145,895,Trey Burke
2014-2015,Utah Jazz,PG,76,43,2288,370,1005,0.368,124,390,0.318,246,615,0.4,0.43,109,145,0.752,31,173,204,328,65,15,124,119,973,Trey Burke
2015-2016,Utah Jazz,PG,64,0,1366,262,634,0.413,88,256,0.344,174,378,0.46,0.483,67,82,0.817,18,94,112,148,35,6,80,86,679,Trey Burke
2016-2017,Washington Wizards,PG,57,0,703,116,255,0.455,31,70,0.443,85,185,0.459,0.516,22,29,0.759,7,40,47,100,11,5,48,54,285,Trey Burke
2017-2018,New York Knicks,PG,36,9,785,193,384,0.503,38,105,0.362,155,279,0.556,0.552,37,57,0.649,13,58,71,170,24,4,43,43,461,Trey Burke
2018-2019,Total,PG,58,8,1125,236,548,0.431,56,159,0.352,180,389,0.463,0.482,103,124,0.831,28,71,99,159,33,7,49,58,631,Trey Burke
2018-2019,New York Knicks,PG,33,7,689,148,358,0.413,30,86,0.349,118,272,0.434,0.455,62,75,0.827,15,47,62,94,21,5,29,33,388,Trey Burke
2018-2019,Dallas Mavericks,PG,25,1,436,88,190,0.463,26,73,0.356,62,117,0.53,0.532,41,49,0.837,13,24,37,65,12,2,20,25,243,Trey Burke
2019-2020,Total,PG,33,1,520,94,209,0.45,32,75,0.427,62,134,0.463,0.526,23,29,0.793,16,34,50,83,16,2,21,33,243,Trey Burke
2019-2020,Philadelphia 76ers,PG,25,0,329,59,127,0.465,16,38,0.421,43,89,0.483,0.528,13,18,0.722,15,20,35,53,7,1,12,21,147,Trey Burke
2019-2020,Dallas Mavericks,PG,8,1,191,35,82,0.427,16,37,0.432,19,45,0.422,0.524,10,11,0.909,1,14,15,30,9,1,9,12,96,Trey Burke
2020-2021,Dallas Mavericks,PG,62,1,911,151,353,0.428,58,164,0.354,93,189,0.492,0.51,51,57,0.895,10,44,54,81,36,7,33,64,411,Trey Burke
2021-2022,Dallas Mavericks,PG,42,0,441,84,215,0.391,26,82,0.317,58,133,0.436,0.451,20,23,0.87,4,29,33,57,12,0,26,39,214,Trey Burke
2011-2012,Utah Jazz,SG,59,0,939,153,357,0.429,15,45,0.333,138,312,0.442,0.45,104,143,0.727,57,75,132,55,27,5,51,84,425,Alec Burks
2012-2013,Utah Jazz,SG,64,0,1137,163,388,0.42,33,92,0.359,130,296,0.439,0.463,92,129,0.713,37,108,145,92,35,13,74,114,451,Alec Burks
2013-2014,Utah Jazz,SG,78,12,2193,380,831,0.457,50,143,0.35,330,688,0.48,0.487,279,373,0.748,59,198,257,212,69,14,149,190,1089,Alec Burks
2014-2015,Utah Jazz,SG,27,27,899,121,300,0.403,26,68,0.382,95,232,0.409,0.447,106,129,0.822,19,95,114,82,17,5,52,64,374,Alec Burks
2015-2016,Utah Jazz,SG,31,3,797,137,334,0.41,32,79,0.405,105,255,0.412,0.458,106,141,0.752,16,93,109,63,18,4,51,71,412,Alec Burks
2016-2017,Utah Jazz,SG,42,0,653,99,248,0.399,25,76,0.329,74,172,0.43,0.45,60,78,0.769,17,103,120,30,18,5,35,50,283,Alec Burks
2017-2018,Utah Jazz,SG,64,1,1059,170,414,0.411,47,142,0.331,123,272,0.452,0.467,107,124,0.863,19,173,192,67,37,8,60,75,494,Alec Burks
2018-2019,Total,SG,64,24,1375,192,474,0.405,61,168,0.363,131,306,0.428,0.469,116,141,0.823,30,205,235,128,39,21,65,91,561,Alec Burks
2018-2019,Utah Jazz,SG,17,0,269,47,114,0.412,16,43,0.372,31,71,0.437,0.482,33,38,0.868,2,25,27,20,6,4,15,22,143,Alec Burks
2018-2019,Cleveland Cavaliers,SG,34,24,979,136,340,0.4,45,119,0.378,91,221,0.412,0.466,79,98,0.806,26,160,186,98,25,16,46,62,396,Alec Burks
2018-2019,Sacramento Kings,SG,13,0,127,9,20,0.45,0,6,0,9,14,0.643,0.45,4,5,0.8,2,20,22,10,8,1,4,7,22,Alec Burks
2019-2020,Total,SF,66,19,1754,321,768,0.418,116,301,0.385,205,467,0.439,0.493,235,265,0.887,48,234,282,189,62,17,91,128,993,Alec Burks
2019-2020,Golden State Warriors,SF,48,18,1390,244,601,0.406,84,224,0.375,160,377,0.424,0.476,201,224,0.897,37,189,226,151,50,17,76,107,773,Alec Burks
2019-2020,Philadelphia 76ers,SG,18,1,364,77,167,0.461,32,77,0.416,45,90,0.5,0.557,34,41,0.829,11,45,56,38,12,0,15,21,220,Alec Burks
2020-2021,New York Knicks,SG,49,5,1255,210,500,0.42,102,246,0.415,108,254,0.425,0.522,101,118,0.856,21,206,227,107,31,14,49,102,623,Alec Burks
2021-2022,New York Knicks,SG,81,44,2318,285,728,0.391,157,389,0.404,128,339,0.378,0.499,217,264,0.822,47,350,397,239,85,26,91,215,944,Alec Burks
2022-2023,Detroit Pistons,SG,51,8,1122,200,459,0.436,99,239,0.414,101,220,0.459,0.544,153,188,0.814,19,139,158,114,38,8,58,98,652,Alec Burks
2023-2024,Total,SG,66,1,1212,210,569,0.369,124,330,0.376,86,239,0.36,0.478,145,167,0.868,24,126,150,88,28,12,48,75,689,Alec Burks
2023-2024,Detroit Pistons,SG,43,0,901,160,406,0.394,99,247,0.401,61,159,0.384,0.516,121,134,0.903,16,94,110,68,21,11,32,64,540,Alec Burks
2023-2024,New York Knicks,SG,23,1,311,50,163,0.307,25,83,0.301,25,80,0.313,0.383,24,33,0.727,8,32,40,20,7,1,16,11,149,Alec Burks
2024-2025,Miami Heat,SG,14,0,237,29,59,0.492,21,41,0.512,8,18,0.444,0.669,13,17,0.765,6,26,32,17,10,4,3,10,92,Alec Burks
2018-2019,Oklahoma City Thunder,SG,32,0,240,33,82,0.402,8,27,0.296,25,55,0.455,0.451,8,12,0.667,4,24,28,9,6,8,9,31,82,Deonte Burton
2019-2020,Oklahoma City Thunder,SF,39,0,356,43,125,0.344,10,53,0.189,33,72,0.458,0.384,8,14,0.571,7,50,57,17,7,10,19,34,104,Deonte Burton
2022-2023,Sacramento Kings,PF,2,0,6,0,2,0,0,1,0,0,1,0,0,0,0,,0,0,0,0,0,0,0,0,0,Deonte Burton
2021-2022,Utah Jazz,SG,42,1,360,61,151,0.404,28,88,0.318,33,63,0.524,0.497,11,16,0.688,5,40,45,63,17,8,33,47,161,Jared Butler
2022-2023,Oklahoma City Thunder,PG,6,1,77,15,32,0.469,7,14,0.5,8,18,0.444,0.578,0,0,,1,3,4,8,5,0,5,5,37,Jared Butler
2023-2024,Washington Wizards,SG,40,0,566,98,201,0.488,24,78,0.308,74,123,0.602,0.547,31,36,0.861,9,49,58,126,29,8,50,58,251,Jared Butler
2024-2025,Washington Wizards,SG,20,0,220,46,101,0.455,7,25,0.28,39,76,0.513,0.49,17,23,0.739,6,14,20,50,7,2,18,24,116,Jared Butler
2011-2012,Chicago Bulls,SG,42,0,359,32,79,0.405,2,11,0.182,30,68,0.441,0.418,43,56,0.768,23,33,56,14,11,5,14,20,109,Jimmy Butler
2012-2013,Chicago Bulls,SF,82,20,2134,239,512,0.467,40,105,0.381,199,407,0.489,0.506,187,233,0.803,136,192,328,115,78,31,62,97,705,Jimmy Butler
2013-2014,Chicago Bulls,SG,67,67,2591,275,693,0.397,68,240,0.283,207,453,0.457,0.446,260,338,0.769,87,243,330,175,127,36,102,106,878,Jimmy Butler
2014-2015,Chicago Bulls,SG,65,65,2513,421,912,0.462,73,193,0.378,348,719,0.484,0.502,386,463,0.834,114,265,379,212,114,36,93,108,1301,Jimmy Butler
2015-2016,Chicago Bulls,SG,67,67,2474,470,1035,0.454,64,205,0.312,406,830,0.489,0.485,395,475,0.832,79,279,358,321,110,43,132,124,1399,Jimmy Butler
2016-2017,Chicago Bulls,SF,76,75,2809,570,1252,0.455,91,248,0.367,479,1004,0.477,0.492,585,676,0.865,129,341,470,417,143,32,159,112,1816,Jimmy Butler
2017-2018,Minnesota Timberwolves,SG,59,59,2164,437,921,0.474,70,200,0.35,367,721,0.509,0.512,363,425,0.854,79,235,314,288,116,24,108,78,1307,Jimmy Butler
2018-2019,Total,SF,65,65,2185,418,904,0.462,67,193,0.347,351,711,0.494,0.499,312,365,0.855,121,221,342,263,123,39,95,111,1215,Jimmy Butler
2018-2019,Minnesota Timberwolves,SG,10,10,361,74,157,0.471,17,45,0.378,57,112,0.509,0.525,48,61,0.787,16,36,52,43,24,10,14,18,213,Jimmy Butler
2018-2019,Philadelphia 76ers,SF,55,55,1824,344,747,0.461,50,148,0.338,294,599,0.491,0.494,264,304,0.868,105,185,290,220,99,29,81,93,1002,Jimmy Butler
2019-2020,Miami Heat,SF,58,58,1959,345,758,0.455,29,119,0.244,316,639,0.495,0.474,438,525,0.834,106,280,386,350,103,32,127,81,1157,Jimmy Butler
2020-2021,Miami Heat,SF,52,52,1745,366,736,0.497,25,102,0.245,341,634,0.538,0.514,359,416,0.863,94,265,359,369,108,18,109,71,1116,Jimmy Butler
2021-2022,Miami Heat,SF,57,57,1931,398,829,0.48,27,116,0.233,371,713,0.52,0.496,396,455,0.87,102,234,336,312,94,27,121,88,1219,Jimmy Butler
2022-2023,Miami Heat,PF,64,64,2138,479,888,0.539,36,103,0.35,443,785,0.564,0.56,472,555,0.85,141,234,375,340,117,21,101,80,1466,Jimmy Butler
2023-2024,Miami Heat,PF,60,60,2042,396,793,0.499,60,145,0.414,336,648,0.519,0.537,394,459,0.858,105,213,318,298,79,17,102,68,1246,Jimmy Butler
2024-2025,Miami Heat,PF,20,20,627,122,221,0.552,10,28,0.357,112,193,0.58,0.575,115,147,0.782,51,64,115,97,25,8,26,20,369,Jimmy Butler
2022-2023,Portland Trail Blazers,C,19,1,221,17,53,0.321,8,35,0.229,9,18,0.5,0.396,3,4,0.75,3,14,17,11,7,9,1,22,45,John Butler
2024-2025,Chicago Bulls,SF,29,0,381,53,143,0.371,25,74,0.338,28,69,0.406,0.458,22,28,0.786,15,61,76,17,8,22,18,42,153,Matas Buzelis
2014-2015,Toronto Raptors,SF,8,0,23,4,12,0.333,2,3,0.667,2,9,0.222,0.417,0,0,,1,1,2,0,0,1,4,3,10,Bruno Caboclo
2015-2016,Toronto Raptors,SF,6,1,43,1,12,0.083,1,7,0.143,0,5,0,0.125,0,0,,1,1,2,1,2,1,4,2,3,Bruno Caboclo
2016-2017,Toronto Raptors,SF,9,0,40,6,16,0.375,2,6,0.333,4,10,0.4,0.438,0,0,,5,5,10,4,2,1,2,4,14,Bruno Caboclo
2017-2018,Total,SF,12,0,107,9,31,0.29,3,17,0.176,6,14,0.429,0.339,5,6,0.833,7,15,22,4,3,4,4,8,26,Bruno Caboclo
2017-2018,Toronto Raptors,SF,2,0,7,0,2,0,0,2,0,0,0,,0,0,0,,0,1,1,1,1,0,0,1,0,Bruno Caboclo
2017-2018,Sacramento Kings,SF,10,0,100,9,29,0.31,3,15,0.2,6,14,0.429,0.362,5,6,0.833,7,14,21,3,2,4,4,7,26,Bruno Caboclo
2018-2019,Memphis Grizzlies,PF,34,19,800,96,225,0.427,48,130,0.369,48,95,0.505,0.533,42,50,0.84,42,116,158,50,14,33,38,81,282,Bruno Caboclo
2019-2020,Total,C,30,0,244,38,89,0.427,6,33,0.182,32,56,0.571,0.461,8,9,0.889,23,37,60,12,15,17,13,31,90,Bruno Caboclo
2019-2020,Memphis Grizzlies,C,22,0,192,28,69,0.406,4,25,0.16,24,44,0.545,0.435,2,3,0.667,17,27,44,10,10,12,7,23,62,Bruno Caboclo
2019-2020,Houston Rockets,C,8,0,52,10,20,0.5,2,8,0.25,8,12,0.667,0.55,6,6,1,6,10,16,2,5,5,6,8,28,Bruno Caboclo
2020-2021,Houston Rockets,PF,6,0,36,8,17,0.471,0,5,0,8,12,0.667,0.471,1,2,0.5,3,11,14,1,0,2,4,6,17,Bruno Caboclo
2019-2020,Los Angeles Lakers,C,1,0,9,3,6,0.5,0,0,3,6,0.5,0.5,0,0,,2,3,5,1,0,0,0,0,6,0,Devontae Cacok
2020-2021,Los Angeles Lakers,PF,20,1,98,17,29,0.586,0,0,17,29,0.586,0.586,5,11,0.455,12,20,32,1,5,4,5,8,39,0,Devontae Cacok
2021-2022,San Antonio Spurs,PF,15,0,121,21,31,0.677,0,0,21,31,0.677,0.677,4,7,0.571,8,34,42,6,8,7,3,16,46,0,Devontae Cacok
2022-2023,Miami Heat,PF,18,0,240,37,66,0.561,7,20,0.35,30,46,0.652,0.614,17,22,0.773,15,37,52,12,11,1,6,21,98,Jamal Cain
2023-2024,Miami Heat,PF,26,1,259,34,79,0.43,11,31,0.355,23,48,0.479,0.5,18,23,0.783,15,22,37,10,10,5,8,22,97,Jamal Cain
2024-2025,New Orleans Pelicans,SF,16,0,225,25,55,0.455,9,28,0.321,16,27,0.593,0.536,10,16,0.625,15,30,45,10,8,7,7,20,69,Jamal Cain
2013-2014,Detroit Pistons,SG,80,41,1583,182,460,0.396,59,185,0.319,123,275,0.447,0.46,47,61,0.77,38,118,156,55,75,12,28,145,470,Kentavious Caldwell-Pope
2014-2015,Detroit Pistons,SG,82,82,2587,390,972,0.401,153,444,0.345,237,528,0.449,0.48,110,158,0.696,46,209,255,109,93,18,94,161,1043,Kentavious Caldwell-Pope
2015-2016,Detroit Pistons,SG,76,76,2789,403,960,0.42,114,369,0.309,289,591,0.489,0.479,185,228,0.811,70,212,282,138,110,17,105,167,1105,Kentavious Caldwell-Pope
2016-2017,Detroit Pistons,SG,76,75,2529,370,928,0.399,153,437,0.35,217,491,0.442,0.481,154,185,0.832,55,193,248,193,89,12,86,118,1047,Kentavious Caldwell-Pope
2017-2018,Los Angeles Lakers,SG,74,74,2458,340,798,0.426,159,415,0.383,181,383,0.473,0.526,153,194,0.789,60,327,387,162,106,16,97,145,992,Kentavious Caldwell-Pope
2018-2019,Los Angeles Lakers,SG,82,23,2035,325,756,0.43,151,435,0.347,174,321,0.542,0.53,137,158,0.867,48,190,238,110,73,13,65,137,938,Kentavious Caldwell-Pope
2019-2020,Los Angeles Lakers,SG,69,26,1762,237,507,0.467,92,239,0.385,145,268,0.541,0.558,79,102,0.775,38,104,142,111,57,14,62,128,645,Kentavious Caldwell-Pope
2020-2021,Los Angeles Lakers,SG,67,67,1902,218,506,0.431,120,293,0.41,98,213,0.46,0.549,97,112,0.866,27,152,179,127,62,26,66,114,653,Kentavious Caldwell-Pope
2021-2022,Washington Wizards,SG,77,77,2329,361,829,0.435,159,408,0.39,202,421,0.48,0.531,137,154,0.89,41,220,261,145,83,26,97,139,1018,Kentavious Caldwell-Pope
2022-2023,Denver Nuggets,SG,76,76,2381,292,632,0.462,135,319,0.423,157,313,0.502,0.569,103,125,0.824,35,173,208,183,112,35,86,145,822,Kentavious Caldwell-Pope
2023-2024,Denver Nuggets,SG,76,76,2402,270,587,0.46,125,308,0.406,145,279,0.52,0.566,101,113,0.894,31,152,183,183,98,42,75,151,766,Kentavious Caldwell-Pope
2024-2025,Orlando Magic,SG,32,32,986,95,237,0.401,46,155,0.297,49,82,0.598,0.498,46,50,0.92,11,55,66,61,52,20,26,66,282,Kentavious Caldwell-Pope
2023-2024,Portland Trail Blazers,PF,70,49,1739,197,438,0.45,58,172,0.337,139,266,0.523,0.516,75,99,0.758,139,204,343,87,66,33,84,174,527,Toumani Camara
2024-2025,Portland Trail Blazers,PF,30,30,916,98,234,0.419,44,127,0.346,54,107,0.505,0.513,22,30,0.733,65,103,168,58,40,14,46,85,262,Toumani Camara
2020-2021,Denver Nuggets,PG,65,19,1425,120,315,0.381,76,216,0.352,44,99,0.444,0.502,80,91,0.879,22,112,134,232,79,14,73,132,396,Facundo Campazzo
2021-2022,Denver Nuggets,PG,65,4,1184,107,296,0.361,58,193,0.301,49,103,0.476,0.459,60,78,0.769,23,94,117,220,63,23,67,124,332,Facundo Campazzo
2022-2023,Dallas Mavericks,PG,8,0,52,3,13,0.231,3,11,0.273,0,2,0,0.346,1,2,0.5,0,2,2,9,6,0,3,3,10,Facundo Campazzo
2019-2020,Denver Nuggets,PF,14,0,45,6,15,0.4,1,6,0.167,5,9,0.556,0.433,4,4,1,5,5,10,3,1,1,3,7,17,Vlatko Čančar
2020-2021,Denver Nuggets,PF,41,1,281,33,72,0.458,9,33,0.273,24,39,0.615,0.521,10,13,0.769,11,39,50,14,11,2,14,18,85,Vlatko Čančar
2021-2022,Denver Nuggets,PF,15,1,176,23,41,0.561,7,12,0.583,16,29,0.552,0.646,9,14,0.643,8,23,31,17,2,3,9,18,62,Vlatko Čančar
2022-2023,Denver Nuggets,PF,60,9,889,108,227,0.476,43,115,0.374,65,112,0.58,0.57,38,41,0.927,24,104,128,80,22,14,37,84,297,Vlatko Čančar
2024-2025,Denver Nuggets,PF,4,0,34,4,7,0.571,1,2,0.5,3,5,0.6,0.643,0,0,,3,5,8,0,0,1,2,4,9,Vlatko Čančar
2020-2021,Orlando Magic,PG,8,0,74,11,28,0.393,6,16,0.375,5,12,0.417,0.5,6,7,0.857,0,5,5,1,5,1,2,9,34,Devin Cannady
2021-2022,Orlando Magic,PG,5,0,145,15,44,0.341,15,37,0.405,0,7,0,0.511,5,7,0.714,1,5,6,10,5,3,5,9,50,Devin Cannady
2014-2015,Houston Rockets,C,12,0,90,14,29,0.483,0,0,,14,29,0.483,0.483,4,23,0.174,10,26,36,2,1,9,5,14,32,Clint Capela
2015-2016,Houston Rockets,C,77,35,1471,231,397,0.582,0,1,0,231,396,0.583,0.582,80,211,0.379,194,300,494,47,59,92,60,190,542,Clint Capela
2016-2017,Houston Rockets,C,65,59,1551,362,563,0.643,0,0,,362,563,0.643,0.643,94,177,0.531,178,348,526,63,34,79,87,179,818,Clint Capela
2017-2018,Houston Rockets,C,74,74,2034,441,676,0.652,0,1,0,441,675,0.653,0.652,144,257,0.56,241,561,802,68,58,137,103,185,1026,Clint Capela
2018-2019,Houston Rockets,C,67,67,2249,474,732,0.648,0,0,,474,732,0.648,0.648,166,261,0.636,298,550,848,96,44,102,94,168,1114,Clint Capela
2019-2020,Houston Rockets,C,39,39,1279,244,388,0.629,0,0,,244,388,0.629,0.629,55,104,0.529,168,369,537,48,33,72,63,102,543,Clint Capela
2020-2021,Atlanta Hawks,C,63,63,1898,413,695,0.594,0,0,,413,695,0.594,0.594,130,227,0.573,297,606,903,49,44,129,73,145,956,Clint Capela
2021-2022,Atlanta Hawks,C,74,73,2042,370,604,0.613,0,1,0,370,603,0.614,0.613,80,169,0.473,279,598,877,92,55,93,44,166,820,Clint Capela
2022-2023,Atlanta Hawks,C,65,63,1730,350,536,0.653,0,1,0,350,535,0.654,0.653,79,131,0.603,258,459,717,58,45,79,54,139,779,Clint Capela
2023-2024,Atlanta Hawks,C,73,73,1883,353,618,0.571,0,1,0,353,617,0.572,0.571,130,206,0.631,335,441,776,91,43,106,74,164,836,Clint Capela
2024-2025,Atlanta Hawks,C,31,31,712,135,236,0.572,0,0,,135,236,0.572,0.572,31,58,0.534,109,174,283,40,18,32,28,60,301,Clint Capela
2020-2021,Charlotte Hornets,C,19,4,115,18,36,0.5,1,7,0.143,17,29,0.586,0.514,9,11,0.818,6,21,27,2,1,5,5,13,46,Vernon Carey Jr.
2021-2022,Total,C,7,1,44,7,13,0.538,0,0,,7,13,0.538,0.538,6,13,0.462,8,4,12,0,2,1,3,4,20,Vernon Carey Jr.
2021-2022,Charlotte Hornets,C,4,1,17,3,6,0.5,0,0,,3,6,0.5,0.5,2,3,0.667,3,2,5,0,1,0,1,1,8,Vernon Carey Jr.
2021-2022,Washington Wizards,C,3,0,27,4,7,0.571,0,0,,4,7,0.571,0.571,4,10,0.4,5,2,7,0,1,1,2,3,12,Vernon Carey Jr.
2022-2023,Washington Wizards,C,11,0,28,2,8,0.25,0,0,,2,8,0.25,0.25,2,2,1,3,8,11,3,2,2,2,5,6,Vernon Carey Jr.
2024-2025,Oklahoma City Thunder,C,5,0,18,1,7,0.143,0,5,0,1,2,0.5,0.143,2,2,1,3,5,8,2,1,1,0,1,4,Branden Carlson
2024-2025,Washington Wizards,PG,28,19,822,91,234,0.389,42,124,0.339,49,110,0.445,0.479,22,27,0.815,10,109,119,106,23,7,55,86,246,Carlton Carrington
2018-2019,Memphis Grizzlies,PG,39,3,577,56,185,0.303,34,102,0.333,22,83,0.265,0.395,26,32,0.813,14,52,66,69,26,11,33,55,172,Jevon Carter
2019-2020,Phoenix Suns,PG,58,2,945,101,243,0.416,62,146,0.425,39,97,0.402,0.543,23,27,0.852,30,88,118,84,47,17,32,86,287,Jevon Carter
2020-2021,Phoenix Suns,PG,60,1,717,94,223,0.422,56,151,0.371,38,72,0.528,0.547,4,7,0.571,16,76,92,71,29,9,16,56,248,Jevon Carter
2021-2022,Total,PG,66,3,905,98,253,0.387,66,170,0.388,32,83,0.386,0.518,15,18,0.833,14,96,110,96,24,14,34,67,277,Jevon Carter
2021-2022,Brooklyn Nets,PG,46,1,552,58,174,0.333,42,127,0.331,16,47,0.34,0.454,7,10,0.7,9,58,67,46,14,10,26,45,165,Jevon Carter
2021-2022,Milwaukee Bucks,PG,20,2,353,40,79,0.506,24,43,0.558,16,36,0.444,0.658,8,8,1,5,38,43,50,10,4,8,22,112,Jevon Carter
2022-2023,Milwaukee Bucks,PG,81,39,1810,239,565,0.423,142,337,0.421,97,228,0.425,0.549,31,38,0.816,35,167,202,197,66,29,78,158,651,Jevon Carter
2023-2024,Chicago Bulls,PG,72,0,1004,138,365,0.378,77,234,0.329,61,131,0.466,0.484,4,7,0.571,11,49,60,94,37,16,36,71,357,Jevon Carter
2024-2025,Chicago Bulls,PG,14,0,97,18,42,0.429,11,28,0.393,7,14,0.5,0.56,1,2,0.5,2,11,13,12,5,0,6,4,48,Jevon Carter
2018-2019,Chicago Bulls,C,44,44,1110,180,371,0.485,6,32,0.188,174,339,0.513,0.493,89,112,0.795,87,220,307,78,26,58,65,152,455,Wendell Carter Jr.
2019-2020,Chicago Bulls,C,43,43,1256,183,343,0.534,6,29,0.207,177,314,0.564,0.542,112,152,0.737,139,266,405,51,33,36,72,162,484,Wendell Carter Jr.
2020-2021,Total,C,54,44,1375,230,457,0.503,15,51,0.294,215,406,0.53,0.52,131,179,0.732,132,311,443,104,35,42,78,146,606,Wendell Carter Jr.
2020-2021,Chicago Bulls,C,32,25,792,129,252,0.512,8,22,0.364,121,230,0.526,0.528,82,111,0.739,70,180,250,69,18,24,49,96,348,Wendell Carter Jr.
2020-2021,Orlando Magic,C,22,19,583,101,205,0.493,7,29,0.241,94,176,0.534,0.51,49,68,0.721,62,131,193,35,17,18,29,50,258,Wendell Carter Jr.
2021-2022,Orlando Magic,PF,62,61,1852,359,684,0.525,70,214,0.327,289,470,0.615,0.576,143,207,0.691,139,509,648,171,36,43,117,169,931,Wendell Carter Jr.
2022-2023,Orlando Magic,C,57,54,1690,322,613,0.525,80,225,0.356,242,388,0.624,0.591,144,195,0.738,120,377,497,132,30,33,106,159,868,Wendell Carter Jr.
2023-2024,Orlando Magic,C,55,48,1406,223,425,0.525,64,171,0.374,159,254,0.626,0.6,93,134,0.694,112,269,381,95,35,28,68,121,603,Wendell Carter Jr.
2024-2025,Orlando Magic,C,20,17,492,48,107,0.449,7,39,0.179,41,68,0.603,0.481,38,51,0.745,33,111,144,45,14,13,14,49,141,Wendell Carter Jr.
2013-2014,Philadelphia 76ers,PG,70,70,2414,427,1054,0.405,55,208,0.264,372,846,0.44,0.431,258,367,0.703,101,336,437,441,130,43,247,213,1167,Michael Carter-Williams
2014-2015,Total,PG,66,63,2149,364,919,0.396,36,153,0.235,328,766,0.428,0.416,202,291,0.694,64,289,353,442,111,30,253,167,966,Michael Carter-Williams
2014-2015,Philadelphia 76ers,PG,41,38,1391,232,611,0.38,32,125,0.256,200,486,0.412,0.406,117,182,0.643,43,211,254,302,60,18,174,103,613,Michael Carter-Williams
2014-2015,Milwaukee Bucks,PG,25,25,758,132,308,0.429,4,28,0.143,128,280,0.457,0.435,85,109,0.78,21,78,99,140,51,12,79,64,353,Michael Carter-Williams
2015-2016,Milwaukee Bucks,PG,54,37,1649,251,555,0.452,15,55,0.273,236,500,0.472,0.466,106,162,0.654,48,228,276,281,80,41,153,162,623,Michael Carter-Williams
2016-2017,Chicago Bulls,PG,45,19,846,112,306,0.366,15,64,0.234,97,242,0.401,0.391,58,77,0.753,24,129,153,113,38,23,66,102,297,Michael Carter-Williams
2017-2018,Charlotte Hornets,PG,52,2,835,76,229,0.332,14,59,0.237,62,170,0.365,0.362,73,89,0.82,37,101,138,116,44,23,52,99,239,Michael Carter-Williams
2018-2019,Total,PG,28,1,372,46,123,0.374,10,38,0.263,36,85,0.424,0.415,32,53,0.604,19,51,70,70,20,15,20,48,134,Michael Carter-Williams
2018-2019,Houston Rockets,PG,16,1,145,25,61,0.41,7,19,0.368,18,42,0.429,0.467,12,26,0.462,3,10,13,21,9,6,10,27,69,Michael Carter-Williams
2018-2019,Orlando Magic,PG,12,0,227,21,62,0.339,3,19,0.158,18,43,0.419,0.363,20,27,0.741,16,41,57,49,11,9,10,21,65,Michael Carter-Williams
2019-2020,Orlando Magic,SG,45,0,833,111,260,0.427,22,75,0.293,89,185,0.481,0.469,79,95,0.832,46,101,147,109,49,22,52,87,323,Michael Carter-Williams
2020-2021,Orlando Magic,SG,31,25,800,105,270,0.389,15,61,0.246,90,209,0.431,0.417,49,80,0.613,39,100,139,129,25,17,69,81,274,Michael Carter-Williams
2022-2023,Orlando Magic,PG,4,0,44,6,14,0.429,1,3,0.333,5,11,0.455,0.464,4,7,0.571,1,4,5,7,1,1,4,5,17,Michael Carter-Williams
2023-2024,Toronto Raptors,SG,4,0,36,3,8,0.375,1,4,0.25,2,4,0.5,0.438,4,5,0.8,2,2,4,3,1,0,1,3,11,D.J. Carton
2024-2025,Toronto Raptors,SG,4,0,33,1,7,0.143,0,3,0,1,4,0.25,0.143,1,1,1,0,4,4,3,2,0,4,1,3,D.J. Carton
2017-2018,Los Angeles Lakers,PG,37,7,562,50,116,0.431,13,43,0.302,37,73,0.507,0.487,21,30,0.7,15,50,65,75,23,10,42,52,134,Alex Caruso
2018-2019,Los Angeles Lakers,PG,25,4,531,77,173,0.445,24,50,0.48,53,123,0.431,0.514,51,64,0.797,20,47,67,77,24,9,42,54,229,Alex Caruso
2019-2020,Los Angeles Lakers,PG,64,2,1175,120,291,0.412,40,120,0.333,80,171,0.468,0.481,69,94,0.734,17,106,123,124,70,18,53,98,349,Alex Caruso
2020-2021,Los Angeles Lakers,PG,58,6,1216,133,305,0.436,55,137,0.401,78,168,0.464,0.526,49,76,0.645,31,139,170,160,64,15,76,108,370,Alex Caruso
2021-2022,Chicago Bulls,SG,41,18,1147,102,256,0.398,42,126,0.333,60,130,0.462,0.48,58,73,0.795,33,115,148,165,71,15,57,106,304,Alex Caruso
2022-2023,Chicago Bulls,PG,67,36,1575,130,286,0.455,55,151,0.364,75,135,0.556,0.551,59,73,0.808,42,154,196,193,98,46,77,159,374,Alex Caruso
2023-2024,Chicago Bulls,SG,71,57,2040,253,541,0.468,136,333,0.408,117,208,0.563,0.593,73,96,0.76,62,211,273,247,120,70,102,181,715,Alex Caruso
2024-2025,Oklahoma City Thunder,SG,20,0,398,43,114,0.377,17,65,0.262,26,49,0.531,0.452,7,9,0.778,12,46,58,49,38,12,15,40,110,Alex Caruso
2024-2025,San Antonio Spurs,PG,30,17,771,119,310,0.384,31,115,0.27,88,195,0.451,0.434,68,96,0.708,20,57,77,110,26,10,55,51,337,Stephon Castle
2023-2024,Los Angeles Lakers,C,16,0,59,9,16,0.563,0,0,,9,16,0.563,0.563,6,6,1,6,6,12,3,2,0,3,11,24,Colin Castleton
2024-2025,Memphis Grizzlies,C,8,0,22,1,4,0.25,0,2,0,1,2,0.5,0.25,8,8,1,2,5,7,0,0,1,0,3,10,Colin Castleton
2015-2016,Sacramento Kings,C,66,39,1412,191,339,0.563,0,2,0,191,337,0.567,0.563,81,125,0.648,134,218,352,37,48,66,46,146,463,Willie Cauley-Stein
2016-2017,Sacramento Kings,C,75,21,1421,255,481,0.53,0,2,0,255,479,0.532,0.53,101,151,0.669,85,254,339,80,53,44,69,147,611,Willie Cauley-Stein
2017-2018,Sacramento Kings,C,73,57,2044,388,773,0.502,3,12,0.25,385,761,0.506,0.504,153,247,0.619,131,379,510,172,77,67,109,185,932,Willie Cauley-Stein
2018-2019,Sacramento Kings,C,81,81,2213,412,741,0.556,1,2,0.5,411,739,0.556,0.557,140,254,0.551,181,497,678,194,96,51,84,227,965,Willie Cauley-Stein
2019-2020,Total,C,54,39,1097,175,302,0.579,0,1,0,175,301,0.581,0.579,40,66,0.606,84,231,315,70,49,61,40,121,390,Willie Cauley-Stein
2019-2020,Golden State Warriors,C,41,37,940,144,257,0.56,0,0,,144,257,0.56,0.56,35,57,0.614,71,184,255,60,45,50,35,102,323,Willie Cauley-Stein
2019-2020,Dallas Mavericks,C,13,2,157,31,45,0.689,0,1,0,31,44,0.705,0.689,5,9,0.556,13,47,60,10,4,11,5,19,67,Willie Cauley-Stein
2020-2021,Dallas Mavericks,C,53,16,906,115,182,0.632,1,11,0.091,114,171,0.667,0.635,49,78,0.628,66,170,236,35,21,43,29,129,280,Willie Cauley-Stein
2021-2022,Total,C,20,2,183,16,35,0.457,1,2,0.5,15,33,0.455,0.471,1,2,0.5,13,27,40,10,6,3,7,19,34,Willie Cauley-Stein
2021-2022,Dallas Mavericks,C,18,2,177,16,35,0.457,1,2,0.5,15,33,0.455,0.471,1,2,0.5,13,25,38,9,6,3,7,17,34,Willie Cauley-Stein
2021-2022,Philadelphia 76ers,C,2,0,6,0,0,,0,0,,0,0,,,0,0,,0,2,2,1,0,0,0,2,0,Willie Cauley-Stein
2021-2022,Indiana Pacers,SG,1,0,1,1,1,1,0,0,1,1,1,1,0,0,0,0,0,0,0,0,0,0,2,0,,Ahmad Caver
2022-2023,Total,SF,17,3,320,59,130,0.454,33,82,0.402,26,48,0.542,0.581,14,17,0.824,10,50,60,10,6,5,11,26,165,Julian Champagnie
2022-2023,Philadelphia 76ers,SF,2,0,7,0,2,0,0,1,0,0,1,0,0,0,0,,0,0,0,0,1,0,0,0,0,Julian Champagnie
2022-2023,San Antonio Spurs,SF,15,3,313,59,128,0.461,33,81,0.407,26,47,0.553,0.59,14,17,0.824,10,50,60,10,5,5,11,26,165,Julian Champagnie
2023-2024,San Antonio Spurs,SF,74,59,1468,164,402,0.408,101,277,0.365,63,125,0.504,0.534,75,92,0.815,42,164,206,103,48,42,57,77,504,Julian Champagnie
2024-2025,San Antonio Spurs,SF,31,26,895,134,307,0.436,84,225,0.373,50,82,0.61,0.573,37,41,0.902,23,130,153,43,27,17,35,51,389,Julian Champagnie
2021-2022,Toronto Raptors,SF,36,0,281,31,67,0.463,10,28,0.357,21,39,0.538,0.537,9,9,1,37,35,72,11,8,4,8,32,81,Justin Champagnie
2022-2023,Total,SF,5,0,34,5,15,0.333,1,5,0.2,4,10,0.4,0.367,0,0,,3,5,8,4,1,0,0,2,11,Justin Champagnie
2022-2023,Toronto Raptors,SF,3,0,11,3,3,1,0,0,,3,3,1,1,0,0,,1,3,4,1,0,0,0,1,6,Justin Champagnie
2022-2023,Boston Celtics,SF,2,0,23,2,12,0.167,1,5,0.2,1,7,0.143,0.208,0,0,,2,2,4,3,1,0,0,1,5,Justin Champagnie
2023-2024,Washington Wizards,SF,15,1,235,32,78,0.41,13,45,0.289,19,33,0.576,0.494,12,15,0.8,19,34,53,19,10,9,10,14,89,Justin Champagnie
2024-2025,Washington Wizards,SF,11,8,266,41,79,0.519,12,36,0.333,29,43,0.674,0.595,9,14,0.643,27,46,73,13,13,10,11,24,103,Justin Champagnie
2022-2023,Memphis Grizzlies,PG,36,0,281,35,83,0.422,2,15,0.133,33,68,0.485,0.434,6,13,0.462,9,29,38,58,12,5,18,15,78,Kennedy Chandler
2019-2020,New Orleans Pelicans,PF,4,0,51,6,9,0.667,0,1,0,6,8,0.75,0.667,0,0,3,6,9,3,1,1,4,10,12,0,Zylan Cheatham
2021-2022,Utah Jazz,SF,1,0,5,0,3,0,0,2,0,0,1,0,0,0,0,0,0,0,0,0,0,0,0,0,0,Zylan Cheatham
2018-2019,Houston Rockets,PG,7,0,33,2,8,0.25,2,5,0.4,0,3,0,0.375,0,0,,1,3,4,4,1,1,1,2,6,Chris Chiozza
2019-2020,Total,PG,28,2,401,55,140,0.393,27,72,0.375,28,68,0.412,0.489,5,5,1,9,44,53,83,21,4,32,37,142,Chris Chiozza
2019-2020,Washington Wizards,PG,10,0,123,10,34,0.294,7,16,0.438,3,18,0.167,0.397,0,0,,0,15,15,28,10,2,9,12,27,Chris Chiozza
2019-2020,Brooklyn Nets,PG,18,2,278,45,106,0.425,20,56,0.357,25,50,0.5,0.519,5,5,1,9,29,38,55,11,2,23,25,115,Chris Chiozza
2020-2021,Brooklyn Nets,PG,22,1,232,31,88,0.352,13,42,0.31,18,46,0.391,0.426,13,17,0.765,3,21,24,65,7,6,16,19,88,Chris Chiozza
2021-2022,Golden State Warriors,PG,34,1,372,24,81,0.296,17,53,0.321,7,28,0.25,0.401,2,3,0.667,9,27,36,65,13,0,32,32,67,Chris Chiozza
2024-2025,Toronto Raptors,PF,3,0,14,1,2,0.5,0,0,1,2,0.5,0.5,0,0,2,2,4,1,0,0,2,2,2,0,,Ulrich Chomche
2016-2017,Phoenix Suns,PF,82,75,1743,284,632,0.449,72,224,0.321,212,408,0.52,0.506,113,181,0.624,96,252,348,60,67,70,108,263,753,Marquese Chriss
2017-2018,Phoenix Suns,PF,72,49,1527,202,477,0.423,56,190,0.295,146,287,0.509,0.482,96,158,0.608,76,319,395,83,51,70,107,205,556,Marquese Chriss
2018-2019,Total,PF,43,2,499,67,180,0.372,16,72,0.222,51,108,0.472,0.417,32,45,0.711,40,102,142,22,17,11,36,81,182,Marquese Chriss
2018-2019,Houston Rockets,PF,16,0,104,11,34,0.324,1,15,0.067,10,19,0.526,0.338,6,7,0.857,7,21,28,6,2,4,12,17,29,Marquese Chriss
2018-2019,Cleveland Cavaliers,PF,27,2,395,56,146,0.384,15,57,0.263,41,89,0.461,0.435,26,38,0.684,33,81,114,16,15,7,24,64,153,Marquese Chriss
2019-2020,Golden State Warriors,PF,59,21,1196,210,385,0.545,8,39,0.205,202,346,0.584,0.556,120,156,0.769,114,251,365,114,39,62,78,122,548,Marquese Chriss
2020-2021,Golden State Warriors,PF,2,0,27,5,14,0.357,1,5,0.2,4,9,0.444,0.393,2,4,0.5,3,10,13,2,0,2,2,3,13,Marquese Chriss
2021-2022,Dallas Mavericks,PF,34,0,346,62,134,0.463,8,25,0.32,54,109,0.495,0.493,22,33,0.667,33,70,103,17,13,12,17,64,154,Marquese Chriss
2024-2025,Los Angeles Clippers,SG,1,0,18,2,7,0.286,1,4,0.25,1,3,0.333,0.357,0,0,1,2,3,0,2,0,1,0,5,0,Cam Christie
2022-2023,Los Angeles Lakers,SG,41,3,512,44,106,0.415,26,62,0.419,18,44,0.409,0.538,14,16,0.875,7,68,75,21,9,7,13,33,128,Max Christie
2023-2024,Los Angeles Lakers,SG,67,7,944,103,241,0.427,42,118,0.356,61,123,0.496,0.515,36,46,0.783,15,127,142,60,20,17,35,57,284,Max Christie
2024-2025,Los Angeles Lakers,SG,29,8,621,62,145,0.428,24,70,0.343,38,75,0.507,0.51,52,60,0.867,21,48,69,34,25,10,22,42,200,Max Christie
2021-2022,Houston Rockets,SG,74,2,1334,224,500,0.448,56,189,0.296,168,311,0.54,0.504,83,113,0.735,52,134,186,150,65,13,114,97,587,Josh Christopher
2022-2023,Houston Rockets,SG,64,2,786,153,329,0.465,21,89,0.236,132,240,0.55,0.497,45,60,0.75,20,51,71,73,33,15,60,59,372,Josh Christopher
2024-2025,Miami Heat,SG,1,0,2,0,1,0,0,1,0,0,0,,0,0,0,,0,0,0,0,0,0,1,0,0,Josh Christopher
2023-2024,San Antonio Spurs,SF,12,0,141,16,33,0.485,1,12,0.083,15,21,0.714,0.5,12,15,0.8,8,14,22,10,7,3,3,18,45,Sidy Cissoko
2024-2025,San Antonio Spurs,SF,12,0,36,5,11,0.455,3,5,0.6,2,6,0.333,0.591,0,4,0,2,6,8,5,0,0,1,5,13,Sidy Cissoko
2018-2019,Houston Rockets,PF,51,2,641,50,151,0.331,41,138,0.297,9,13,0.692,0.467,7,7,1,24,92,116,18,20,26,7,47,148,Gary Clark
2019-2020,Total,PF,42,5,567,54,133,0.406,39,111,0.351,15,22,0.682,0.553,9,10,0.9,37,73,110,17,6,22,10,46,156,Gary Clark
2019-2020,Houston Rockets,PF,18,0,212,23,59,0.39,18,51,0.353,5,8,0.625,0.542,6,7,0.857,11,29,40,12,2,7,2,21,70,Gary Clark
2019-2020,Orlando Magic,SF,24,5,355,31,74,0.419,21,60,0.35,10,14,0.714,0.561,3,3,1,26,44,70,5,4,15,8,25,86,Gary Clark
2020-2021,Total,SF,39,11,654,40,132,0.303,31,108,0.287,9,24,0.375,0.42,8,10,0.8,33,82,115,31,13,7,17,35,119,Gary Clark
2020-2021,Orlando Magic,SF,35,11,637,40,131,0.305,31,108,0.287,9,23,0.391,0.424,8,10,0.8,33,79,112,30,12,7,17,34,119,Gary Clark
2020-2021,Denver Nuggets,SF,2,0,4,0,0,,0,0,,0,0,,,0,0,,0,1,1,0,0,0,0,0,0,Gary Clark
2020-2021,Philadelphia 76ers,PF,2,0,13,0,1,0,0,0,,0,1,0,0,0,0,,0,2,2,1,1,0,0,1,0,Gary Clark
2021-2022,New Orleans Pelicans,PF,38,1,378,33,88,0.375,28,70,0.4,5,18,0.278,0.534,7,10,0.7,23,67,90,18,13,7,10,20,101,Gary Clark
2019-2020,Memphis Grizzlies,PF,58,4,1300,296,479,0.618,23,64,0.359,273,415,0.658,0.642,85,112,0.759,92,253,345,81,32,48,55,100,700,Brandon Clarke
2020-2021,Memphis Grizzlies,PF,59,16,1415,256,495,0.517,20,77,0.26,236,418,0.565,0.537,78,113,0.69,97,231,328,95,60,51,33,84,610,Brandon Clarke
2021-2022,Memphis Grizzlies,PF,64,1,1246,288,447,0.644,5,22,0.227,283,425,0.666,0.65,85,130,0.654,135,207,342,86,39,68,34,122,666,Brandon Clarke
2022-2023,Memphis Grizzlies,PF,56,8,1090,229,349,0.656,1,6,0.167,228,343,0.665,0.658,99,137,0.723,92,218,310,72,34,37,55,131,558,Brandon Clarke
2023-2024,Memphis Grizzlies,PF,6,1,134,33,59,0.559,1,6,0.167,32,53,0.604,0.568,1,7,0.143,13,19,32,9,5,6,3,8,68,Brandon Clarke
2024-2025,Memphis Grizzlies,PF,31,17,569,103,170,0.606,1,16,0.063,102,154,0.662,0.609,19,31,0.613,52,106,158,31,24,15,16,67,226,Brandon Clarke
2014-2015,Los Angeles Lakers,PG,59,38,1476,267,596,0.448,38,121,0.314,229,475,0.482,0.48,131,158,0.829,56,135,191,206,51,12,96,109,703,Jordan Clarkson
2015-2016,Los Angeles Lakers,SG,79,79,2552,475,1098,0.433,111,320,0.347,364,778,0.468,0.483,164,204,0.804,93,220,313,192,88,7,135,168,1225,Jordan Clarkson
2016-2017,Los Angeles Lakers,SG,82,19,2397,477,1071,0.445,117,356,0.329,360,715,0.503,0.5,134,168,0.798,49,197,246,213,88,8,164,150,1205,Jordan Clarkson
2017-2018,Total,SG,81,2,1888,430,954,0.451,112,318,0.352,318,636,0.5,0.509,152,190,0.8,57,160,217,221,58,6,127,107,1124,Jordan Clarkson
2017-2018,Los Angeles Lakers,SG,53,2,1256,299,667,0.448,68,210,0.324,231,457,0.505,0.499,105,132,0.795,44,115,159,173,39,3,95,63,771,Jordan Clarkson
2017-2018,Cleveland Cavaliers,SG,28,0,632,131,287,0.456,44,108,0.407,87,179,0.486,0.533,47,58,0.81,13,45,58,48,19,3,32,44,353,Jordan Clarkson
2018-2019,Cleveland Cavaliers,SG,81,0,2214,529,1180,0.448,144,445,0.324,385,735,0.524,0.509,162,192,0.844,82,188,270,196,57,13,135,112,1364,Jordan Clarkson
2019-2020,Total,SG,71,2,1705,394,867,0.454,152,413,0.368,242,454,0.533,0.542,138,165,0.836,50,137,187,136,46,16,97,108,1078,Jordan Clarkson
2019-2020,Cleveland Cavaliers,SG,29,0,666,144,326,0.442,59,159,0.371,85,167,0.509,0.532,76,86,0.884,21,48,69,70,17,8,39,33,423,Jordan Clarkson
2019-2020,Utah Jazz,SG,42,2,1039,250,541,0.462,93,254,0.366,157,287,0.547,0.548,62,79,0.785,29,89,118,66,29,8,58,75,655,Jordan Clarkson
2020-2021,Utah Jazz,SG,68,1,1818,457,1075,0.425,208,599,0.347,249,476,0.523,0.522,129,144,0.896,47,227,274,168,61,10,115,110,1251,Jordan Clarkson
2021-2022,Utah Jazz,SG,79,1,2141,466,1113,0.419,190,597,0.318,276,516,0.535,0.504,144,174,0.828,67,206,273,194,66,16,129,149,1266,Jordan Clarkson
2022-2023,Utah Jazz,SG,61,61,1988,458,1031,0.444,155,459,0.338,303,572,0.53,0.519,200,245,0.816,72,174,246,270,33,13,186,120,1271,Jordan Clarkson
2023-2024,Utah Jazz,SG,55,19,1682,337,816,0.413,91,309,0.294,246,507,0.485,0.469,177,201,0.881,49,139,188,277,35,6,146,81,942,Jordan Clarkson
2024-2025,Utah Jazz,SG,18,2,470,96,235,0.409,35,105,0.333,61,130,0.469,0.483,57,71,0.803,10,52,62,74,17,4,44,29,284,Jordan Clarkson
2019-2020,Brooklyn Nets,C,15,0,187,27,48,0.563,1,7,0.143,26,41,0.634,0.573,11,21,0.524,19,25,44,16,1,8,9,14,66,Nic Claxton
2020-2021,Brooklyn Nets,C,32,1,594,90,145,0.621,1,5,0.2,89,140,0.636,0.624,31,64,0.484,43,123,166,28,23,40,18,68,212,Nic Claxton
2021-2022,Brooklyn Nets,C,47,19,974,178,264,0.674,0,0,,178,264,0.674,0.674,54,93,0.581,91,173,264,43,24,51,38,110,410,Nic Claxton
2022-2023,Brooklyn Nets,C,76,76,2271,414,587,0.705,0,2,0,414,585,0.708,0.705,133,246,0.541,184,518,702,144,65,189,96,212,961,Nic Claxton
2023-2024,Brooklyn Nets,C,71,71,2116,366,582,0.629,1,5,0.2,365,577,0.633,0.63,108,196,0.551,193,513,706,147,46,146,93,175,841,Nic Claxton
2024-2025,Brooklyn Nets,C,25,17,634,105,185,0.568,1,8,0.125,104,177,0.588,0.57,28,55,0.509,51,137,188,50,22,31,33,54,239,Nic Claxton
2019-2020,Houston Rockets,SG,33,0,291,57,142,0.401,37,107,0.346,20,35,0.571,0.532,10,11,0.909,4,26,30,27,9,6,19,26,161,Chris Clemons
2024-2025,Portland Trail Blazers,C,23,7,377,56,105,0.533,5,15,0.333,51,90,0.567,0.557,16,22,0.727,65,80,145,12,12,40,25,66,133,Donovan Clingan
2023-2024,Brooklyn Nets,PF,23,4,370,50,93,0.538,12,33,0.364,38,60,0.633,0.602,21,30,0.7,26,55,81,18,8,16,15,25,133,Noah Clowney
2024-2025,Brooklyn Nets,PF,22,4,433,64,157,0.408,42,110,0.382,22,47,0.468,0.541,21,27,0.778,21,61,82,17,7,12,18,63,191,Noah Clowney
2019-2020,Los Angeles Clippers,SG,18,1,159,23,54,0.426,6,19,0.316,17,35,0.486,0.481,6,11,0.545,4,12,16,14,5,2,8,20,58,Amir Coffey
2020-2021,Los Angeles Clippers,SG,44,1,394,45,103,0.437,23,56,0.411,22,47,0.468,0.549,27,38,0.711,10,34,44,22,10,0,15,30,140,Amir Coffey
2021-2022,Los Angeles Clippers,SG,69,30,1567,211,466,0.453,96,254,0.378,115,212,0.542,0.556,101,117,0.863,26,171,197,124,38,15,45,87,619,Amir Coffey
2022-2023,Los Angeles Clippers,SF,50,9,625,56,145,0.386,11,40,0.275,45,105,0.429,0.424,49,63,0.778,17,36,53,53,7,5,21,50,172,Amir Coffey
2023-2024,Los Angeles Clippers,SF,70,13,1460,166,352,0.472,70,184,0.38,96,168,0.571,0.571,61,71,0.859,29,119,148,76,41,14,33,102,463,Amir Coffey
2024-2025,Los Angeles Clippers,SG,30,8,736,106,216,0.491,49,114,0.43,57,102,0.559,0.604,40,48,0.833,16,62,78,36,16,3,20,49,301,Amir Coffey
2024-2025,Utah Jazz,PG,21,2,367,26,86,0.302,5,32,0.156,21,54,0.389,0.331,8,19,0.421,3,40,43,70,16,4,50,38,65,Isaiah Collier
2017-2018,Atlanta Hawks,PF,74,26,1785,314,545,0.576,16,47,0.34,298,498,0.598,0.591,133,186,0.715,176,365,541,98,47,80,105,215,777,John Collins
2018-2019,Atlanta Hawks,PF,61,59,1829,465,831,0.56,55,158,0.348,410,673,0.609,0.593,203,266,0.763,219,376,595,121,22,39,120,199,1188,John Collins
2019-2020,Atlanta Hawks,PF,41,41,1363,353,605,0.583,59,147,0.401,294,458,0.642,0.632,120,150,0.8,116,300,416,60,31,66,75,138,885,John Collins
2020-2021,Atlanta Hawks,PF,63,63,1848,429,771,0.556,83,208,0.399,346,563,0.615,0.61,170,204,0.833,118,349,467,78,34,63,84,193,1111,John Collins
2021-2022,Atlanta Hawks,PF,54,53,1663,339,644,0.526,64,176,0.364,275,468,0.588,0.576,134,169,0.793,93,329,422,98,33,56,60,164,876,John Collins
2022-2023,Atlanta Hawks,PF,71,71,2130,359,707,0.508,70,240,0.292,289,467,0.619,0.557,143,178,0.803,77,385,462,85,42,73,79,220,931,John Collins
2023-2024,Utah Jazz,PF,68,66,1901,397,746,0.532,86,232,0.371,311,514,0.605,0.59,147,185,0.795,157,418,575,77,40,61,98,191,1027,John Collins
2024-2025,Utah Jazz,PF,26,17,780,168,321,0.523,36,85,0.424,132,236,0.559,0.579,88,101,0.871,58,156,214,65,29,22,67,75,460,John Collins
2017-2018,Portland Trail Blazers,C,66,1,1045,115,289,0.398,35,113,0.31,80,176,0.455,0.458,27,42,0.643,45,176,221,52,17,31,58,133,292,Zach Collins
2018-2019,Portland Trail Blazers,C,77,0,1356,189,400,0.473,40,121,0.331,149,279,0.534,0.523,94,126,0.746,109,215,324,71,25,66,77,174,512,Zach Collins
2019-2020,Portland Trail Blazers,PF,11,11,290,32,68,0.471,7,19,0.368,25,49,0.51,0.522,6,8,0.75,25,44,69,16,5,5,14,36,77,Zach Collins
2021-2022,San Antonio Spurs,C,28,4,502,76,155,0.49,14,41,0.341,62,114,0.544,0.535,52,65,0.8,46,107,153,61,13,23,45,67,218,Zach Collins
2022-2023,San Antonio Spurs,C,63,26,1441,284,548,0.518,55,147,0.374,229,401,0.571,0.568,108,142,0.761,116,286,402,180,37,49,129,199,731,Zach Collins
2023-2024,San Antonio Spurs,C,69,29,1526,298,616,0.484,58,181,0.32,240,435,0.552,0.531,122,162,0.753,118,252,370,194,34,52,132,206,776,Zach Collins
2024-2025,San Antonio Spurs,C,24,4,341,50,105,0.476,12,36,0.333,38,69,0.551,0.533,28,32,0.875,28,52,80,42,11,12,21,53,140,Zach Collins
2022-2023,Portland Trail Blazers,C,1,0,21,3,5,0.6,0,0,3,5,0.6,0.6,1,4,0.25,2,1,3,0,0,1,0,0,7,0,Chance Comanche
2007-2008,Memphis Grizzlies,PG,53,46,1381,189,442,0.428,30,91,0.33,159,351,0.453,0.462,90,123,0.732,21,118,139,222,44,2,89,85,498,Mike Conley
2008-2009,Memphis Grizzlies,PG,82,61,2508,323,730,0.442,88,217,0.406,235,513,0.458,0.503,161,197,0.817,25,251,276,354,90,8,143,146,895,Mike Conley
2009-2010,Memphis Grizzlies,PG,80,80,2569,369,830,0.445,82,212,0.387,287,618,0.464,0.494,139,187,0.743,30,161,191,425,109,12,170,178,959,Mike Conley
2010-2011,Memphis Grizzlies,PG,81,81,2872,423,953,0.444,80,217,0.369,343,736,0.466,0.486,181,247,0.733,32,215,247,528,144,18,176,182,1107,Mike Conley
2011-2012,Memphis Grizzlies,PG,62,61,2174,296,684,0.433,60,159,0.377,236,525,0.45,0.477,136,158,0.861,22,134,156,404,136,11,125,133,788,Mike Conley
2012-2013,Memphis Grizzlies,PG,80,80,2757,414,940,0.44,106,293,0.362,308,647,0.476,0.497,234,282,0.83,43,182,225,487,174,24,189,171,1168,Mike Conley
2013-2014,Memphis Grizzlies,PG,73,73,2446,463,1030,0.45,105,291,0.361,358,739,0.484,0.5,225,276,0.815,41,172,213,441,110,13,150,141,1256,Mike Conley
2014-2015,Memphis Grizzlies,PG,70,70,2225,393,882,0.446,107,277,0.386,286,605,0.473,0.506,214,249,0.859,29,180,209,375,89,14,156,139,1107,Mike Conley
2015-2016,Memphis Grizzlies,PG,56,56,1761,294,696,0.422,78,215,0.363,216,481,0.449,0.478,191,229,0.834,26,138,164,342,67,16,84,100,857,Mike Conley
2016-2017,Memphis Grizzlies,PG,69,68,2292,464,1009,0.46,171,419,0.408,293,590,0.497,0.545,316,368,0.859,31,210,241,433,92,19,156,126,1415,Mike Conley
2017-2018,Memphis Grizzlies,PG,12,12,373,64,168,0.381,24,77,0.312,40,91,0.44,0.452,53,66,0.803,0,27,27,49,12,3,18,24,205,Mike Conley
2018-2019,Memphis Grizzlies,PG,70,70,2342,490,1120,0.438,155,426,0.364,335,694,0.483,0.507,343,406,0.845,40,199,239,449,94,22,130,123,1478,Mike Conley
2019-2020,Utah Jazz,PG,47,41,1363,232,567,0.409,96,256,0.375,136,311,0.437,0.494,115,139,0.827,33,118,151,208,36,5,92,104,675,Mike Conley
2020-2021,Utah Jazz,PG,51,51,1498,284,640,0.444,138,335,0.412,146,305,0.479,0.552,121,142,0.852,36,141,177,305,70,9,99,98,827,Mike Conley
2021-2022,Utah Jazz,PG,72,72,2058,344,791,0.435,169,414,0.408,175,377,0.464,0.542,129,162,0.796,47,170,217,385,96,21,123,142,986,Mike Conley
2022-2023,Total,PG,67,66,2029,261,610,0.428,135,351,0.385,126,259,0.486,0.539,141,169,0.834,33,149,182,450,73,14,103,139,798,Mike Conley
2022-2023,Utah Jazz,PG,43,42,1276,153,375,0.408,77,213,0.362,76,162,0.469,0.511,78,96,0.813,17,90,107,330,44,10,74,94,461,Mike Conley
2022-2023,Minnesota Timberwolves,PG,24,24,753,108,235,0.46,58,138,0.42,50,97,0.515,0.583,63,73,0.863,16,59,75,120,29,4,29,45,337,Mike Conley
2023-2024,Minnesota Timberwolves,PG,76,76,2193,294,644,0.457,179,405,0.442,115,239,0.481,0.595,102,112,0.911,37,181,218,449,88,17,102,128,869,Mike Conley
2024-2025,Minnesota Timberwolves,PG,26,26,661,67,192,0.349,48,134,0.358,19,58,0.328,0.474,31,34,0.912,13,60,73,117,39,6,33,42,213,Mike Conley
2015-2016,Portland Trail Blazers,SG,34,0,143,13,49,0.265,5,21,0.238,8,28,0.286,0.316,5,5,1,11,21,32,10,2,0,10,6,36,Pat Connaughton
2016-2017,Portland Trail Blazers,SG,39,1,316,37,72,0.514,17,33,0.515,20,39,0.513,0.632,7,9,0.778,10,42,52,28,6,2,17,23,98,Pat Connaughton
2017-2018,Portland Trail Blazers,SG,82,5,1488,165,390,0.423,74,210,0.352,91,180,0.506,0.518,37,44,0.841,36,125,161,91,23,22,43,120,441,Pat Connaughton
2018-2019,Milwaukee Bucks,SG,61,2,1261,163,350,0.466,66,200,0.33,97,150,0.647,0.56,29,40,0.725,61,197,258,122,33,25,33,81,421,Pat Connaughton
2019-2020,Milwaukee Bucks,SG,67,4,1243,137,301,0.455,55,166,0.331,82,135,0.607,0.547,31,40,0.775,60,224,284,107,25,31,52,70,360,Pat Connaughton
2020-2021,Milwaukee Bucks,SG,69,4,1575,168,387,0.434,101,272,0.371,67,115,0.583,0.565,31,40,0.775,63,269,332,81,49,23,33,99,468,Pat Connaughton
2021-2022,Milwaukee Bucks,SF,65,19,1691,227,496,0.458,146,370,0.395,81,126,0.643,0.605,45,54,0.833,45,228,273,82,59,15,35,86,645,Pat Connaughton
2022-2023,Milwaukee Bucks,SF,61,33,1443,165,421,0.392,109,322,0.339,56,99,0.566,0.521,27,41,0.659,50,233,283,77,37,11,33,69,466,Pat Connaughton
2023-2024,Milwaukee Bucks,SF,76,3,1676,151,347,0.435,82,238,0.345,69,109,0.633,0.553,44,58,0.759,51,188,239,161,40,19,49,99,428,Pat Connaughton
2024-2025,Milwaukee Bucks,SG,16,0,269,27,71,0.38,14,45,0.311,13,26,0.5,0.479,9,12,0.75,8,38,46,26,3,5,11,20,77,Pat Connaughton
2019-2020,Total,PF,13,0,54,8,12,0.667,0,0,,8,12,0.667,0.667,7,8,0.875,6,8,14,1,3,0,3,5,23,Tyler Cook
2019-2020,Cleveland Cavaliers,PF,11,0,35,7,10,0.7,0,0,,7,10,0.7,0.7,5,6,0.833,4,6,10,1,1,0,1,4,19,Tyler Cook
2019-2020,Denver Nuggets,SF,2,0,19,1,2,0.5,0,0,,1,2,0.5,0.5,2,2,1,2,2,4,0,2,0,2,1,4,Tyler Cook
2020-2021,Total,SF,32,1,438,69,103,0.67,1,2,0.5,68,101,0.673,0.675,17,35,0.486,28,67,95,17,8,2,21,35,156,Tyler Cook
2020-2021,Brooklyn Nets,PF,4,0,17,1,3,0.333,0,0,,1,3,0.333,0.333,0,0,,1,1,2,2,0,0,1,2,2,Tyler Cook
2020-2021,Detroit Pistons,SF,28,1,421,68,100,0.68,1,2,0.5,67,98,0.684,0.685,17,35,0.486,27,66,93,15,8,2,20,33,154,Tyler Cook
2021-2022,Chicago Bulls,PF,20,2,200,23,38,0.605,0,0,,23,38,0.605,0.605,21,32,0.656,16,37,53,3,4,4,7,28,67,Tyler Cook
2022-2023,Washington Wizards,PF,10,1,126,17,28,0.607,0,1,0,17,27,0.63,0.607,4,10,0.4,16,22,38,6,6,4,8,13,38,Xavier Cooks
2021-2022,Atlanta Hawks,PG,13,0,39,3,14,0.214,1,6,0.167,2,8,0.25,0.25,0,0,0,5,5,5,0,0,5,1,7,0,Sharife Cooper
2023-2024,Washington Wizards,SF,63,15,1715,188,432,0.435,64,185,0.346,124,247,0.502,0.509,92,131,0.702,56,200,256,110,57,48,87,137,532,Bilal Coulibaly
2024-2025,Washington Wizards,SF,26,26,903,124,284,0.437,31,103,0.301,93,181,0.514,0.491,69,88,0.784,37,112,149,91,38,19,54,65,348,Bilal Coulibaly
2023-2024,Philadelphia 76ers,SG,32,0,289,54,112,0.482,12,32,0.375,42,80,0.525,0.536,53,71,0.746,14,32,46,16,8,1,5,17,173,Ricky Council IV
2024-2025,Philadelphia 76ers,SF,21,0,264,36,89,0.404,9,34,0.265,27,55,0.491,0.455,36,42,0.857,13,30,43,16,7,4,8,17,117,Ricky Council IV
2013-2014,Houston Rockets,SF,7,0,34,6,14,0.429,4,11,0.364,2,3,0.667,0.571,0,0,,2,3,5,0,2,0,1,3,16,Robert Covington
2014-2015,Philadelphia 76ers,SF,70,49,1956,299,756,0.396,167,446,0.374,132,310,0.426,0.506,178,217,0.82,65,251,316,105,97,31,128,189,943,Robert Covington
2015-2016,Philadelphia 76ers,SF,67,49,1903,274,712,0.385,170,482,0.353,104,230,0.452,0.504,140,177,0.791,65,354,419,97,105,40,143,232,858,Robert Covington
2016-2017,Philadelphia 76ers,SF,67,67,2119,292,732,0.399,137,412,0.333,155,320,0.484,0.492,143,174,0.822,92,344,436,102,127,69,131,203,864,Robert Covington
2017-2018,Philadelphia 76ers,SF,80,80,2532,345,836,0.413,203,550,0.369,142,286,0.497,0.534,116,136,0.853,55,378,433,156,137,72,126,238,1009,Robert Covington
2018-2019,Total,SF,35,35,1203,156,362,0.431,85,225,0.378,71,137,0.518,0.548,68,89,0.764,28,165,193,46,74,47,47,126,465,Robert Covington
2018-2019,Philadelphia 76ers,SF,13,13,440,50,117,0.427,30,77,0.39,20,40,0.5,0.556,17,23,0.739,7,60,67,14,24,23,22,45,147,Robert Covington
2018-2019,Minnesota Timberwolves,SF,22,22,763,106,245,0.433,55,148,0.372,51,97,0.526,0.545,51,66,0.773,21,105,126,32,50,24,25,81,318,Robert Covington
2019-2020,Total,PF,70,68,2137,305,723,0.422,161,480,0.335,144,243,0.593,0.533,99,124,0.798,63,400,463,88,115,93,103,220,870,Robert Covington
2019-2020,Minnesota Timberwolves,PF,48,47,1411,216,496,0.435,108,312,0.346,108,184,0.587,0.544,75,94,0.798,36,251,287,56,80,45,73,148,615,Robert Covington
2019-2020,Houston Rockets,C,22,21,726,89,227,0.392,53,168,0.315,36,59,0.61,0.509,24,30,0.8,27,149,176,32,35,48,30,72,255,Robert Covington
2020-2021,Portland Trail Blazers,PF,70,70,2243,204,509,0.401,135,356,0.379,69,153,0.451,0.533,50,62,0.806,61,405,466,117,101,84,64,195,593,Robert Covington
2021-2022,Total,PF,71,42,1940,209,498,0.42,128,339,0.378,81,159,0.509,0.548,58,69,0.841,59,332,391,92,103,91,75,190,604,Robert Covington
2021-2022,Portland Trail Blazers,PF,48,40,1431,128,336,0.381,79,230,0.343,49,106,0.462,0.499,30,36,0.833,41,233,274,68,74,63,58,132,365,Robert Covington
2021-2022,Los Angeles Clippers,PF,23,2,509,81,162,0.5,49,109,0.45,32,53,0.604,0.651,28,33,0.848,18,99,117,24,29,28,17,58,239,Robert Covington
2022-2023,Los Angeles Clippers,PF,48,0,779,102,229,0.445,54,136,0.397,48,93,0.516,0.563,30,40,0.75,31,135,166,57,38,33,32,86,288,Robert Covington
2023-2024,Total,PF,29,6,488,43,98,0.439,19,56,0.339,24,42,0.571,0.536,22,26,0.846,31,66,97,24,39,18,11,56,127,Robert Covington
2023-2024,Los Angeles Clippers,PF,3,3,69,3,9,0.333,2,8,0.25,1,1,1,0.444,1,2,0.5,2,6,8,7,6,2,0,7,9,Robert Covington
2023-2024,Philadelphia 76ers,SF,26,3,419,40,89,0.449,17,48,0.354,23,41,0.561,0.545,21,24,0.875,29,60,89,17,33,16,11,49,118,Robert Covington
2013-2014,Portland Trail Blazers,SG,15,0,100,12,33,0.364,6,14,0.429,6,19,0.316,0.455,3,4,0.75,1,8,9,6,2,1,3,10,33,Allen Crabbe
2014-2015,Portland Trail Blazers,SG,51,9,683,63,153,0.412,30,85,0.353,33,68,0.485,0.51,12,16,0.75,7,66,73,39,19,15,15,74,168,Allen Crabbe
2015-2016,Portland Trail Blazers,SG,81,8,2105,311,678,0.459,112,285,0.393,199,393,0.506,0.541,98,113,0.867,27,189,216,99,63,16,64,192,832,Allen Crabbe
2016-2017,Portland Trail Blazers,SG,79,7,2254,303,647,0.468,134,302,0.444,169,345,0.49,0.572,105,124,0.847,19,207,226,94,54,20,62,171,845,Allen Crabbe
2017-2018,Brooklyn Nets,SG,75,68,2197,337,827,0.407,201,532,0.378,136,295,0.461,0.529,115,135,0.852,28,296,324,117,47,35,78,168,990,Allen Crabbe
2018-2019,Brooklyn Nets,SG,43,20,1133,137,373,0.367,98,259,0.378,39,114,0.342,0.499,41,56,0.732,16,132,148,46,23,13,46,102,413,Allen Crabbe
2019-2020,Total,SG,37,1,653,63,177,0.356,36,119,0.303,27,58,0.466,0.458,10,14,0.714,11,66,77,33,15,4,17,47,172,Allen Crabbe
2019-2020,Atlanta Hawks,SG,28,1,522,52,143,0.364,30,93,0.323,22,50,0.44,0.469,9,12,0.75,10,55,65,28,15,4,12,36,143,Allen Crabbe
2019-2020,Minnesota Timberwolves,SF,9,0,131,11,34,0.324,6,26,0.231,5,8,0.625,0.412,1,2,0.5,1,11,12,5,0,0,5,11,29,Allen Crabbe
2017-2018,Denver Nuggets,SF,39,5,629,62,137,0.453,17,58,0.293,45,79,0.57,0.515,22,35,0.629,40,87,127,25,12,15,20,63,163,Torrey Craig
2018-2019,Denver Nuggets,SF,75,37,1503,160,362,0.442,61,188,0.324,99,174,0.569,0.526,49,70,0.7,89,174,263,72,37,46,44,175,430,Torrey Craig
2019-2020,Denver Nuggets,SF,58,27,1072,124,269,0.461,45,138,0.326,79,131,0.603,0.545,22,36,0.611,63,126,189,47,23,36,25,135,315,Torrey Craig
2020-2021,Total,SF,50,8,803,109,227,0.48,39,106,0.368,70,121,0.579,0.566,17,22,0.773,57,140,197,49,28,26,25,83,274,Torrey Craig
2020-2021,Milwaukee Bucks,SF,18,0,201,18,46,0.391,8,22,0.364,10,24,0.417,0.478,1,2,0.5,13,30,43,16,9,7,5,24,45,Torrey Craig
2020-2021,Phoenix Suns,SF,32,8,602,91,181,0.503,31,84,0.369,60,97,0.619,0.588,16,20,0.8,44,110,154,33,19,19,20,59,229,Torrey Craig
2021-2022,Total,SF,78,16,1596,200,441,0.454,77,234,0.329,123,207,0.594,0.541,39,52,0.75,86,224,310,91,46,36,67,151,516,Torrey Craig
2021-2022,Indiana Pacers,SF,51,14,1034,128,281,0.456,46,138,0.333,82,143,0.573,0.537,27,35,0.771,59,136,195,58,24,19,39,95,329,Torrey Craig
2021-2022,Phoenix Suns,SF,27,2,562,72,160,0.45,31,96,0.323,41,64,0.641,0.547,12,17,0.706,27,88,115,33,22,17,28,56,187,Torrey Craig
2022-2023,Phoenix Suns,PF,79,60,1948,228,500,0.456,100,253,0.395,128,247,0.518,0.556,32,45,0.711,145,281,426,117,50,62,73,179,588,Torrey Craig
2023-2024,Chicago Bulls,SF,53,14,1049,108,251,0.43,60,153,0.392,48,98,0.49,0.55,27,36,0.75,69,148,217,58,30,21,32,110,303,Torrey Craig
2024-2025,Chicago Bulls,SF,7,1,80,14,27,0.519,8,21,0.381,6,6,1,0.667,2,2,1,5,12,17,3,1,1,0,13,38,Torrey Craig
2012-2013,Dallas Mavericks,SF,78,16,1353,141,367,0.384,63,192,0.328,78,175,0.446,0.47,47,73,0.644,35,152,187,94,63,17,49,128,392,Jae Crowder
2013-2014,Dallas Mavericks,SF,78,8,1254,130,296,0.439,50,151,0.331,80,145,0.552,0.524,46,61,0.754,46,148,194,60,59,21,41,100,356,Jae Crowder
2014-2015,Total,SF,82,17,1647,229,545,0.42,61,208,0.293,168,337,0.499,0.476,109,141,0.773,72,221,293,94,72,25,49,137,628,Jae Crowder
2014-2015,Dallas Mavericks,SF,25,0,265,33,76,0.434,13,38,0.342,20,38,0.526,0.52,10,11,0.909,12,17,29,12,15,5,10,26,89,Jae Crowder
2014-2015,Boston Celtics,SF,57,17,1382,196,469,0.418,48,170,0.282,148,299,0.495,0.469,99,130,0.762,60,204,264,82,57,20,39,111,539,Jae Crowder
2015-2016,Boston Celtics,SF,73,73,2308,360,813,0.443,122,363,0.336,238,450,0.529,0.518,196,239,0.82,70,303,373,135,126,35,83,198,1038,Jae Crowder
2016-2017,Boston Celtics,SF,72,72,2335,333,720,0.463,157,394,0.398,176,326,0.54,0.572,176,217,0.811,48,367,415,155,73,23,80,161,999,Jae Crowder
2017-2018,Total,SF,80,47,2090,271,671,0.404,110,341,0.323,161,330,0.488,0.486,121,148,0.818,59,216,275,99,64,21,74,187,773,Jae Crowder
2017-2018,Cleveland Cavaliers,SF,53,47,1346,157,376,0.418,62,189,0.328,95,187,0.508,0.5,78,92,0.848,41,132,173,58,41,12,42,124,454,Jae Crowder
2017-2018,Utah Jazz,SF,27,0,744,114,295,0.386,48,152,0.316,66,143,0.462,0.468,43,56,0.768,18,84,102,41,23,9,32,63,319,Jae Crowder
2018-2019,Utah Jazz,SF,80,11,2166,318,797,0.399,173,522,0.331,145,275,0.527,0.508,142,197,0.721,60,324,384,133,64,31,85,170,951,Jae Crowder
2019-2020,Total,SF,65,53,1875,226,563,0.401,135,394,0.343,91,169,0.538,0.521,97,125,0.776,52,332,384,161,72,24,69,143,684,Jae Crowder
2019-2020,Memphis Grizzlies,SF,45,45,1322,147,399,0.368,78,266,0.293,69,133,0.519,0.466,75,95,0.789,40,237,277,125,47,14,54,85,447,Jae Crowder
2019-2020,Miami Heat,PF,20,8,553,79,164,0.482,57,128,0.445,22,36,0.611,0.655,22,30,0.733,12,95,107,36,25,10,15,58,237,Jae Crowder
2020-2021,Phoenix Suns,PF,60,42,1648,199,492,0.404,148,380,0.389,51,112,0.455,0.555,57,75,0.76,32,250,282,127,48,27,55,125,603,Jae Crowder
2021-2022,Phoenix Suns,PF,67,67,1886,217,544,0.399,127,365,0.348,90,179,0.503,0.516,71,90,0.789,30,324,354,124,95,30,55,173,632,Jae Crowder
2022-2023,Milwaukee Bucks,PF,18,3,340,45,94,0.479,24,55,0.436,21,39,0.538,0.606,10,12,0.833,17,52,69,27,12,6,7,27,124,Jae Crowder
2023-2024,Milwaukee Bucks,PF,50,25,1156,114,270,0.422,58,166,0.349,56,104,0.538,0.53,26,36,0.722,31,130,161,66,38,9,23,74,312,Jae Crowder
2024-2025,Sacramento Kings,SF,6,2,89,6,17,0.353,3,12,0.25,3,5,0.6,0.441,5,6,0.833,6,11,17,4,3,0,4,10,20,Jae Crowder
2023-2024,New Orleans Pelicans,PG,1,0,3,0,1,0,0,0,0,1,0,0,0,0,0,0,0,0,0,0,0,0,0,0,,Jalen Crutcher
2024-2025,Brooklyn Nets,SG,5,0,10,1,7,0.143,0,3,0,1,4,0.25,0.143,1,2,0.5,0,2,2,0,0,0,0,0,3,Cui Yongxi
2019-2020,Minnesota Timberwolves,SG,63,35,1506,230,569,0.404,66,221,0.299,164,348,0.471,0.462,54,117,0.462,70,142,212,110,57,38,81,125,580,Jarrett Culver
2020-2021,Minnesota Timberwolves,SG,34,7,499,69,168,0.411,13,53,0.245,56,115,0.487,0.449,29,48,0.604,34,70,104,24,17,9,28,58,180,Jarrett Culver
2021-2022,Memphis Grizzlies,SG,37,0,338,51,135,0.378,12,47,0.255,39,88,0.443,0.422,16,34,0.471,13,35,48,33,20,5,20,42,130,Jarrett Culver
2022-2023,Atlanta Hawks,SF,10,1,137,17,43,0.395,1,12,0.083,16,31,0.516,0.407,9,13,0.692,10,28,38,6,6,2,7,14,44,Jarrett Culver
2021-2022,Detroit Pistons,SG,64,64,2088,429,1031,0.416,114,363,0.314,315,668,0.472,0.471,142,168,0.845,58,296,354,356,78,43,234,200,1114,Cade Cunningham
2022-2023,Detroit Pistons,PG,12,12,400,93,224,0.415,17,61,0.279,76,163,0.466,0.453,36,43,0.837,12,62,74,72,10,7,39,34,239,Cade Cunningham
2023-2024,Detroit Pistons,PG,62,62,2074,524,1167,0.449,119,335,0.355,405,832,0.487,0.5,238,274,0.869,33,235,268,464,56,22,212,153,1405,Cade Cunningham
2024-2025,Detroit Pistons,PG,27,27,979,244,543,0.449,66,177,0.373,178,366,0.486,0.51,100,125,0.8,28,158,186,263,23,24,121,76,654,Cade Cunningham
2013-2014,Total,PG,2,0,13,1,3,0.333,1,1,1,0,2,0,0.5,0,0,,0,1,1,0,2,0,0,0,3,Seth Curry
2013-2014,Memphis Grizzlies,PG,1,0,4,0,0,,0,0,,0,0,,,0,0,,0,0,0,0,0,0,0,0,0,Seth Curry
2013-2014,Cleveland Cavaliers,PG,1,0,9,1,3,0.333,1,1,1,0,2,0,0.5,0,0,,0,1,1,0,2,0,0,0,3,Seth Curry
2014-2015,Phoenix Suns,PG,2,0,8,0,3,0,0,1,0,0,2,0,0,0,0,,0,2,2,1,0,0,0,2,0,Seth Curry
2015-2016,Sacramento Kings,PG,44,9,692,102,224,0.455,50,111,0.45,52,113,0.46,0.567,45,54,0.833,9,51,60,67,22,3,36,41,299,Seth Curry
2016-2017,Dallas Mavericks,PG,70,42,2029,338,703,0.481,137,322,0.425,201,381,0.528,0.578,85,100,0.85,25,154,179,189,79,7,92,126,898,Seth Curry
2018-2019,Portland Trail Blazers,SG,74,2,1399,212,465,0.456,113,251,0.45,99,214,0.463,0.577,44,52,0.846,27,93,120,66,36,12,61,97,581,Seth Curry
2019-2020,Dallas Mavericks,SG,64,25,1576,284,574,0.495,145,321,0.452,139,253,0.549,0.621,80,97,0.825,27,118,145,124,38,9,62,113,793,Seth Curry
2020-2021,Philadelphia 76ers,SG,57,57,1638,258,552,0.467,126,280,0.45,132,272,0.485,0.582,69,77,0.896,10,126,136,155,44,8,65,96,711,Seth Curry
2021-2022,Total,SG,64,64,2135,360,739,0.487,158,374,0.422,202,365,0.553,0.594,82,94,0.872,21,179,200,230,53,14,109,148,960,Seth Curry
2021-2022,Philadelphia 76ers,SG,45,45,1566,256,528,0.485,100,250,0.4,156,278,0.561,0.58,64,73,0.877,17,134,151,181,36,11,84,101,676,Seth Curry
2021-2022,Brooklyn Nets,SG,19,19,569,104,211,0.493,58,124,0.468,46,87,0.529,0.63,18,21,0.857,4,45,49,49,17,3,25,47,284,Seth Curry
2022-2023,Brooklyn Nets,SG,61,7,1211,208,449,0.463,94,232,0.405,114,217,0.525,0.568,51,55,0.927,13,87,100,99,36,7,51,96,561,Seth Curry
2023-2024,Total,SG,44,4,616,80,204,0.392,38,108,0.352,42,96,0.438,0.485,28,31,0.903,18,50,68,44,22,6,21,39,226,Seth Curry
2023-2024,Dallas Mavericks,SG,36,3,457,54,145,0.372,29,80,0.363,25,65,0.385,0.472,17,19,0.895,15,37,52,30,17,3,16,32,154,Seth Curry
2023-2024,Charlotte Hornets,SG,8,1,159,26,59,0.441,9,28,0.321,17,31,0.548,0.517,11,12,0.917,3,13,16,14,5,3,5,7,72,Seth Curry
2024-2025,Charlotte Hornets,SG,27,5,336,44,99,0.444,22,53,0.415,22,46,0.478,0.556,9,11,0.818,10,26,36,12,13,4,7,27,119,Seth Curry
2009-2010,Golden State Warriors,PG,80,77,2896,528,1143,0.462,166,380,0.437,362,763,0.474,0.535,177,200,0.885,48,308,356,472,152,19,243,252,1399,Stephen Curry
2010-2011,Golden State Warriors,PG,74,74,2489,505,1053,0.48,151,342,0.442,354,711,0.498,0.551,212,227,0.934,52,234,286,432,109,20,226,233,1373,Stephen Curry
2011-2012,Golden State Warriors,PG,26,23,732,145,296,0.49,55,121,0.455,90,175,0.514,0.583,38,47,0.809,15,73,88,138,39,8,65,62,383,Stephen Curry
2012-2013,Golden State Warriors,PG,78,78,2983,626,1388,0.451,272,600,0.453,354,788,0.449,0.549,262,291,0.9,59,255,314,539,126,12,240,198,1786,Stephen Curry
2013-2014,Golden State Warriors,PG,78,78,2846,652,1383,0.471,261,615,0.424,391,768,0.509,0.566,308,348,0.885,46,288,334,666,128,14,294,194,1873,Stephen Curry
2014-2015,Golden State Warriors,PG,80,80,2613,653,1341,0.487,286,646,0.443,367,695,0.528,0.594,308,337,0.914,56,285,341,619,163,16,249,158,1900,Stephen Curry
2015-2016,Golden State Warriors,PG,79,79,2700,805,1598,0.504,402,886,0.454,403,712,0.566,0.63,363,400,0.908,68,362,430,527,169,15,262,161,2375,Stephen Curry
2016-2017,Golden State Warriors,PG,79,79,2638,675,1443,0.468,324,789,0.411,351,654,0.537,0.58,325,362,0.898,61,292,353,524,142,17,239,183,1999,Stephen Curry
2017-2018,Golden State Warriors,PG,51,51,1631,428,864,0.495,212,501,0.423,216,363,0.595,0.618,278,302,0.921,36,225,261,310,80,8,153,114,1346,Stephen Curry
2018-2019,Golden State Warriors,PG,69,69,2331,632,1340,0.472,354,810,0.437,278,530,0.525,0.604,263,287,0.916,45,324,369,361,92,25,192,166,1881,Stephen Curry
2019-2020,Golden State Warriors,PG,5,5,139,33,82,0.402,12,49,0.245,21,33,0.636,0.476,26,26,1,4,22,26,33,5,2,16,11,104,Stephen Curry
2020-2021,Golden State Warriors,PG,63,63,2152,658,1365,0.482,337,801,0.421,321,564,0.569,0.605,362,395,0.916,29,316,345,363,77,8,213,119,2015,Stephen Curry
2021-2022,Golden State Warriors,PG,64,64,2211,535,1224,0.437,285,750,0.38,250,474,0.527,0.554,275,298,0.923,34,301,335,404,85,23,206,130,1630,Stephen Curry
2022-2023,Golden State Warriors,PG,56,56,1941,559,1133,0.493,273,639,0.427,286,494,0.579,0.614,257,281,0.915,39,302,341,352,52,20,179,117,1648,Stephen Curry
2023-2024,Golden State Warriors,PG,74,74,2421,650,1445,0.45,357,876,0.408,293,569,0.515,0.573,299,324,0.923,37,293,330,379,54,28,210,117,1956,Stephen Curry
2024-2025,Golden State Warriors,PG,24,24,748,177,399,0.444,102,248,0.411,75,151,0.497,0.571,84,91,0.923,10,105,115,157,28,13,74,25,540,Stephen Curry
2024-2025,Orlando Magic,SF,29,22,723,92,217,0.424,35,106,0.33,57,111,0.514,0.505,24,31,0.774,28,74,102,43,11,6,28,45,243,Tristan Da Silva
2024-2025,New York Knicks,SG,12,0,82,6,20,0.3,5,14,0.357,1,6,0.167,0.425,2,2,1,0,13,13,5,1,2,1,5,19,Pacome Dadiet
2022-2023,New Orleans Pelicans,PG,59,11,1042,87,208,0.418,27,86,0.314,60,122,0.492,0.483,26,40,0.65,36,152,188,134,43,11,57,99,227,Dyson Daniels
2023-2024,New Orleans Pelicans,PG,61,16,1358,139,311,0.447,42,135,0.311,97,176,0.551,0.514,34,53,0.642,62,174,236,164,85,25,59,101,354,Dyson Daniels
2024-2025,Atlanta Hawks,SG,29,29,974,158,346,0.457,36,110,0.327,122,236,0.517,0.509,26,43,0.605,46,101,147,101,90,26,56,73,378,Dyson Daniels
2020-2021,Charlotte Hornets,SG,7,0,26,2,7,0.286,2,7,0.286,0,0,0.429,3,3,1,1,0,1,1,0,1,1,1,9,0,Nate Darling
2012-2013,New Orleans Pelicans,PF,64,60,1846,349,676,0.516,0,6,0,349,670,0.521,0.516,169,225,0.751,165,357,522,63,75,112,89,158,867,Anthony Davis
2013-2014,New Orleans Pelicans,PF,67,66,2358,522,1005,0.519,2,9,0.222,520,996,0.522,0.52,348,440,0.791,207,466,673,105,89,189,109,200,1394,Anthony Davis
2014-2015,New Orleans Pelicans,PF,68,68,2455,642,1199,0.535,1,12,0.083,641,1187,0.54,0.536,371,461,0.805,173,523,696,149,100,200,95,141,1656,Anthony Davis
2015-2016,New Orleans Pelicans,C,61,61,2164,560,1136,0.493,35,108,0.324,525,1028,0.511,0.508,326,430,0.758,130,497,627,116,78,125,121,148,1481,Anthony Davis
2016-2017,New Orleans Pelicans,C,75,75,2708,770,1526,0.505,40,134,0.299,730,1392,0.524,0.518,519,647,0.802,172,712,884,157,94,167,181,168,2099,Anthony Davis
2017-2018,New Orleans Pelicans,PF,75,75,2727,780,1462,0.534,55,162,0.34,725,1300,0.558,0.552,495,598,0.828,187,645,832,174,115,193,162,159,2110,Anthony Davis
2018-2019,New Orleans Pelicans,C,56,56,1850,530,1026,0.517,48,145,0.331,482,881,0.547,0.54,344,433,0.794,174,498,672,218,88,135,112,132,1452,Anthony Davis
2019-2020,Los Angeles Lakers,PF,62,62,2131,551,1096,0.503,72,218,0.33,479,878,0.546,0.536,444,525,0.846,142,435,577,200,91,143,154,156,1618,Anthony Davis
2020-2021,Los Angeles Lakers,PF,36,36,1162,301,613,0.491,26,100,0.26,275,513,0.536,0.512,158,214,0.738,62,224,286,110,45,59,74,60,786,Anthony Davis
2021-2022,Los Angeles Lakers,C,40,40,1404,370,695,0.532,13,70,0.186,357,625,0.571,0.542,174,244,0.713,106,288,394,122,49,90,82,97,927,Anthony Davis
2022-2023,Los Angeles Lakers,C,56,54,1904,542,962,0.563,19,74,0.257,523,888,0.589,0.573,348,444,0.784,195,507,702,148,59,114,122,146,1451,Anthony Davis
2023-2024,Los Angeles Lakers,C,76,76,2700,713,1283,0.556,29,107,0.271,684,1176,0.582,0.567,421,516,0.816,239,722,961,266,91,178,159,177,1876,Anthony Davis
2024-2025,Los Angeles Lakers,C,29,29,1001,270,519,0.52,19,63,0.302,251,456,0.55,0.539,186,241,0.772,76,255,331,98,37,61,65,55,745,Anthony Davis
2022-2023,Washington Wizards,SG,28,5,423,66,171,0.386,17,70,0.243,49,101,0.485,0.436,14,27,0.519,10,55,65,28,10,8,17,48,163,Johnny Davis
2023-2024,Washington Wizards,SG,50,6,613,62,154,0.403,14,40,0.35,48,114,0.421,0.448,14,24,0.583,18,54,72,32,18,10,13,57,152,Johnny Davis
2024-2025,Washington Wizards,SG,20,0,186,27,58,0.466,6,19,0.316,21,39,0.538,0.517,7,11,0.636,7,25,32,9,12,6,4,16,67,Johnny Davis
2019-2020,Toronto Raptors,SG,72,4,1209,199,436,0.456,94,242,0.388,105,194,0.541,0.564,51,59,0.864,50,187,237,115,39,14,76,124,543,Terence Davis
2020-2021,Total,SG,61,4,1074,195,456,0.428,98,267,0.367,97,189,0.513,0.535,45,55,0.818,20,134,154,83,44,14,63,97,533,Terence Davis
2020-2021,Toronto Raptors,SG,34,4,493,87,210,0.414,44,122,0.361,43,88,0.489,0.519,16,18,0.889,9,57,66,37,17,7,29,48,234,Terence Davis
2020-2021,Sacramento Kings,SG,27,0,581,108,246,0.439,54,145,0.372,54,101,0.535,0.549,29,37,0.784,11,77,88,46,27,7,34,49,299,Terence Davis
2021-2022,Sacramento Kings,SG,30,11,536,113,267,0.423,49,149,0.329,64,118,0.542,0.515,36,44,0.818,11,83,94,40,25,11,33,70,311,Terence Davis
2022-2023,Sacramento Kings,SG,64,5,841,154,364,0.423,89,243,0.366,65,121,0.537,0.545,34,43,0.791,20,119,139,67,43,12,53,104,431,Terence Davis
2022-2023,Boston Celtics,SG,12,0,66,8,19,0.421,2,7,0.286,6,12,0.5,0.474,1,2,0.5,2,7,9,11,2,2,4,5,19,JD Davison
2023-2024,Boston Celtics,SG,8,0,39,5,12,0.417,3,7,0.429,2,5,0.4,0.542,3,4,0.75,2,8,10,10,1,1,2,4,16,JD Davison
2024-2025,Boston Celtics,PG,5,0,24,2,5,0.4,1,3,0.333,1,2,0.5,0.5,1,2,0.5,0,2,2,1,1,0,6,1,6,JD Davison
2022-2023,Houston Rockets,SF,4,0,25,5,12,0.417,3,10,0.3,2,2,1,0.542,2,2,1,1,5,6,1,0,1,0,2,15,Darius Days
2009-2010,Toronto Raptors,SG,77,65,1664,255,512,0.498,4,16,0.25,251,496,0.506,0.502,148,194,0.763,66,157,223,53,43,18,62,176,662,DeMar DeRozan
2010-2011,Toronto Raptors,SG,82,82,2851,539,1154,0.467,5,52,0.096,534,1102,0.485,0.469,327,402,0.813,75,240,315,148,85,31,144,217,1410,DeMar DeRozan
2011-2012,Toronto Raptors,SG,63,63,2206,381,903,0.422,24,92,0.261,357,811,0.44,0.435,268,331,0.81,40,171,211,128,48,17,123,162,1054,DeMar DeRozan
2012-2013,Toronto Raptors,SG,82,82,3013,548,1231,0.445,34,120,0.283,514,1111,0.463,0.459,355,427,0.831,48,272,320,204,76,24,151,173,1485,DeMar DeRozan
2013-2014,Toronto Raptors,SG,79,79,3017,604,1407,0.429,64,210,0.305,540,1197,0.451,0.452,519,630,0.824,51,292,343,313,86,28,176,197,1791,DeMar DeRozan
2014-2015,Toronto Raptors,SG,60,60,2100,409,990,0.413,25,88,0.284,384,902,0.426,0.426,361,434,0.832,41,236,277,210,73,11,137,122,1204,DeMar DeRozan
2015-2016,Toronto Raptors,SG,78,78,2804,614,1377,0.446,47,139,0.338,567,1238,0.458,0.463,555,653,0.85,64,285,349,315,81,21,175,167,1830,DeMar DeRozan
2016-2017,Toronto Raptors,SG,74,74,2620,721,1545,0.467,33,124,0.266,688,1421,0.484,0.477,545,647,0.842,70,316,386,290,78,13,180,134,2020,DeMar DeRozan
2017-2018,Toronto Raptors,SG,80,80,2711,645,1413,0.456,89,287,0.31,556,1126,0.494,0.488,461,559,0.825,59,256,315,417,85,22,175,151,1840,DeMar DeRozan
2018-2019,San Antonio Spurs,SG,77,77,2688,631,1313,0.481,7,45,0.156,624,1268,0.492,0.483,366,441,0.83,54,408,462,475,86,36,199,177,1635,DeMar DeRozan
2019-2020,San Antonio Spurs,SF,68,68,2316,557,1049,0.531,9,35,0.257,548,1014,0.54,0.535,381,451,0.845,44,331,375,380,70,20,164,180,1504,DeMar DeRozan
2020-2021,San Antonio Spurs,PF,61,61,2056,455,920,0.495,19,74,0.257,436,846,0.515,0.505,387,440,0.88,40,219,259,422,56,15,119,128,1316,DeMar DeRozan
2021-2022,Chicago Bulls,PF,76,76,2743,774,1535,0.504,50,142,0.352,724,1393,0.52,0.521,520,593,0.877,56,336,392,374,68,24,181,178,2118,DeMar DeRozan
2022-2023,Chicago Bulls,SF,74,74,2682,657,1303,0.504,46,142,0.324,611,1161,0.526,0.522,456,523,0.872,34,309,343,377,83,36,153,186,1816,DeMar DeRozan
2023-2024,Chicago Bulls,SF,79,79,2989,650,1355,0.48,75,225,0.333,575,1130,0.509,0.507,522,612,0.853,43,297,340,421,90,45,135,161,1897,DeMar DeRozan
2024-2025,Sacramento Kings,SF,26,26,918,197,410,0.48,17,55,0.309,180,355,0.507,0.501,128,150,0.853,14,85,99,101,38,11,41,50,539,DeMar DeRozan
2013-2014,Total,C,31,6,390,38,83,0.458,0,0,,38,83,0.458,0.458,21,32,0.656,38,89,127,5,7,22,18,66,97,Dewayne Dedmon
2013-2014,Golden State Warriors,C,4,0,6,0,1,0,0,0,,0,1,0,0,1,2,0.5,0,0,0,0,0,0,0,1,1,Dewayne Dedmon
2013-2014,Philadelphia 76ers,C,11,0,150,15,29,0.517,0,0,,15,29,0.517,0.517,7,13,0.538,11,38,49,3,0,9,9,28,37,Dewayne Dedmon
2013-2014,Orlando Magic,C,16,6,234,23,53,0.434,0,0,,23,53,0.434,0.434,13,17,0.765,27,51,78,2,7,13,9,37,59,Dewayne Dedmon
2014-2015,Orlando Magic,C,59,15,845,91,162,0.562,0,1,0,91,161,0.565,0.562,34,64,0.531,118,177,295,9,16,50,51,141,216,Dewayne Dedmon
2015-2016,Orlando Magic,C,58,20,705,99,177,0.559,0,0,,99,177,0.559,0.559,57,76,0.75,67,161,228,13,22,46,32,109,255,Dewayne Dedmon
2016-2017,San Antonio Spurs,C,76,37,1330,161,259,0.622,0,0,,161,259,0.622,0.622,65,93,0.699,129,367,496,44,37,61,61,180,387,Dewayne Dedmon
2017-2018,Atlanta Hawks,C,62,46,1542,250,477,0.524,50,141,0.355,200,336,0.595,0.577,67,86,0.779,100,389,489,90,40,51,86,162,617,Dewayne Dedmon
2018-2019,Atlanta Hawks,C,64,52,1609,259,526,0.492,83,217,0.382,176,309,0.57,0.571,92,113,0.814,105,375,480,90,69,71,84,214,693,Dewayne Dedmon
2019-2020,Total,C,44,18,774,102,255,0.4,22,107,0.206,80,148,0.541,0.443,30,36,0.833,60,189,249,22,25,41,57,133,256,Dewayne Dedmon
2019-2020,Sacramento Kings,C,34,10,541,69,171,0.404,14,71,0.197,55,100,0.55,0.444,23,28,0.821,46,121,167,15,15,26,47,93,175,Dewayne Dedmon
2019-2020,Atlanta Hawks,C,10,8,233,33,84,0.393,8,36,0.222,25,48,0.521,0.44,7,8,0.875,14,68,82,7,10,15,10,40,81,Dewayne Dedmon
2020-2021,Miami Heat,C,16,0,210,46,65,0.708,1,5,0.2,45,60,0.75,0.715,20,27,0.741,28,58,86,12,9,6,13,36,113,Dewayne Dedmon
2021-2022,Miami Heat,C,67,15,1065,164,290,0.566,19,47,0.404,145,243,0.597,0.598,75,100,0.75,105,281,386,47,24,42,70,174,422,Dewayne Dedmon
2022-2023,Total,C,38,1,426,77,151,0.51,12,39,0.308,65,112,0.58,0.55,33,49,0.673,34,100,134,26,9,19,25,75,199,Dewayne Dedmon
2022-2023,Miami Heat,C,30,0,350,64,129,0.496,11,37,0.297,53,92,0.576,0.539,32,44,0.727,28,81,109,16,7,14,19,61,171,Dewayne Dedmon
2022-2023,Philadelphia 76ers,C,8,1,76,13,22,0.591,1,2,0.5,12,20,0.6,0.614,1,5,0.2,6,19,25,10,2,5,6,14,28,Dewayne Dedmon
2013-2014,Cleveland Cavaliers,SG,72,4,1271,122,296,0.412,57,155,0.368,65,141,0.461,0.508,38,48,0.792,29,94,123,187,33,5,60,121,339,Matthew Dellavedova
2014-2015,Cleveland Cavaliers,SG,67,13,1380,111,307,0.362,68,167,0.407,43,140,0.307,0.472,29,38,0.763,37,89,126,204,24,2,61,152,319,Matthew Dellavedova
2015-2016,Cleveland Cavaliers,PG,76,14,1867,207,511,0.405,98,239,0.41,109,272,0.401,0.501,57,66,0.864,33,129,162,337,44,9,116,178,569,Matthew Dellavedova
2016-2017,Milwaukee Bucks,PG,76,54,1986,208,534,0.39,79,215,0.367,129,319,0.404,0.463,82,96,0.854,24,123,147,357,53,0,133,153,577,Matthew Dellavedova
2017-2018,Milwaukee Bucks,PG,38,3,712,55,152,0.362,29,78,0.372,26,74,0.351,0.457,25,27,0.926,14,50,64,145,14,0,49,67,164,Matthew Dellavedova
2018-2019,Total,PG,48,0,812,98,242,0.405,44,130,0.338,54,112,0.482,0.496,42,52,0.808,6,71,77,181,14,2,68,75,282,Matthew Dellavedova
2018-2019,Milwaukee Bucks,PG,12,0,97,6,19,0.316,4,11,0.364,2,8,0.25,0.421,4,4,1,0,10,10,29,2,0,11,9,20,Matthew Dellavedova
2018-2019,Cleveland Cavaliers,PG,36,0,715,92,223,0.413,40,119,0.336,52,104,0.5,0.502,38,48,0.792,6,61,67,152,12,2,57,66,262,Matthew Dellavedova
2019-2020,Cleveland Cavaliers,PG,57,4,821,62,175,0.354,21,91,0.231,41,84,0.488,0.414,32,37,0.865,18,57,75,180,20,2,59,78,177,Matthew Dellavedova
2020-2021,Cleveland Cavaliers,PG,13,1,224,14,56,0.25,4,25,0.16,10,31,0.323,0.286,4,4,1,6,18,24,58,4,1,6,21,36,Matthew Dellavedova
2022-2023,Sacramento Kings,PG,32,0,213,17,50,0.34,9,27,0.333,8,23,0.348,0.43,4,7,0.571,1,12,13,41,7,0,10,20,47,Matthew Dellavedova
2023-2024,Dallas Mavericks,SG,4,0,30,10,19,0.526,1,8,0.125,9,11,0.818,0.553,1,3,0.333,1,8,9,4,0,1,3,1,22,Dexter Dennis
2018-2019,Milwaukee Bucks,SG,27,0,411,50,124,0.403,22,83,0.265,28,41,0.683,0.492,9,12,0.75,16,49,65,31,13,6,19,38,131,Donte DiVincenzo
2019-2020,Milwaukee Bucks,SG,66,24,1520,232,510,0.455,83,247,0.336,149,263,0.567,0.536,63,86,0.733,66,252,318,154,85,20,90,113,610,Donte DiVincenzo
2020-2021,Milwaukee Bucks,SG,66,66,1814,253,603,0.42,131,346,0.379,122,257,0.475,0.528,51,71,0.718,81,299,380,203,72,15,91,112,688,Donte DiVincenzo
2021-2022,Total,SG,42,1,1006,118,336,0.351,74,218,0.339,44,118,0.373,0.461,70,83,0.843,40,130,170,118,48,8,72,69,380,Donte DiVincenzo
2021-2022,Milwaukee Bucks,SG,17,0,341,39,118,0.331,21,74,0.284,18,44,0.409,0.419,23,27,0.852,18,42,60,29,11,3,28,26,122,Donte DiVincenzo
2021-2022,Sacramento Kings,SG,25,1,665,79,218,0.362,53,144,0.368,26,74,0.351,0.484,47,56,0.839,22,88,110,89,37,5,44,43,258,Donte DiVincenzo
2022-2023,Golden State Warriors,SG,72,36,1894,235,540,0.435,150,378,0.397,85,162,0.525,0.574,58,71,0.817,80,245,325,252,97,10,112,133,678,Donte DiVincenzo
2023-2024,New York Knicks,SG,81,63,2360,445,1004,0.443,283,705,0.401,162,299,0.542,0.584,86,114,0.754,63,234,297,216,107,36,113,166,1259,Donte DiVincenzo
2024-2025,Minnesota Timberwolves,SG,30,2,750,97,255,0.38,68,195,0.349,29,60,0.483,0.514,20,25,0.8,11,86,97,101,36,7,48,44,282,Donte DiVincenzo
2022-2023,Los Angeles Clippers,C,22,1,195,24,47,0.511,1,2,0.5,23,45,0.511,0.521,10,16,0.625,31,19,50,4,7,8,9,15,59,Moussa Diabaté
2023-2024,Los Angeles Clippers,C,11,0,64,10,19,0.526,0,0,,10,19,0.526,0.526,9,14,0.643,15,9,24,4,5,1,2,4,29,Moussa Diabaté
2024-2025,Charlotte Hornets,C,28,4,515,46,75,0.613,0,0,,46,75,0.613,0.613,11,25,0.44,92,107,199,18,17,22,26,50,103,Moussa Diabaté
2020-2021,Milwaukee Bucks,PF,14,1,141,16,40,0.4,1,8,0.125,15,32,0.469,0.413,11,14,0.786,8,26,34,8,7,6,3,16,44,Mamadi Diakite
2021-2022,Oklahoma City Thunder,PF,13,3,188,25,47,0.532,0,5,0,25,42,0.595,0.532,6,11,0.545,17,42,59,2,5,9,7,33,56,Mamadi Diakite
2022-2023,Cleveland Cavaliers,C,22,2,176,24,50,0.48,7,21,0.333,17,29,0.586,0.55,2,2,1,8,22,30,8,4,9,12,26,57,Mamadi Diakite
2023-2024,Total,PF,6,0,24,4,6,0.667,0,1,0,4,5,0.8,0.667,4,6,0.667,1,3,4,2,1,1,1,2,12,Mamadi Diakite
2023-2024,San Antonio Spurs,PF,3,0,16,4,5,0.8,0,0,,4,5,0.8,0.8,4,6,0.667,1,2,3,2,0,1,0,1,12,Mamadi Diakite
2023-2024,New York Knicks,PF,3,0,8,0,1,0,0,1,0,0,0,,0,0,0,,0,1,1,0,1,0,1,1,0,Mamadi Diakite
2016-2017,New Orleans Pelicans,PF,17,0,199,36,76,0.474,0,0,,36,76,0.474,0.474,15,21,0.714,23,50,73,4,4,7,7,17,87,Cheick Diallo
2017-2018,New Orleans Pelicans,PF,52,0,581,102,176,0.58,0,0,,102,176,0.58,0.58,50,66,0.758,47,164,211,19,11,21,28,82,254,Cheick Diallo
2018-2019,New Orleans Pelicans,PF,64,1,896,168,271,0.62,1,4,0.25,167,267,0.625,0.622,50,67,0.746,75,257,332,33,29,33,49,113,387,Cheick Diallo
2019-2020,Phoenix Suns,C,47,2,479,92,142,0.648,1,3,0.333,91,139,0.655,0.651,34,39,0.872,30,101,131,22,11,12,32,55,219,Cheick Diallo
2021-2022,Detroit Pistons,C,3,0,31,3,8,0.375,0,0,,3,8,0.375,0.375,5,6,0.833,4,8,12,0,1,0,1,6,11,Cheick Diallo
2018-2019,Oklahoma City Thunder,SG,51,3,526,75,165,0.455,4,24,0.167,71,141,0.504,0.467,36,59,0.61,38,59,97,17,21,10,23,77,190,Hamidou Diallo
2019-2020,Oklahoma City Thunder,SF,46,3,896,132,296,0.446,16,57,0.281,116,239,0.485,0.473,38,63,0.603,44,123,167,36,37,9,51,101,318,Hamidou Diallo
2020-2021,Total,SF,52,9,1226,224,470,0.477,28,82,0.341,196,388,0.505,0.506,128,200,0.64,59,213,272,101,41,24,76,134,604,Hamidou Diallo
2020-2021,Oklahoma City Thunder,SG,32,5,761,143,297,0.481,12,41,0.293,131,256,0.512,0.502,83,132,0.629,37,128,165,77,31,12,49,83,381,Hamidou Diallo
2020-2021,Detroit Pistons,SF,20,4,465,81,173,0.468,16,41,0.39,65,132,0.492,0.514,45,68,0.662,22,85,107,24,10,12,27,51,223,Hamidou Diallo
2021-2022,Detroit Pistons,SG,58,29,1269,261,526,0.496,23,93,0.247,238,433,0.55,0.518,91,140,0.65,69,208,277,73,71,17,58,143,636,Hamidou Diallo
2022-2023,Detroit Pistons,SF,56,0,996,215,375,0.573,5,21,0.238,210,354,0.593,0.58,87,148,0.588,57,137,194,55,53,16,71,124,522,Hamidou Diallo
2023-2024,Washington Wizards,SG,2,0,5,1,2,0.5,0,0,,1,2,0.5,0.5,0,0,,2,0,2,1,2,0,1,1,2,Hamidou Diallo
2023-2024,Toronto Raptors,SG,60,17,1268,189,445,0.425,88,241,0.365,101,204,0.495,0.524,44,51,0.863,27,105,132,68,34,2,50,87,510,Gradey Dick
2024-2025,Toronto Raptors,SG,26,26,833,158,375,0.421,65,184,0.353,93,191,0.487,0.508,88,99,0.889,21,68,89,57,24,6,46,62,469,Gradey Dick
2022-2023,Oklahoma City Thunder,PF,39,1,569,76,181,0.42,26,98,0.265,50,83,0.602,0.492,15,23,0.652,19,86,105,46,14,7,26,42,193,Ousmane Dieng
2023-2024,Oklahoma City Thunder,PF,33,0,365,49,116,0.422,21,70,0.3,28,46,0.609,0.513,14,16,0.875,10,41,51,37,8,5,19,22,133,Ousmane Dieng
2024-2025,Oklahoma City Thunder,PF,17,0,189,20,60,0.333,9,36,0.25,11,24,0.458,0.408,7,11,0.636,9,34,43,13,11,4,4,18,56,Ousmane Dieng
2024-2025,Minnesota Timberwolves,PG,15,0,127,23,51,0.451,9,21,0.429,14,30,0.467,0.539,0,0,1,10,11,25,2,0,16,5,55,0,Rob Dillingham
2014-2015,Detroit Pistons,PG,34,1,455,51,169,0.302,12,65,0.185,39,104,0.375,0.337,31,34,0.912,4,44,48,104,19,6,33,53,145,Spencer Dinwiddie
2015-2016,Detroit Pistons,PG,12,0,159,19,54,0.352,1,10,0.1,18,44,0.409,0.361,19,33,0.576,4,13,17,22,3,0,7,20,58,Spencer Dinwiddie
2016-2017,Brooklyn Nets,PG,59,18,1334,134,302,0.444,38,101,0.376,96,201,0.478,0.507,126,159,0.792,27,137,164,185,44,23,66,119,432,Spencer Dinwiddie
2017-2018,Brooklyn Nets,PG,80,58,2306,324,838,0.387,141,433,0.326,183,405,0.452,0.471,218,268,0.813,40,219,259,524,68,23,128,186,1007,Spencer Dinwiddie
2018-2019,Brooklyn Nets,PG,68,4,1914,366,828,0.442,124,370,0.335,242,458,0.528,0.517,287,356,0.806,26,140,166,311,40,17,152,187,1143,Spencer Dinwiddie
2019-2020,Brooklyn Nets,PG,64,49,1994,424,1021,0.415,123,400,0.308,301,621,0.485,0.476,347,446,0.778,32,189,221,432,40,21,174,180,1318,Spencer Dinwiddie
2020-2021,Brooklyn Nets,SG,3,3,64,6,16,0.375,2,7,0.286,4,9,0.444,0.438,6,6,1,0,13,13,9,2,1,5,4,20,Spencer Dinwiddie
2021-2022,Total,PG,67,51,1980,306,735,0.416,112,330,0.339,194,405,0.479,0.493,195,252,0.774,45,234,279,346,44,13,104,150,919,Spencer Dinwiddie
2021-2022,Washington Wizards,PG,44,44,1330,185,492,0.376,70,226,0.31,115,266,0.432,0.447,116,143,0.811,36,171,207,256,27,7,73,107,556,Spencer Dinwiddie
2021-2022,Dallas Mavericks,PG,23,7,650,121,243,0.498,42,104,0.404,79,139,0.568,0.584,79,109,0.725,9,63,72,90,17,6,31,43,363,Spencer Dinwiddie
2022-2023,Total,SG,79,79,2725,460,1050,0.438,181,490,0.369,279,560,0.498,0.524,268,330,0.812,28,242,270,515,67,24,145,187,1369,Spencer Dinwiddie
2022-2023,Dallas Mavericks,SG,53,53,1808,316,694,0.455,138,341,0.405,178,353,0.504,0.555,170,207,0.821,19,144,163,279,39,16,90,124,940,Spencer Dinwiddie
2022-2023,Brooklyn Nets,PG,26,26,917,144,356,0.404,43,149,0.289,101,207,0.488,0.465,98,123,0.797,9,98,107,236,28,8,55,63,429,Spencer Dinwiddie
2023-2024,Total,PG,76,52,2152,251,640,0.392,124,368,0.337,127,272,0.467,0.489,169,210,0.805,30,175,205,356,51,22,91,138,795,Spencer Dinwiddie
2023-2024,Brooklyn Nets,PG,48,48,1474,195,499,0.391,89,278,0.32,106,221,0.48,0.48,125,160,0.781,26,132,158,288,38,9,62,86,604,Spencer Dinwiddie
2023-2024,Los Angeles Lakers,PG,28,4,678,56,141,0.397,35,90,0.389,21,51,0.412,0.521,44,50,0.88,4,43,47,68,13,13,29,52,191,Spencer Dinwiddie
2024-2025,Dallas Mavericks,PG,29,2,630,71,189,0.376,35,107,0.327,36,82,0.439,0.468,65,74,0.878,6,49,55,94,26,8,24,39,242,Spencer Dinwiddie
2018-2019,Dallas Mavericks,SG,72,72,2318,506,1186,0.427,168,514,0.327,338,672,0.503,0.497,346,485,0.713,86,477,563,429,77,25,247,137,1526,Luka Dončić
2019-2020,Dallas Mavericks,PG,61,61,2047,581,1255,0.463,171,541,0.316,410,714,0.574,0.531,426,562,0.758,78,495,573,538,62,14,260,153,1759,Luka Dončić
2020-2021,Dallas Mavericks,PG,66,66,2262,647,1351,0.479,192,548,0.35,455,803,0.567,0.55,344,471,0.73,54,473,527,567,64,36,281,152,1830,Luka Dončić
2021-2022,Dallas Mavericks,PG,65,65,2301,641,1403,0.457,201,569,0.353,440,834,0.528,0.529,364,489,0.744,56,537,593,568,75,36,292,145,1847,Luka Dončić
2022-2023,Dallas Mavericks,PG,66,66,2391,719,1449,0.496,185,541,0.342,534,908,0.588,0.56,515,694,0.742,54,515,569,529,90,33,236,166,2138,Luka Dončić
2023-2024,Dallas Mavericks,PG,70,70,2624,804,1652,0.487,284,744,0.382,520,908,0.573,0.573,478,608,0.786,59,588,647,686,99,38,282,149,2370,Luka Dončić
2024-2025,Dallas Mavericks,PG,22,22,785,216,466,0.464,75,212,0.354,141,254,0.555,0.544,112,146,0.767,16,167,183,172,44,9,75,58,619,Luka Dončić
2017-2018,Atlanta Hawks,SG,56,5,974,144,382,0.377,72,199,0.362,72,183,0.393,0.471,45,63,0.714,17,113,130,79,17,5,37,63,405,Tyler Dorsey
2018-2019,Total,SG,48,11,698,107,264,0.405,44,132,0.333,63,132,0.477,0.489,38,61,0.623,27,86,113,56,14,2,27,53,296,Tyler Dorsey
2018-2019,Atlanta Hawks,SG,27,0,251,32,89,0.36,10,39,0.256,22,50,0.44,0.416,16,26,0.615,9,34,43,17,7,1,10,20,90,Tyler Dorsey
2018-2019,Memphis Grizzlies,SG,21,11,447,75,175,0.429,34,93,0.366,41,82,0.5,0.526,22,35,0.629,18,52,70,39,7,1,17,33,206,Tyler Dorsey
2022-2023,Dallas Mavericks,SF,3,0,8,4,5,0.8,1,2,0.5,3,3,1,0.9,0,0,,1,1,2,0,0,0,0,0,9,Tyler Dorsey
2019-2020,Oklahoma City Thunder,SF,36,28,820,86,218,0.394,30,101,0.297,56,117,0.479,0.463,42,53,0.792,24,57,81,27,31,4,22,97,244,Luguentz Dort
2020-2021,Oklahoma City Thunder,SG,52,52,1543,247,639,0.387,113,329,0.343,134,310,0.432,0.475,122,164,0.744,38,151,189,88,45,19,79,134,729,Luguentz Dort
2021-2022,Oklahoma City Thunder,SG,51,51,1665,293,726,0.404,130,391,0.332,163,335,0.487,0.493,161,191,0.843,38,174,212,88,46,18,88,149,877,Luguentz Dort
2022-2023,Oklahoma City Thunder,SF,74,73,2272,339,873,0.388,135,409,0.33,204,464,0.44,0.466,200,259,0.772,128,216,344,154,75,23,92,243,1013,Luguentz Dort
2023-2024,Oklahoma City Thunder,SF,79,79,2246,288,657,0.438,156,396,0.394,132,261,0.506,0.557,128,155,0.826,74,210,284,113,72,47,74,228,860,Luguentz Dort
2024-2025,Oklahoma City Thunder,SF,29,29,854,97,240,0.404,63,161,0.391,34,79,0.43,0.535,28,35,0.8,45,89,134,47,35,23,16,91,285,Luguentz Dort
2021-2022,Chicago Bulls,SG,77,40,2110,278,535,0.52,70,186,0.376,208,349,0.596,0.585,53,78,0.679,27,187,214,256,60,29,108,182,679,Ayo Dosunmu
2022-2023,Chicago Bulls,SG,80,51,2098,281,570,0.493,59,189,0.312,222,381,0.583,0.545,66,82,0.805,45,175,220,206,62,26,99,182,687,Ayo Dosunmu
2023-2024,Chicago Bulls,SG,76,37,2212,360,719,0.501,119,295,0.403,241,424,0.568,0.583,85,105,0.81,54,162,216,242,68,36,103,166,924,Ayo Dosunmu
2024-2025,Chicago Bulls,SG,30,17,924,147,300,0.49,40,125,0.32,107,175,0.611,0.557,43,54,0.796,18,100,118,145,24,14,40,68,377,Ayo Dosunmu
2020-2021,Chicago Bulls,PG,11,0,50,11,21,0.524,1,7,0.143,10,14,0.714,0.548,0,0,,2,3,5,7,4,0,0,3,23,Devon Dotson
2021-2022,Chicago Bulls,PG,11,0,85,11,23,0.478,2,9,0.222,9,14,0.643,0.522,5,9,0.556,1,8,9,15,1,0,5,11,29,Devon Dotson
2022-2023,Washington Wizards,PG,6,0,53,1,10,0.1,1,4,0.25,0,6,0,0.15,0,0,,6,4,10,8,5,0,3,9,3,Devon Dotson
2019-2020,Detroit Pistons,PF,38,19,754,92,236,0.39,28,98,0.286,64,138,0.464,0.449,31,46,0.674,20,98,118,19,20,8,35,80,243,Sekou Doumbouya
2020-2021,Detroit Pistons,PF,56,11,869,107,282,0.379,26,115,0.226,81,167,0.485,0.426,45,64,0.703,39,104,143,47,24,9,44,94,285,Sekou Doumbouya
2021-2022,Los Angeles Lakers,PF,2,0,16,5,8,0.625,1,2,0.5,4,6,0.667,0.688,3,4,0.75,2,4,6,0,3,2,2,1,14,Sekou Doumbouya
2021-2022,Total,PG,9,0,108,8,26,0.308,1,9,0.111,7,17,0.412,0.327,2,2,1,8,10,18,10,5,1,5,5,19,Jeff Dowtin
2021-2022,Golden State Warriors,PG,4,0,28,3,6,0.5,0,1,0,3,5,0.6,0.5,0,0,,1,6,7,3,0,1,1,2,6,Jeff Dowtin
2021-2022,Milwaukee Bucks,PG,1,0,3,0,1,0,0,1,0,0,0,,0,0,0,,0,0,0,0,0,0,0,0,0,Jeff Dowtin
2021-2022,Orlando Magic,PG,4,0,77,5,19,0.263,1,7,0.143,4,12,0.333,0.289,2,2,1,7,4,11,7,5,0,4,3,13,Jeff Dowtin
2022-2023,Toronto Raptors,PG,25,0,259,25,57,0.439,5,16,0.313,20,41,0.488,0.482,6,9,0.667,6,17,23,31,9,3,5,13,61,Jeff Dowtin
2023-2024,Philadelphia 76ers,PG,12,0,142,20,36,0.556,9,19,0.474,11,17,0.647,0.681,3,4,0.75,3,17,20,27,7,1,5,1,52,Jeff Dowtin
2024-2025,Philadelphia 76ers,PG,9,0,92,10,24,0.417,1,8,0.125,9,16,0.563,0.438,4,5,0.8,2,6,8,10,3,1,1,5,25,Jeff Dowtin
2017-2018,Oklahoma City Thunder,PG,2,0,3,1,2,0.5,0,0,,1,2,0.5,0.5,0,0,,0,1,1,0,0,0,1,1,2,PJ Dozier
2018-2019,Boston Celtics,SG,6,0,51,8,21,0.381,2,8,0.25,6,13,0.462,0.429,1,2,0.5,6,11,17,5,2,0,0,2,19,PJ Dozier
2019-2020,Denver Nuggets,SG,29,0,412,65,157,0.414,17,49,0.347,48,108,0.444,0.468,21,29,0.724,10,45,55,63,14,6,27,45,168,PJ Dozier
2020-2021,Denver Nuggets,SG,50,6,1088,148,355,0.417,47,149,0.315,101,206,0.49,0.483,42,66,0.636,35,147,182,92,31,22,46,86,385,PJ Dozier
2021-2022,Denver Nuggets,SG,18,0,340,36,99,0.364,15,48,0.313,21,51,0.412,0.439,10,13,0.769,14,49,63,29,11,6,13,33,97,PJ Dozier
2022-2023,Sacramento Kings,SF,16,0,79,10,33,0.303,2,16,0.125,8,17,0.471,0.333,0,0,,1,13,14,10,6,1,5,7,22,PJ Dozier
2024-2025,Minnesota Timberwolves,SG,9,0,35,2,3,0.667,2,3,0.667,0,0,,1,1,6,0.167,1,4,5,5,1,0,1,3,7,PJ Dozier
2023-2024,Chicago Bulls,SF,4,0,30,4,10,0.4,2,6,0.333,2,4,0.5,0.5,1,2,0.5,1,3,4,4,2,1,2,6,11,Henri Drell
2012-2013,Detroit Pistons,C,60,10,1243,208,342,0.608,1,2,0.5,207,340,0.609,0.61,59,159,0.371,169,288,457,30,59,95,57,144,476,Andre Drummond
2013-2014,Detroit Pistons,C,81,81,2619,479,769,0.623,0,2,0,479,767,0.625,0.623,137,328,0.418,440,631,1071,35,101,131,110,273,1095,Andre Drummond
2014-2015,Detroit Pistons,C,82,82,2502,494,961,0.514,0,2,0,494,959,0.515,0.514,142,365,0.389,437,667,1104,55,73,153,120,285,1130,Andre Drummond
2015-2016,Detroit Pistons,C,81,81,2666,552,1060,0.521,2,6,0.333,550,1054,0.522,0.522,208,586,0.355,395,803,1198,67,119,112,155,245,1314,Andre Drummond
2016-2017,Detroit Pistons,C,81,81,2409,483,911,0.53,2,7,0.286,481,904,0.532,0.531,137,355,0.386,345,770,1115,90,124,89,152,237,1105,Andre Drummond
2017-2018,Detroit Pistons,C,78,78,2625,466,881,0.529,0,11,0,466,870,0.536,0.529,239,395,0.605,399,848,1247,237,114,127,200,250,1171,Andre Drummond
2018-2019,Detroit Pistons,C,79,79,2647,561,1052,0.533,5,38,0.132,556,1014,0.548,0.536,243,412,0.59,423,809,1232,112,136,138,175,272,1370,Andre Drummond
2019-2020,Total,C,57,56,1879,418,784,0.533,5,35,0.143,413,749,0.551,0.536,169,294,0.575,250,614,864,152,109,93,203,201,1010,Andre Drummond
2019-2020,Detroit Pistons,C,49,48,1654,360,679,0.53,1,21,0.048,359,658,0.546,0.531,149,255,0.584,226,549,775,138,97,82,174,176,870,Andre Drummond
2019-2020,Cleveland Cavaliers,C,8,8,225,58,105,0.552,4,14,0.286,54,91,0.593,0.571,20,39,0.513,24,65,89,14,12,11,29,25,140,Andre Drummond
2020-2021,Total,C,46,46,1242,282,572,0.493,0,8,0,282,564,0.5,0.493,123,205,0.6,166,385,551,94,63,49,124,149,687,Andre Drummond
2020-2021,Cleveland Cavaliers,C,25,25,722,180,380,0.474,0,8,0,180,372,0.484,0.474,77,129,0.597,101,236,337,64,40,29,81,69,437,Andre Drummond
2020-2021,Los Angeles Lakers,C,21,21,520,102,192,0.531,0,0,,102,192,0.531,0.531,46,76,0.605,65,149,214,30,23,20,43,80,250,Andre Drummond
2021-2022,Total,C,73,36,1437,247,433,0.57,0,3,0,247,430,0.574,0.57,86,164,0.524,229,451,680,131,78,68,115,192,580,Andre Drummond
2021-2022,Philadelphia 76ers,C,49,12,902,128,238,0.538,0,2,0,128,236,0.542,0.538,42,82,0.512,136,297,433,97,56,45,79,121,298,Andre Drummond
2021-2022,Brooklyn Nets,C,24,24,535,119,195,0.61,0,1,0,119,194,0.613,0.61,44,82,0.537,93,154,247,34,22,23,36,71,282,Andre Drummond
2022-2023,Chicago Bulls,C,67,0,849,166,274,0.606,0,3,0,166,271,0.613,0.606,67,125,0.536,138,306,444,33,45,27,75,117,399,Andre Drummond
2023-2024,Chicago Bulls,C,79,10,1351,267,480,0.556,0,3,0,267,477,0.56,0.556,129,218,0.592,265,443,708,37,73,48,81,140,663,Andre Drummond
2024-2025,Philadelphia 76ers,C,24,14,463,67,134,0.5,1,9,0.111,66,125,0.528,0.504,31,54,0.574,67,126,193,12,30,10,40,60,166,Andre Drummond
2021-2022,Indiana Pacers,SG,55,39,1541,268,621,0.432,94,255,0.369,174,366,0.475,0.507,90,112,0.804,41,185,226,114,56,10,90,95,720,Chris Duarte
2022-2023,Indiana Pacers,SF,46,12,897,123,333,0.369,55,174,0.316,68,159,0.428,0.452,61,72,0.847,19,96,115,64,25,9,41,65,362,Chris Duarte
2023-2024,Sacramento Kings,SF,59,11,719,80,210,0.381,44,127,0.346,36,83,0.434,0.486,26,33,0.788,26,80,106,44,28,8,26,80,230,Chris Duarte
2024-2025,Chicago Bulls,SG,13,0,54,10,20,0.5,5,12,0.417,5,8,0.625,0.625,6,8,0.75,4,12,16,5,0,0,1,5,31,Chris Duarte
2024-2025,Oklahoma City Thunder,SG,4,0,7,0,3,0,0,2,0,0,1,0,0,0,0,0,0,0,0,0,0,0,0,0,0,Alex Ducas
2021-2022,Brooklyn Nets,PG,22,7,341,39,108,0.361,9,37,0.243,30,71,0.423,0.403,17,21,0.81,30,37,67,17,14,7,9,36,104,David Duke Jr.
2022-2023,Brooklyn Nets,SG,23,0,228,36,78,0.462,1,12,0.083,35,66,0.53,0.468,12,17,0.706,11,18,29,21,10,1,18,31,85,David Duke Jr.
2023-2024,San Antonio Spurs,SG,4,0,51,10,18,0.556,3,6,0.5,7,12,0.583,0.639,3,3,1,2,8,10,5,2,0,3,4,26,David Duke Jr.
2024-2025,San Antonio Spurs,SG,1,0,8,1,4,0.25,0,1,0,1,3,0.333,0.25,1,2,0.5,0,0,0,2,0,0,0,1,3,David Duke Jr.
2016-2017,Minnesota Timberwolves,PG,78,7,1333,118,313,0.377,21,73,0.288,97,240,0.404,0.411,36,59,0.61,24,142,166,188,78,36,89,178,293,Kris Dunn
2017-2018,Chicago Bulls,PG,52,43,1525,286,666,0.429,43,134,0.321,243,532,0.457,0.462,84,114,0.737,24,197,221,310,104,27,150,174,699,Kris Dunn
2018-2019,Chicago Bulls,PG,46,44,1389,215,506,0.425,34,96,0.354,181,410,0.441,0.458,55,69,0.797,19,168,187,277,68,21,104,166,519,Kris Dunn
2019-2020,Chicago Bulls,PG,51,32,1269,152,342,0.444,29,112,0.259,123,230,0.535,0.487,40,54,0.741,23,163,186,173,101,17,68,158,373,Kris Dunn
2020-2021,Atlanta Hawks,PG,4,0,45,1,12,0.083,0,2,0,1,10,0.1,0.083,3,4,0.75,0,6,6,2,2,2,3,10,5,Kris Dunn
2021-2022,Portland Trail Blazers,PG,14,3,336,44,102,0.431,1,11,0.091,43,91,0.473,0.436,17,18,0.944,9,40,49,79,23,3,32,38,106,Kris Dunn
2022-2023,Utah Jazz,PG,22,3,568,116,216,0.537,17,36,0.472,99,180,0.55,0.576,41,53,0.774,9,91,100,124,25,10,35,58,290,Kris Dunn
2023-2024,Utah Jazz,PG,66,32,1249,147,313,0.47,41,111,0.369,106,202,0.525,0.535,22,32,0.688,50,139,189,254,68,28,79,135,357,Kris Dunn
2024-2025,Los Angeles Clippers,PG,31,20,730,88,198,0.444,34,100,0.34,54,98,0.551,0.53,6,12,0.5,22,90,112,85,54,8,36,79,216,Kris Dunn
2024-2025,Phoenix Suns,SF,26,11,465,60,143,0.42,28,91,0.308,32,52,0.615,0.517,5,12,0.417,17,51,68,21,15,16,14,59,153,Ryan Dunn
2007-2008,Seattle SuperSonics,SG,80,80,2768,587,1366,0.43,59,205,0.288,528,1161,0.455,0.451,391,448,0.873,70,278,348,192,78,75,232,122,1624,Kevin Durant
2008-2009,Oklahoma City Thunder,SF,74,74,2885,661,1390,0.476,97,230,0.422,564,1160,0.486,0.51,452,524,0.863,77,405,482,205,96,53,225,134,1871,Kevin Durant
2009-2010,Oklahoma City Thunder,SF,82,82,3239,794,1668,0.476,128,351,0.365,666,1317,0.506,0.514,756,840,0.9,105,518,623,231,112,84,271,171,2472,Kevin Durant
2010-2011,Oklahoma City Thunder,SF,78,78,3038,711,1538,0.462,145,414,0.35,566,1124,0.504,0.509,594,675,0.88,57,476,533,214,88,76,218,159,2161,Kevin Durant
2011-2012,Oklahoma City Thunder,SF,66,66,2546,643,1297,0.496,133,344,0.387,510,953,0.535,0.547,431,501,0.86,40,487,527,231,88,77,248,133,1850,Kevin Durant
2012-2013,Oklahoma City Thunder,SF,81,81,3119,731,1433,0.51,139,334,0.416,592,1099,0.539,0.559,679,750,0.905,46,594,640,374,116,105,280,143,2280,Kevin Durant
2013-2014,Oklahoma City Thunder,SF,81,81,3122,849,1688,0.503,192,491,0.391,657,1197,0.549,0.56,703,805,0.873,58,540,598,445,103,59,285,174,2593,Kevin Durant
2014-2015,Oklahoma City Thunder,SF,27,27,913,238,467,0.51,64,159,0.403,174,308,0.565,0.578,146,171,0.854,16,162,178,110,24,25,74,40,686,Kevin Durant
2015-2016,Oklahoma City Thunder,SF,72,72,2578,698,1381,0.505,186,481,0.387,512,900,0.569,0.573,447,498,0.898,45,544,589,361,69,85,250,137,2029,Kevin Durant
2016-2017,Golden State Warriors,PF,62,62,2070,551,1026,0.537,117,312,0.375,434,714,0.608,0.594,336,384,0.875,39,474,513,300,66,99,138,117,1555,Kevin Durant
2017-2018,Golden State Warriors,SF,68,68,2325,630,1222,0.516,173,413,0.419,457,809,0.565,0.586,359,404,0.889,31,433,464,366,50,119,207,133,1792,Kevin Durant
2018-2019,Golden State Warriors,SF,78,78,2702,721,1383,0.521,137,388,0.353,584,995,0.587,0.571,448,506,0.885,33,464,497,457,58,84,225,155,2027,Kevin Durant
2020-2021,Brooklyn Nets,PF,35,32,1157,324,603,0.537,85,189,0.45,239,414,0.577,0.608,210,238,0.882,13,234,247,195,25,45,120,70,943,Kevin Durant
2021-2022,Brooklyn Nets,PF,55,55,2047,578,1115,0.518,115,300,0.383,463,815,0.568,0.57,372,409,0.91,29,378,407,351,48,52,191,113,1643,Kevin Durant
2022-2023,Total,PF,47,47,1672,483,862,0.56,93,230,0.404,390,632,0.617,0.614,307,334,0.919,17,296,313,235,34,67,156,99,1366,Kevin Durant
2022-2023,Brooklyn Nets,PF,39,39,1403,410,734,0.559,71,189,0.376,339,545,0.622,0.607,267,286,0.934,14,248,262,207,32,57,136,92,1158,Kevin Durant
2022-2023,Phoenix Suns,PF,8,8,269,73,128,0.57,22,41,0.537,51,87,0.586,0.656,40,48,0.833,3,48,51,28,2,10,20,7,208,Kevin Durant
2023-2024,Phoenix Suns,PF,75,75,2791,751,1436,0.523,168,407,0.413,583,1029,0.567,0.581,362,423,0.856,41,454,495,378,69,91,244,133,2032,Kevin Durant
2024-2025,Phoenix Suns,PF,20,20,717,194,377,0.515,50,119,0.42,144,258,0.558,0.581,112,133,0.842,8,120,128,75,16,23,62,35,550,Kevin Durant
2022-2023,Detroit Pistons,C,67,31,1670,258,398,0.648,0,2,0,258,396,0.652,0.648,96,157,0.611,229,366,595,75,44,59,92,182,612,Jalen Duren
2023-2024,Detroit Pistons,C,61,60,1777,349,564,0.619,0,4,0,349,560,0.623,0.619,143,181,0.79,192,517,709,147,33,47,129,192,841,Jalen Duren
2024-2025,Detroit Pistons,C,28,28,701,104,150,0.693,0,0,,104,150,0.693,0.693,49,80,0.613,85,173,258,65,15,33,56,88,257,Jalen Duren
2018-2019,Milwaukee Bucks,PG,3,0,6,2,3,0.667,1,1,1,1,2,0.5,0.833,0,0,0,1,1,2,0,0,0,0,5,0,Trevon Duval
2022-2023,Houston Rockets,PF,82,5,1767,296,660,0.448,59,172,0.343,237,488,0.486,0.493,109,145,0.752,195,301,496,88,96,47,101,189,760,Tari Eason
2023-2024,Houston Rockets,PF,22,0,480,88,189,0.466,18,50,0.36,70,139,0.504,0.513,21,33,0.636,46,107,153,27,31,19,20,51,215,Tari Eason
2024-2025,Houston Rockets,PF,24,0,546,105,221,0.475,23,73,0.315,82,148,0.554,0.527,37,49,0.755,51,100,151,25,46,24,20,59,270,Tari Eason
2024-2025,Memphis Grizzlies,C,20,14,438,93,154,0.604,9,21,0.429,84,133,0.632,0.633,30,47,0.638,74,86,160,21,16,23,32,57,225,Zach Edey
2020-2021,Minnesota Timberwolves,SG,72,55,2314,505,1211,0.417,171,520,0.329,334,691,0.483,0.488,211,272,0.776,59,277,336,211,82,36,160,129,1392,Anthony Edwards
2021-2022,Minnesota Timberwolves,SG,72,72,2466,549,1245,0.441,215,602,0.357,334,643,0.519,0.527,220,280,0.786,62,281,343,275,105,46,190,164,1533,Anthony Edwards
2022-2023,Minnesota Timberwolves,SG,79,79,2842,707,1541,0.459,213,578,0.369,494,963,0.513,0.528,319,422,0.756,47,411,458,350,125,58,259,186,1946,Anthony Edwards
2023-2024,Minnesota Timberwolves,SG,79,78,2770,718,1558,0.461,190,532,0.357,528,1026,0.515,0.522,423,506,0.836,52,378,430,405,101,42,241,141,2049,Anthony Edwards
2024-2025,Minnesota Timberwolves,SG,30,30,1077,270,604,0.447,124,295,0.42,146,309,0.472,0.55,94,117,0.803,20,146,166,120,40,18,93,58,758,Anthony Edwards
2019-2020,Boston Celtics,SG,37,0,351,42,128,0.328,24,76,0.316,18,52,0.346,0.422,13,19,0.684,6,41,47,24,12,4,15,34,121,Carsen Edwards
2020-2021,Boston Celtics,SG,31,1,276,47,111,0.423,18,63,0.286,29,48,0.604,0.505,11,13,0.846,3,23,26,14,7,1,7,25,123,Carsen Edwards
2021-2022,Detroit Pistons,SG,4,0,79,9,30,0.3,4,16,0.25,5,14,0.357,0.367,1,1,1,2,4,6,14,2,0,5,4,23,Carsen Edwards
2024-2025,Philadelphia 76ers,SF,2,0,9,2,3,0.667,0,1,0,2,2,1,0.667,0,1,0,0,2,2,1,0,0,0,0,4,Justin Edwards
2021-2022,Brooklyn Nets,SF,48,23,987,110,267,0.412,48,136,0.353,62,131,0.473,0.502,16,19,0.842,44,128,172,31,29,24,42,85,284,Kessler Edwards
2022-2023,Total,SF,36,4,385,36,93,0.387,17,55,0.309,19,38,0.5,0.478,11,15,0.733,23,38,61,23,14,6,13,40,100,Kessler Edwards
2022-2023,Brooklyn Nets,SF,14,1,79,6,24,0.25,2,12,0.167,4,12,0.333,0.292,1,2,0.5,6,8,14,2,3,1,4,3,15,Kessler Edwards
2022-2023,Sacramento Kings,SF,22,3,306,30,69,0.435,15,43,0.349,15,26,0.577,0.543,10,13,0.769,17,30,47,21,11,5,9,37,85,Kessler Edwards
2023-2024,Sacramento Kings,SF,54,0,275,34,82,0.415,20,52,0.385,14,30,0.467,0.537,5,9,0.556,9,33,42,15,10,4,4,26,93,Kessler Edwards
2024-2025,Dallas Mavericks,SF,10,0,24,0,6,0,0,4,0,0,2,0,0,0,0,,0,2,2,1,0,1,1,4,0,Kessler Edwards
2021-2022,Oklahoma City Thunder,SG,2,0,11,1,4,0.25,1,4,0.25,0,0,0.375,0,0,0,3,3,0,0,0,1,0,3,0,,Rob Edwards
2018-2019,Houston Rockets,SF,2,0,16,1,4,0.25,1,4,0.25,0,0,0.375,0,0,1,1,2,0,0,0,0,0,3,0,,Vince Edwards
2020-2021,Portland Trail Blazers,SF,30,0,192,25,66,0.379,7,34,0.206,18,32,0.563,0.432,11,15,0.733,11,21,32,10,6,3,5,27,68,CJ Elleby
2021-2022,Portland Trail Blazers,SF,58,28,1174,121,308,0.393,37,126,0.294,84,182,0.462,0.453,60,84,0.714,66,161,227,87,35,19,56,116,339,CJ Elleby
2022-2023,Sacramento Kings,SG,16,0,71,7,16,0.438,6,12,0.5,1,4,0.25,0.625,4,7,0.571,4,4,8,6,5,1,1,10,24,Keon Ellis
2023-2024,Sacramento Kings,SG,57,21,978,107,232,0.461,70,168,0.417,37,64,0.578,0.612,26,35,0.743,32,92,124,85,51,29,37,112,310,Keon Ellis
2024-2025,Sacramento Kings,SG,29,4,577,59,128,0.461,37,91,0.407,22,37,0.595,0.605,27,32,0.844,22,42,64,31,33,23,23,54,182,Keon Ellis
2016-2017,Philadelphia 76ers,C,31,31,786,200,429,0.466,36,98,0.367,164,331,0.495,0.508,191,244,0.783,61,182,243,66,27,76,117,112,627,Joel Embiid
2017-2018,Philadelphia 76ers,C,63,63,1912,510,1056,0.483,66,214,0.308,444,842,0.527,0.514,359,467,0.769,143,547,690,199,40,111,234,209,1445,Joel Embiid
2018-2019,Philadelphia 76ers,C,64,64,2154,580,1199,0.484,79,263,0.3,501,936,0.535,0.517,522,649,0.804,160,711,871,234,46,122,226,211,1761,Joel Embiid
2019-2020,Philadelphia 76ers,C,51,51,1506,382,801,0.477,57,172,0.331,325,629,0.517,0.512,351,435,0.807,141,452,593,152,45,65,159,174,1172,Joel Embiid
2020-2021,Philadelphia 76ers,C,51,51,1585,461,899,0.513,58,154,0.377,403,745,0.541,0.545,471,548,0.859,113,426,539,145,50,69,159,123,1451,Joel Embiid
2021-2022,Philadelphia 76ers,C,68,68,2297,666,1334,0.499,93,251,0.371,573,1083,0.529,0.534,654,803,0.814,146,650,796,284,77,99,214,181,2079,Joel Embiid
2022-2023,Philadelphia 76ers,C,66,66,2284,728,1328,0.548,66,200,0.33,662,1128,0.587,0.573,661,771,0.857,113,557,670,274,66,112,226,205,2183,Joel Embiid
2023-2024,Philadelphia 76ers,C,39,39,1309,450,851,0.529,54,139,0.388,396,712,0.556,0.561,399,452,0.883,95,335,430,219,46,66,150,112,1353,Joel Embiid
2024-2025,Philadelphia 76ers,C,9,9,252,61,142,0.43,11,38,0.289,50,104,0.481,0.468,59,62,0.952,13,50,63,35,6,8,28,22,192,Joel Embiid
2018-2019,San Antonio Spurs,PF,23,0,113,15,26,0.577,0,0,,15,26,0.577,0.577,11,13,0.846,6,28,34,7,2,5,8,11,41,Drew Eubanks
2019-2020,San Antonio Spurs,C,22,3,272,43,67,0.642,1,1,1,42,66,0.636,0.649,20,26,0.769,28,57,85,15,5,17,21,37,107,Drew Eubanks
2020-2021,San Antonio Spurs,C,54,3,755,116,205,0.566,2,2,1,114,203,0.562,0.571,77,106,0.726,74,167,241,42,18,49,45,88,311,Drew Eubanks
2021-2022,Total,C,71,31,1245,221,371,0.596,5,23,0.217,216,348,0.621,0.602,99,130,0.762,130,252,382,85,31,40,81,122,546,Drew Eubanks
2021-2022,San Antonio Spurs,C,49,9,595,84,159,0.528,1,8,0.125,83,151,0.55,0.531,59,79,0.747,64,132,196,50,13,30,46,61,228,Drew Eubanks
2021-2022,Portland Trail Blazers,C,22,22,650,137,212,0.646,4,15,0.267,133,197,0.675,0.656,40,51,0.784,66,120,186,35,18,10,35,61,318,Drew Eubanks
2022-2023,Portland Trail Blazers,C,78,28,1584,214,334,0.641,7,18,0.389,207,316,0.655,0.651,83,125,0.664,132,286,418,103,40,102,67,169,518,Drew Eubanks
2023-2024,Phoenix Suns,C,75,6,1169,152,253,0.601,3,3,1,149,250,0.596,0.607,72,93,0.774,103,219,322,63,27,61,61,115,379,Drew Eubanks
2024-2025,Utah Jazz,C,23,0,311,44,73,0.603,2,4,0.5,42,69,0.609,0.616,19,31,0.613,26,64,90,25,5,15,17,27,109,Drew Eubanks
2018-2019,Golden State Warriors,SG,30,1,204,18,53,0.34,4,15,0.267,14,38,0.368,0.377,0,1,0,6,19,25,23,5,3,11,28,40,Jacob Evans
2019-2020,Total,SG,29,1,418,45,134,0.336,13,39,0.333,32,95,0.337,0.384,25,29,0.862,9,32,41,31,11,12,25,41,128,Jacob Evans
2019-2020,Golden State Warriors,SG,27,1,414,45,133,0.338,13,38,0.342,32,95,0.337,0.387,25,29,0.862,9,32,41,31,11,12,25,41,128,Jacob Evans
2019-2020,Minnesota Timberwolves,SG,2,0,4,0,1,0,0,1,0,0,0,,0,0,0,,0,0,0,0,0,0,0,0,0,Jacob Evans
2023-2024,Total,SF,17,8,367,36,71,0.507,12,32,0.375,24,39,0.615,0.592,17,25,0.68,18,42,60,16,6,5,9,23,101,Tosan Evbuomwan
2023-2024,Memphis Grizzlies,SF,4,0,74,4,15,0.267,2,8,0.25,2,7,0.286,0.333,0,0,,8,6,14,6,0,1,1,5,10,Tosan Evbuomwan
2023-2024,Detroit Pistons,SF,13,8,293,32,56,0.571,10,24,0.417,22,32,0.688,0.661,17,25,0.68,10,36,46,10,6,4,8,18,91,Tosan Evbuomwan
2014-2015,Utah Jazz,PG,82,41,1817,145,416,0.349,83,264,0.314,62,152,0.408,0.448,20,32,0.625,27,104,131,198,41,14,118,147,393,Dante Exum
2016-2017,Utah Jazz,PG,66,26,1228,155,363,0.427,44,149,0.295,111,214,0.519,0.488,58,73,0.795,30,102,132,111,21,12,80,146,412,Dante Exum
2017-2018,Utah Jazz,PG,14,0,235,42,87,0.483,5,18,0.278,37,69,0.536,0.511,25,31,0.806,4,22,26,43,8,3,20,20,114,Dante Exum
2018-2019,Utah Jazz,PG,42,1,664,101,241,0.419,18,62,0.29,83,179,0.464,0.456,68,86,0.791,16,52,68,110,14,5,52,69,288,Dante Exum
2019-2020,Total,SG,35,1,485,56,119,0.471,15,43,0.349,41,76,0.539,0.534,32,43,0.744,12,55,67,40,13,8,31,38,159,Dante Exum
2019-2020,Utah Jazz,SG,11,0,83,10,23,0.435,2,6,0.333,8,17,0.471,0.478,2,2,1,3,9,12,7,1,2,10,8,24,Dante Exum
2019-2020,Cleveland Cavaliers,SG,24,1,402,46,96,0.479,13,37,0.351,33,59,0.559,0.547,30,41,0.732,9,46,55,33,12,6,21,30,135,Dante Exum
2020-2021,Cleveland Cavaliers,SG,6,3,116,10,26,0.385,2,11,0.182,8,15,0.533,0.423,1,2,0.5,2,15,17,13,4,2,7,9,23,Dante Exum
2023-2024,Dallas Mavericks,PG,55,17,1088,161,302,0.533,53,108,0.491,108,194,0.557,0.621,53,68,0.779,25,124,149,157,22,5,49,85,428,Dante Exum
2010-2011,Total,PF,78,27,1535,215,416,0.517,0,0,,215,416,0.517,0.517,103,173,0.595,171,241,412,39,29,68,77,246,533,Derrick Favors
2010-2011,New Jersey Nets,PF,56,23,1091,141,276,0.511,0,0,,141,276,0.511,0.511,71,116,0.612,126,171,297,21,18,41,56,183,353,Derrick Favors
2010-2011,Utah Jazz,PF,22,4,444,74,140,0.529,0,0,,74,140,0.529,0.529,32,57,0.561,45,70,115,18,11,27,21,63,180,Derrick Favors
2011-2012,Utah Jazz,PF,65,9,1376,222,445,0.499,0,0,,222,445,0.499,0.499,126,194,0.649,158,267,425,43,38,65,103,145,570,Derrick Favors
2012-2013,Utah Jazz,PF,77,8,1787,274,568,0.482,0,5,0,274,563,0.487,0.482,179,260,0.688,184,362,546,75,67,130,129,247,727,Derrick Favors
2013-2014,Utah Jazz,PF,73,73,2201,390,747,0.522,0,1,0,390,746,0.523,0.522,190,284,0.669,199,438,637,91,75,108,129,236,970,Derrick Favors
2014-2015,Utah Jazz,PF,74,74,2280,482,918,0.525,1,6,0.167,481,912,0.527,0.526,222,332,0.669,196,411,607,112,60,123,121,210,1187,Derrick Favors
2015-2016,Utah Jazz,PF,62,59,1983,418,811,0.515,0,4,0,418,807,0.518,0.515,180,254,0.709,169,334,503,94,74,91,104,150,1016,Derrick Favors
2016-2017,Utah Jazz,PF,50,39,1186,203,417,0.487,3,10,0.3,200,407,0.491,0.49,67,109,0.615,92,213,305,56,45,40,60,103,476,Derrick Favors
2017-2018,Utah Jazz,C,77,77,2153,395,702,0.563,14,63,0.222,381,639,0.596,0.573,140,215,0.651,198,354,552,102,54,82,88,164,944,Derrick Favors
2018-2019,Utah Jazz,C,76,70,1766,363,619,0.586,17,78,0.218,346,541,0.64,0.6,154,228,0.675,207,353,560,89,56,106,84,163,897,Derrick Favors
2019-2020,New Orleans Pelicans,C,51,49,1243,209,339,0.617,1,7,0.143,208,332,0.627,0.618,40,71,0.563,163,338,501,81,30,46,55,107,459,Derrick Favors
2020-2021,Utah Jazz,C,68,0,1039,155,243,0.638,0,2,0,155,241,0.643,0.638,59,80,0.738,138,238,376,44,32,68,36,143,369,Derrick Favors
2021-2022,Oklahoma City Thunder,C,39,18,653,94,182,0.516,2,16,0.125,92,166,0.554,0.522,16,25,0.64,58,126,184,25,17,12,9,62,206,Derrick Favors
2019-2020,Atlanta Hawks,C,56,13,713,103,199,0.518,5,37,0.135,98,162,0.605,0.53,29,51,0.569,67,131,198,49,18,17,42,107,240,Bruno Fernando
2020-2021,Atlanta Hawks,C,33,0,226,18,44,0.409,0,2,0,18,42,0.429,0.409,15,22,0.682,16,62,78,10,4,3,21,23,51,Bruno Fernando
2021-2022,Total,C,30,0,152,36,55,0.655,1,2,0.5,35,53,0.66,0.664,15,24,0.625,18,37,55,7,1,11,14,24,88,Bruno Fernando
2021-2022,Boston Celtics,C,20,0,58,7,14,0.5,1,1,1,6,13,0.462,0.536,4,5,0.8,7,8,15,4,0,3,5,6,19,Bruno Fernando
2021-2022,Houston Rockets,C,10,0,94,29,41,0.707,0,1,0,29,40,0.725,0.707,11,19,0.579,11,29,40,3,1,8,9,18,69,Bruno Fernando
2022-2023,Total,C,39,4,405,59,112,0.527,0,4,0,59,108,0.546,0.527,35,50,0.7,54,83,137,31,6,34,25,74,153,Bruno Fernando
2022-2023,Houston Rockets,C,31,4,364,48,93,0.516,0,1,0,48,92,0.522,0.516,30,44,0.682,48,74,122,30,6,31,20,68,126,Bruno Fernando
2022-2023,Atlanta Hawks,C,8,0,41,11,19,0.579,0,3,0,11,16,0.688,0.579,5,6,0.833,6,9,15,1,0,3,5,6,27,Bruno Fernando
2023-2024,Atlanta Hawks,C,45,2,682,109,187,0.583,0,4,0,109,183,0.596,0.583,64,96,0.667,59,134,193,46,25,28,44,107,282,Bruno Fernando
2024-2025,Toronto Raptors,C,16,2,143,26,48,0.542,0,0,,26,48,0.542,0.542,6,8,0.75,21,29,50,18,4,9,14,26,58,Bruno Fernando
2024-2025,Utah Jazz,C,19,8,333,45,87,0.517,12,35,0.343,33,52,0.635,0.586,20,36,0.556,17,66,83,35,9,2,19,35,122,Kyle Filipowski
2016-2017,Dallas Mavericks,PF,81,35,1642,124,333,0.372,56,191,0.293,68,142,0.479,0.456,46,61,0.754,55,167,222,67,52,25,45,125,350,Dorian Finney-Smith
2017-2018,Dallas Mavericks,PF,21,13,448,46,121,0.38,20,67,0.299,26,54,0.481,0.463,11,15,0.733,22,53,75,26,10,4,21,43,123,Dorian Finney-Smith
2018-2019,Dallas Mavericks,SF,81,26,1985,228,528,0.432,79,254,0.311,149,274,0.544,0.507,73,103,0.709,138,251,389,95,69,36,74,186,608,Dorian Finney-Smith
2019-2020,Dallas Mavericks,PF,71,68,2120,243,522,0.466,114,303,0.376,129,219,0.589,0.575,78,108,0.722,145,260,405,114,45,39,69,178,678,Dorian Finney-Smith
2020-2021,Dallas Mavericks,PF,60,60,1921,220,466,0.472,119,302,0.394,101,164,0.616,0.6,31,41,0.756,98,228,326,102,52,25,48,138,590,Dorian Finney-Smith
2021-2022,Dallas Mavericks,PF,80,80,2644,326,692,0.471,172,435,0.395,154,257,0.599,0.595,56,83,0.675,122,253,375,150,88,39,80,183,880,Dorian Finney-Smith
2022-2023,Total,PF,66,66,2009,196,501,0.391,114,338,0.337,82,163,0.503,0.505,45,59,0.763,114,202,316,100,55,36,62,144,551,Dorian Finney-Smith
2022-2023,Dallas Mavericks,PF,40,40,1288,129,310,0.416,77,217,0.355,52,93,0.559,0.54,30,40,0.75,67,121,188,59,38,20,36,80,365,Dorian Finney-Smith
2022-2023,Brooklyn Nets,PF,26,26,721,67,191,0.351,37,121,0.306,30,70,0.429,0.448,15,19,0.789,47,81,128,41,17,16,26,64,186,Dorian Finney-Smith
2023-2024,Brooklyn Nets,PF,68,56,1934,215,511,0.421,117,336,0.348,98,175,0.56,0.535,33,46,0.717,109,208,317,107,56,38,59,150,580,Dorian Finney-Smith
2024-2025,Brooklyn Nets,PF,20,20,579,73,159,0.459,47,108,0.435,26,51,0.51,0.607,15,24,0.625,31,60,91,31,18,12,18,54,208,Dorian Finney-Smith
2020-2021,Los Angeles Clippers,PF,3,0,11,1,3,0.333,1,2,0.5,0,1,0,0.5,0,0,0,3,3,0,0,0,0,3,3,0,Malik Fitts
2021-2022,Total,PF,15,0,63,8,19,0.421,5,10,0.5,3,9,0.333,0.553,0,0,2,15,17,5,0,0,2,4,21,0,Malik Fitts
2021-2022,Utah Jazz,PF,7,0,35,2,9,0.222,2,4,0.5,0,5,0,0.333,0,0,0,10,10,0,0,0,2,3,6,0,Malik Fitts
2021-2022,Boston Celtics,PF,8,0,28,6,10,0.6,3,6,0.5,3,4,0.75,0.75,0,0,2,5,7,5,0,0,0,1,15,0,Malik Fitts
2023-2024,Oklahoma City Thunder,SG,2,0,14,1,7,0.143,1,6,0.167,0,1,0,0.214,0,0,0,0,0,4,0,0,0,0,3,0,Adam Flagler
2024-2025,Oklahoma City Thunder,SG,11,0,40,5,20,0.25,5,19,0.263,0,1,0,0.375,0,0,2,4,6,0,2,0,0,4,15,0,Adam Flagler
2024-2025,Los Angeles Clippers,SF,1,0,14,4,9,0.444,0,2,0,4,7,0.571,0.444,1,1,1,1,3,4,0,0,0,1,3,9,Trentyn Flowers
2020-2021,Toronto Raptors,PG,47,14,928,127,340,0.374,54,168,0.321,73,172,0.424,0.453,45,56,0.804,10,106,116,137,38,7,43,68,353,Malachi Flynn
2021-2022,Toronto Raptors,PG,44,5,537,72,183,0.393,30,90,0.333,42,93,0.452,0.475,15,24,0.625,10,53,63,70,20,4,13,45,189,Malachi Flynn
2022-2023,Toronto Raptors,PG,53,2,691,87,242,0.36,47,133,0.353,40,109,0.367,0.457,25,33,0.758,15,61,76,70,21,4,25,65,246,Malachi Flynn
2023-2024,Total,PG,69,0,876,136,325,0.418,56,169,0.331,80,156,0.513,0.505,52,71,0.732,21,93,114,130,38,8,63,66,380,Malachi Flynn
2023-2024,Toronto Raptors,PG,31,0,474,56,137,0.409,28,80,0.35,28,57,0.491,0.511,17,22,0.773,13,52,65,73,18,6,33,42,157,Malachi Flynn
2023-2024,New York Knicks,PG,14,0,60,9,23,0.391,4,13,0.308,5,10,0.5,0.478,9,11,0.818,0,6,6,6,1,0,3,3,31,Malachi Flynn
2023-2024,Detroit Pistons,PG,24,0,342,71,165,0.43,24,76,0.316,47,89,0.528,0.503,26,38,0.684,8,35,43,51,19,2,27,21,192,Malachi Flynn
2022-2023,Utah Jazz,SF,52,6,766,115,312,0.369,63,191,0.33,52,121,0.43,0.47,35,44,0.795,31,55,86,42,15,8,39,62,328,Simone Fontecchio
2023-2024,Total,SF,66,43,1644,252,548,0.46,134,334,0.401,118,214,0.551,0.582,54,66,0.818,64,182,246,101,44,23,68,110,692,Simone Fontecchio
2023-2024,Utah Jazz,SF,50,34,1160,161,358,0.45,91,233,0.391,70,125,0.56,0.577,32,40,0.8,52,124,176,73,30,18,51,81,445,Simone Fontecchio
2023-2024,Detroit Pistons,SF,16,9,484,91,190,0.479,43,101,0.426,48,89,0.539,0.592,22,26,0.846,12,58,70,28,14,5,17,29,247,Simone Fontecchio
2024-2025,Detroit Pistons,SF,29,0,523,61,147,0.415,34,97,0.351,27,50,0.54,0.531,34,41,0.829,16,65,81,25,10,5,24,38,190,Simone Fontecchio
2016-2017,San Antonio Spurs,SG,36,0,285,36,99,0.364,17,53,0.321,19,46,0.413,0.449,5,6,0.833,2,21,23,23,1,0,11,20,94,Bryn Forbes
2017-2018,San Antonio Spurs,SG,80,12,1517,209,497,0.421,89,228,0.39,120,269,0.446,0.51,48,72,0.667,12,98,110,80,28,2,37,108,555,Bryn Forbes
2018-2019,San Antonio Spurs,SG,82,81,2293,361,791,0.456,176,413,0.426,185,378,0.489,0.568,69,78,0.885,18,221,239,175,45,4,80,159,967,Bryn Forbes
2019-2020,San Antonio Spurs,SG,63,62,1579,242,581,0.417,148,381,0.388,94,200,0.47,0.544,75,90,0.833,12,114,126,108,33,0,57,113,707,Bryn Forbes
2020-2021,Milwaukee Bucks,SG,70,10,1354,250,529,0.473,154,341,0.452,96,188,0.511,0.618,47,61,0.77,11,101,112,45,24,1,44,77,701,Bryn Forbes
2021-2022,Total,SG,75,2,1286,231,539,0.429,122,295,0.414,109,244,0.447,0.542,79,87,0.908,10,83,93,75,25,5,56,95,663,Bryn Forbes
2021-2022,San Antonio Spurs,SG,40,1,676,128,296,0.432,63,151,0.417,65,145,0.448,0.539,44,49,0.898,4,59,63,41,17,3,33,42,363,Bryn Forbes
2021-2022,Denver Nuggets,SG,35,1,610,103,243,0.424,59,144,0.41,44,99,0.444,0.545,35,38,0.921,6,24,30,34,8,2,23,53,300,Bryn Forbes
2022-2023,Minnesota Timberwolves,SG,25,0,268,30,83,0.361,14,46,0.304,16,37,0.432,0.446,15,15,1,4,11,15,17,7,2,12,22,89,Bryn Forbes
2021-2022,Orlando Magic,SF,5,0,74,6,20,0.3,2,15,0.133,4,5,0.8,0.35,0,0,2,13,15,2,1,0,4,7,14,0,Aleem Ford
2023-2024,Sacramento Kings,PG,6,0,22,4,7,0.571,2,3,0.667,2,4,0.5,0.714,2,2,1,0,2,2,2,0,0,1,0,12,Jordan Ford
2020-2021,Utah Jazz,PG,30,0,302,32,71,0.451,5,26,0.192,27,45,0.6,0.486,19,19,1,11,33,44,45,9,4,21,22,88,Trent Forrest
2021-2022,Utah Jazz,PG,60,6,765,76,155,0.49,5,27,0.185,71,128,0.555,0.506,38,48,0.792,23,76,99,106,30,6,48,43,195,Trent Forrest
2022-2023,Atlanta Hawks,SG,23,3,277,25,60,0.417,0,2,0,25,58,0.431,0.417,2,3,0.667,5,32,37,38,7,2,15,17,52,Trent Forrest
2023-2024,Atlanta Hawks,SG,38,0,414,34,90,0.378,2,10,0.2,32,80,0.4,0.389,13,17,0.765,11,40,51,92,11,3,20,25,83,Trent Forrest
2012-2013,Denver Nuggets,SG,38,4,428,75,152,0.493,22,54,0.407,53,98,0.541,0.566,30,39,0.769,6,29,35,44,19,1,32,65,202,Evan Fournier
2013-2014,Denver Nuggets,SG,76,4,1503,228,544,0.419,89,237,0.376,139,307,0.453,0.501,93,123,0.756,34,168,202,112,34,7,100,179,638,Evan Fournier
2014-2015,Orlando Magic,SG,58,32,1661,253,575,0.44,85,225,0.378,168,350,0.48,0.514,107,147,0.728,28,125,153,120,40,2,82,116,698,Evan Fournier
2015-2016,Orlando Magic,SF,79,71,2566,429,929,0.462,156,390,0.4,273,539,0.506,0.546,199,238,0.836,33,192,225,213,96,2,133,214,1213,Evan Fournier
2016-2017,Orlando Magic,SG,68,66,2234,408,930,0.439,128,360,0.356,280,570,0.491,0.508,223,277,0.805,44,165,209,202,66,4,141,180,1167,Evan Fournier
2017-2018,Orlando Magic,SF,57,57,1837,368,802,0.459,127,335,0.379,241,467,0.516,0.538,150,173,0.867,23,157,180,165,47,16,95,138,1013,Evan Fournier
2018-2019,Orlando Magic,SG,81,81,2553,468,1069,0.438,153,450,0.34,315,619,0.509,0.509,137,170,0.806,38,220,258,295,71,12,154,225,1226,Evan Fournier
2019-2020,Orlando Magic,SF,66,66,2076,434,929,0.467,173,434,0.399,261,495,0.527,0.56,180,220,0.818,18,153,171,209,71,15,125,161,1221,Evan Fournier
2020-2021,Total,SF,42,36,1259,247,541,0.457,117,283,0.413,130,258,0.504,0.565,108,137,0.788,10,118,128,144,47,19,73,96,719,Evan Fournier
2020-2021,Orlando Magic,SF,26,26,787,170,369,0.461,73,188,0.388,97,181,0.536,0.56,98,123,0.797,5,70,75,95,27,9,54,55,511,Evan Fournier
2020-2021,Boston Celtics,SF,16,10,472,77,172,0.448,44,95,0.463,33,77,0.429,0.576,10,14,0.714,5,48,53,49,20,10,19,41,208,Evan Fournier
2021-2022,New York Knicks,SG,80,80,2358,402,965,0.417,241,619,0.389,161,346,0.465,0.541,80,113,0.708,34,176,210,171,79,20,105,180,1125,Evan Fournier
2022-2023,New York Knicks,SG,27,7,459,56,166,0.337,35,114,0.307,21,52,0.404,0.443,18,21,0.857,4,45,49,36,16,3,22,46,165,Evan Fournier
2023-2024,Total,SG,32,0,580,79,221,0.357,33,130,0.254,46,91,0.505,0.432,29,36,0.806,5,53,58,48,29,7,21,48,220,Evan Fournier
2023-2024,New York Knicks,SG,3,0,39,4,20,0.2,2,15,0.133,2,5,0.4,0.25,2,2,1,0,4,4,3,4,0,1,4,12,Evan Fournier
2023-2024,Detroit Pistons,SG,29,0,541,75,201,0.373,31,115,0.27,44,86,0.512,0.45,27,34,0.794,5,49,54,45,25,7,20,44,208,Evan Fournier
2017-2018,Sacramento Kings,PG,73,61,2026,328,797,0.412,47,153,0.307,281,644,0.436,0.441,141,195,0.723,33,171,204,320,70,20,173,163,844,De'Aaron Fox
2018-2019,Sacramento Kings,PG,81,81,2546,505,1102,0.458,86,232,0.371,419,870,0.482,0.497,303,417,0.727,43,261,304,590,133,45,227,204,1399,De'Aaron Fox
2019-2020,Sacramento Kings,PG,51,49,1634,391,815,0.48,54,185,0.292,337,630,0.535,0.513,241,342,0.705,35,161,196,348,74,25,158,145,1077,De'Aaron Fox
2020-2021,Sacramento Kings,PG,58,58,2036,529,1110,0.477,103,320,0.322,426,790,0.539,0.523,300,417,0.719,33,170,203,417,87,27,174,170,1461,De'Aaron Fox
2021-2022,Sacramento Kings,PG,59,59,2084,516,1092,0.473,74,249,0.297,442,843,0.524,0.506,261,348,0.75,25,206,231,330,68,25,168,172,1367,De'Aaron Fox
2022-2023,Sacramento Kings,PG,73,73,2435,682,1331,0.512,119,367,0.324,563,964,0.584,0.557,343,440,0.78,40,266,306,447,83,23,181,172,1826,De'Aaron Fox
2023-2024,Sacramento Kings,PG,74,74,2659,720,1549,0.465,214,580,0.369,506,969,0.522,0.534,312,423,0.738,67,273,340,418,150,31,194,193,1966,De'Aaron Fox
2024-2025,Sacramento Kings,PG,31,31,1154,300,623,0.482,64,193,0.332,236,430,0.549,0.533,149,184,0.81,34,122,156,189,49,10,107,84,813,De'Aaron Fox
2018-2019,Orlando Magic,SG,10,0,44,7,21,0.333,0,6,0,7,15,0.467,0.333,1,4,0.25,3,2,5,1,1,0,1,6,15,Melvin Frazier
2019-2020,Orlando Magic,SG,19,0,126,15,34,0.441,8,16,0.5,7,18,0.389,0.559,2,4,0.5,2,8,10,3,9,2,5,11,40,Melvin Frazier
2021-2022,Oklahoma City Thunder,SG,3,0,120,13,48,0.271,1,21,0.048,12,27,0.444,0.281,5,7,0.714,5,8,13,1,1,0,3,8,32,Melvin Frazier
2024-2025,Indiana Pacers,PF,17,1,119,10,22,0.455,1,6,0.167,9,16,0.563,0.477,5,9,0.556,4,10,14,6,2,2,4,15,26,Enrique Freeman
2023-2024,Toronto Raptors,PG,22,6,403,55,124,0.444,10,42,0.238,45,82,0.549,0.484,33,36,0.917,16,54,70,40,10,4,25,28,153,Javon Freeman-Liberty
2023-2024,Total,SF,6,0,40,6,15,0.4,1,5,0.2,5,10,0.5,0.433,2,2,1,4,1,5,0,3,0,2,2,15,Alex Fudge
2023-2024,Los Angeles Lakers,SF,4,0,14,1,6,0.167,0,2,0,1,4,0.25,0.167,2,2,1,2,0,2,0,0,0,1,1,4,Alex Fudge
2023-2024,Dallas Mavericks,SF,2,0,26,5,9,0.556,1,3,0.333,4,6,0.667,0.611,0,0,,2,1,3,0,3,0,1,1,11,Alex Fudge
2017-2018,Philadelphia 76ers,SG,14,0,253,45,111,0.405,0,1,0,45,110,0.409,0.405,10,21,0.476,11,32,43,53,12,4,17,22,100,Markelle Fultz
2018-2019,Philadelphia 76ers,SG,19,15,427,65,155,0.419,4,14,0.286,61,141,0.433,0.432,21,37,0.568,26,44,70,59,17,5,25,52,155,Markelle Fultz
2019-2020,Orlando Magic,PG,72,60,1996,359,772,0.465,36,135,0.267,323,637,0.507,0.488,116,159,0.73,41,197,238,369,90,11,147,142,870,Markelle Fultz
2020-2021,Orlando Magic,PG,8,8,215,41,104,0.394,4,16,0.25,37,88,0.42,0.413,17,19,0.895,5,20,25,43,8,2,18,18,103,Markelle Fultz
2021-2022,Orlando Magic,PG,18,3,360,83,175,0.474,4,17,0.235,79,158,0.5,0.486,25,31,0.806,4,45,49,99,20,5,40,22,195,Markelle Fultz
2022-2023,Orlando Magic,PG,60,60,1778,349,679,0.514,27,87,0.31,322,592,0.544,0.534,112,143,0.783,69,165,234,341,87,26,139,131,837,Markelle Fultz
2023-2024,Orlando Magic,PG,43,18,910,154,326,0.472,4,18,0.222,150,308,0.487,0.479,23,33,0.697,56,82,138,120,42,15,50,65,335,Markelle Fultz
2023-2024,Chicago Bulls,SG,5,0,13,0,4,0,0,3,0,0,1,0,0,0,0,0,0,0,0,1,1,0,0,0,0,Andrew Funk
2024-2025,Indiana Pacers,SG,19,0,205,20,54,0.37,11,32,0.344,9,22,0.409,0.472,7,7,1,13,16,29,9,8,6,9,19,58,Johnny Furphy
2019-2020,Total,PF,30,1,235,21,48,0.438,6,20,0.3,15,28,0.536,0.5,15,22,0.682,21,31,52,8,11,7,16,39,63,Wenyen Gabriel
2019-2020,Sacramento Kings,PF,11,0,61,6,17,0.353,1,8,0.125,5,9,0.556,0.382,6,10,0.6,4,6,10,3,3,2,5,7,19,Wenyen Gabriel
2019-2020,Portland Trail Blazers,PF,19,1,174,15,31,0.484,5,12,0.417,10,19,0.526,0.565,9,12,0.75,17,25,42,5,8,5,11,32,44,Wenyen Gabriel
2020-2021,New Orleans Pelicans,PF,21,0,241,24,60,0.4,13,32,0.406,11,28,0.393,0.508,11,17,0.647,20,34,54,11,9,8,15,32,72,Wenyen Gabriel
2021-2022,Total,PF,26,5,358,54,110,0.491,8,28,0.286,46,82,0.561,0.527,25,42,0.595,39,58,97,14,5,11,16,68,141,Wenyen Gabriel
2021-2022,Brooklyn Nets,PF,1,0,1,0,0,,0,0,,0,0,,,0,0,,0,1,1,0,0,0,0,0,0,Wenyen Gabriel
2021-2022,Los Angeles Clippers,PF,6,0,46,5,13,0.385,2,5,0.4,3,8,0.375,0.462,2,4,0.5,5,9,14,2,1,2,3,11,14,Wenyen Gabriel
2021-2022,Los Angeles Lakers,PF,19,5,311,49,97,0.505,6,23,0.261,43,74,0.581,0.536,23,38,0.605,34,48,82,12,4,9,13,57,127,Wenyen Gabriel
2022-2023,Los Angeles Lakers,C,68,2,1024,155,260,0.596,10,36,0.278,145,224,0.647,0.615,52,84,0.619,116,170,286,36,26,35,46,144,372,Wenyen Gabriel
2023-2024,Memphis Grizzlies,PF,5,0,81,8,22,0.364,1,6,0.167,7,16,0.438,0.386,0,5,0,7,18,25,3,2,2,8,10,17,Wenyen Gabriel
2019-2020,Chicago Bulls,C,43,7,609,94,134,0.701,0,0,,94,134,0.701,0.701,32,60,0.533,52,54,106,21,13,56,29,98,220,Daniel Gafford
2020-2021,Total,C,54,11,791,154,225,0.684,0,0,,154,225,0.684,0.684,72,108,0.667,94,137,231,29,26,75,41,98,380,Daniel Gafford
2020-2021,Chicago Bulls,C,31,11,383,60,87,0.69,0,0,,60,87,0.69,0.69,27,41,0.659,44,59,103,17,11,34,22,54,147,Daniel Gafford
2020-2021,Washington Wizards,C,23,0,408,94,138,0.681,0,0,,94,138,0.681,0.681,45,67,0.672,50,78,128,12,15,41,19,44,233,Daniel Gafford
2021-2022,Washington Wizards,C,72,53,1444,285,411,0.693,0,1,0,285,410,0.695,0.693,107,153,0.699,155,252,407,68,30,99,65,170,677,Daniel Gafford
2022-2023,Washington Wizards,C,78,47,1604,289,395,0.732,0,0,,289,395,0.732,0.732,127,187,0.679,163,270,433,84,33,99,85,187,705,Daniel Gafford
2023-2024,Total,PF,74,66,1815,348,480,0.725,0,0,,348,480,0.725,0.725,118,175,0.674,195,367,562,115,65,153,74,227,814,Daniel Gafford
2023-2024,Washington Wizards,C,45,45,1192,203,294,0.69,0,0,,203,294,0.69,0.69,84,119,0.706,131,230,361,69,44,97,46,147,490,Daniel Gafford
2023-2024,Dallas Mavericks,PF,29,21,623,145,186,0.78,0,0,,145,186,0.78,0.78,34,56,0.607,64,137,201,46,21,56,28,80,324,Daniel Gafford
2024-2025,Dallas Mavericks,C,30,13,613,150,208,0.721,0,0,,150,208,0.721,0.721,64,95,0.674,75,108,183,38,13,36,29,76,364,Daniel Gafford
2008-2009,New York Knicks,SG,28,2,412,56,125,0.448,32,72,0.444,24,53,0.453,0.576,26,27,0.963,13,42,55,15,14,4,15,48,170,Danilo Gallinari
2009-2010,New York Knicks,SF,81,74,2747,392,927,0.423,186,488,0.381,206,439,0.469,0.523,251,307,0.818,65,333,398,135,75,58,110,191,1221,Danilo Gallinari
2010-2011,Total,SF,62,60,2104,265,640,0.414,103,293,0.352,162,347,0.467,0.495,337,391,0.862,59,246,305,104,51,27,83,144,970,Danilo Gallinari
2010-2011,New York Knicks,PF,48,48,1671,211,509,0.415,83,239,0.347,128,270,0.474,0.496,259,290,0.893,48,181,229,82,38,18,58,117,764,Danilo Gallinari
2010-2011,Denver Nuggets,SF,14,12,433,54,131,0.412,20,54,0.37,34,77,0.442,0.489,78,101,0.772,11,65,76,22,13,9,25,27,206,Danilo Gallinari
2011-2012,Denver Nuggets,SF,43,40,1351,193,466,0.414,60,183,0.328,133,283,0.47,0.479,182,209,0.871,28,174,202,116,42,23,68,86,628,Danilo Gallinari
2012-2013,Denver Nuggets,SF,71,71,2309,364,871,0.418,135,362,0.373,229,509,0.45,0.495,286,348,0.822,65,302,367,176,64,36,111,130,1149,Danilo Gallinari
2014-2015,Denver Nuggets,SF,59,27,1426,228,568,0.401,107,301,0.355,121,267,0.453,0.496,171,191,0.895,31,187,218,83,47,20,57,94,734,Danilo Gallinari
2015-2016,Denver Nuggets,SF,53,53,1839,287,700,0.41,87,239,0.364,200,461,0.434,0.472,375,432,0.868,52,229,281,135,42,19,77,87,1036,Danilo Gallinari
2016-2017,Denver Nuggets,SF,63,63,2134,335,750,0.447,126,324,0.389,209,426,0.491,0.531,349,387,0.902,39,286,325,135,40,15,82,93,1145,Danilo Gallinari
2017-2018,Los Angeles Clippers,SF,21,21,671,102,256,0.398,36,111,0.324,66,145,0.455,0.469,81,87,0.931,9,92,101,41,12,10,26,30,321,Danilo Gallinari
2018-2019,Los Angeles Clippers,SF,68,68,2059,409,884,0.463,161,372,0.433,248,512,0.484,0.554,367,406,0.904,54,363,417,178,49,23,99,129,1346,Danilo Gallinari
2019-2020,Oklahoma City Thunder,PF,62,62,1834,358,817,0.438,178,439,0.405,180,378,0.476,0.547,266,298,0.893,34,288,322,119,42,5,76,75,1160,Danilo Gallinari
2020-2021,Atlanta Hawks,PF,51,4,1222,206,475,0.434,103,254,0.406,103,221,0.466,0.542,161,174,0.925,17,194,211,76,30,10,43,105,676,Danilo Gallinari
2021-2022,Atlanta Hawks,PF,66,18,1672,259,597,0.434,112,294,0.381,147,303,0.485,0.528,141,156,0.904,35,273,308,101,28,12,38,93,771,Danilo Gallinari
2023-2024,Total,SF,49,0,630,83,190,0.437,30,93,0.323,53,97,0.546,0.516,84,98,0.857,20,88,108,55,14,6,23,50,280,Danilo Gallinari
2023-2024,Washington Wizards,PF,26,0,385,57,131,0.435,20,64,0.313,37,67,0.552,0.511,47,56,0.839,12,64,76,31,6,3,12,26,181,Danilo Gallinari
2023-2024,Detroit Pistons,SF,6,0,90,12,22,0.545,7,12,0.583,5,10,0.5,0.705,21,24,0.875,2,12,14,12,2,2,1,9,52,Danilo Gallinari
2023-2024,Milwaukee Bucks,SF,17,0,155,14,37,0.378,3,17,0.176,11,20,0.55,0.419,16,18,0.889,6,12,18,12,6,1,10,15,47,Danilo Gallinari
2014-2015,New York Knicks,PG,45,41,1457,204,511,0.399,62,176,0.352,142,335,0.424,0.46,63,78,0.808,37,153,190,150,52,12,61,129,533,Langston Galloway
2015-2016,New York Knicks,PG,82,7,2033,231,588,0.393,77,224,0.344,154,364,0.423,0.458,86,114,0.754,43,245,288,207,77,22,61,177,625,Langston Galloway
2016-2017,Total,PG,74,2,1495,207,545,0.38,120,308,0.39,87,237,0.367,0.49,51,64,0.797,27,129,156,93,46,6,46,96,585,Langston Galloway
2016-2017,New Orleans Pelicans,PG,55,0,1120,165,441,0.374,101,268,0.377,64,173,0.37,0.489,40,52,0.769,20,101,121,65,40,5,28,76,471,Langston Galloway
2016-2017,Sacramento Kings,PG,19,2,375,42,104,0.404,19,40,0.475,23,64,0.359,0.495,11,12,0.917,7,28,35,28,6,1,18,20,114,Langston Galloway
2017-2018,Detroit Pistons,SG,58,2,863,126,340,0.371,75,218,0.344,51,122,0.418,0.481,33,41,0.805,13,79,92,58,35,5,18,39,360,Langston Galloway
2018-2019,Detroit Pistons,SG,80,4,1745,228,587,0.388,135,380,0.355,93,207,0.449,0.503,81,96,0.844,49,122,171,85,37,8,24,135,672,Langston Galloway
2019-2020,Detroit Pistons,SG,66,6,1702,236,542,0.435,132,331,0.399,104,211,0.493,0.557,73,85,0.859,33,116,149,101,48,11,40,96,677,Langston Galloway
2020-2021,Phoenix Suns,SG,40,0,438,66,147,0.449,36,85,0.424,30,62,0.484,0.571,22,23,0.957,7,35,42,26,8,0,13,25,190,Langston Galloway
2021-2022,Total,SG,7,0,107,6,26,0.231,2,16,0.125,4,10,0.4,0.269,0,0,,3,15,18,12,1,0,6,7,14,Langston Galloway
2021-2022,Brooklyn Nets,SG,4,0,58,5,13,0.385,2,8,0.25,3,5,0.6,0.462,0,0,,1,7,8,5,0,0,5,5,12,Langston Galloway
2021-2022,Milwaukee Bucks,SG,3,0,49,1,13,0.077,0,8,0,1,5,0.2,0.077,0,0,,2,8,10,7,1,0,1,2,2,Langston Galloway
2019-2020,Cleveland Cavaliers,SG,59,59,1824,280,699,0.401,105,296,0.355,175,403,0.434,0.476,63,72,0.875,27,84,111,229,42,4,151,92,728,Darius Garland
2020-2021,Cleveland Cavaliers,PG,54,50,1790,362,802,0.451,105,266,0.395,257,536,0.479,0.517,112,132,0.848,23,106,129,329,66,6,164,110,941,Darius Garland
2021-2022,Cleveland Cavaliers,PG,68,68,2430,542,1173,0.462,174,454,0.383,368,719,0.512,0.536,215,241,0.892,39,185,224,583,89,7,248,115,1473,Darius Garland
2022-2023,Cleveland Cavaliers,PG,69,69,2447,522,1129,0.462,169,412,0.41,353,717,0.492,0.537,277,321,0.863,28,157,185,538,85,9,199,148,1490,Darius Garland
2023-2024,Cleveland Cavaliers,PG,57,57,1901,375,841,0.446,132,356,0.371,243,485,0.501,0.524,146,175,0.834,30,122,152,373,74,7,176,95,1028,Darius Garland
2024-2025,Cleveland Cavaliers,PG,30,30,900,221,446,0.496,89,204,0.436,132,242,0.545,0.595,86,93,0.925,16,61,77,193,33,7,73,66,617,Darius Garland
2021-2022,Miami Heat,SG,12,0,128,5,21,0.238,1,4,0.25,4,17,0.235,0.262,2,5,0.4,9,14,23,7,5,3,2,16,13,Marcus Garrett
2021-2022,Houston Rockets,PF,24,2,240,19,44,0.432,5,20,0.25,14,24,0.583,0.489,5,7,0.714,21,62,83,17,10,11,6,28,48,Usman Garuba
2022-2023,Houston Rockets,C,75,1,970,86,177,0.486,24,59,0.407,62,118,0.525,0.554,29,47,0.617,120,187,307,64,44,29,47,135,225,Usman Garuba
2023-2024,Golden State Warriors,PF,6,0,18,1,6,0.167,0,1,0,1,5,0.2,0.167,1,2,0.5,3,4,7,1,1,3,2,2,3,Usman Garuba
2021-2022,Detroit Pistons,C,32,5,389,66,147,0.449,16,49,0.327,50,98,0.51,0.503,38,61,0.623,58,42,100,20,9,6,18,55,186,Luka Garza
2022-2023,Minnesota Timberwolves,C,28,0,243,63,116,0.543,14,39,0.359,49,77,0.636,0.603,41,52,0.788,33,30,63,18,3,2,14,43,181,Luka Garza
2023-2024,Minnesota Timberwolves,C,25,0,122,36,75,0.48,9,32,0.281,27,43,0.628,0.54,18,25,0.72,19,12,31,4,4,1,6,24,99,Luka Garza
2024-2025,Minnesota Timberwolves,C,9,0,46,14,25,0.56,2,8,0.25,12,17,0.706,0.6,5,8,0.625,4,7,11,1,1,0,3,4,35,Luka Garza
2023-2024,New Orleans Pelicans,SF,1,0,7,0,4,0,0,2,0,0,2,0,0,0,0,0,1,1,0,0,0,0,0,0,0,Kaiser Gates
2023-2024,Utah Jazz,PG,75,44,2023,319,815,0.391,147,440,0.334,172,375,0.459,0.482,189,223,0.848,15,196,211,332,36,7,188,91,974,Keyonte George
2024-2025,Utah Jazz,PG,25,25,791,135,343,0.394,68,195,0.349,67,148,0.453,0.493,67,83,0.807,12,72,84,143,18,5,83,45,405,Keyonte George
2024-2025,Washington Wizards,SG,23,6,588,57,171,0.333,28,113,0.248,29,58,0.5,0.415,22,30,0.733,17,75,92,55,17,16,25,68,164,Kyshawn George
2010-2011,Indiana Pacers,SG,61,19,1265,179,395,0.453,41,138,0.297,138,257,0.537,0.505,77,101,0.762,37,187,224,65,62,26,70,127,476,Paul George
2011-2012,Indiana Pacers,SG,66,66,1958,281,639,0.44,90,234,0.385,191,405,0.472,0.51,146,182,0.802,56,314,370,158,108,38,117,191,798,Paul George
2012-2013,Indiana Pacers,SF,79,79,2972,493,1176,0.419,170,469,0.362,323,707,0.457,0.491,221,274,0.807,88,515,603,327,143,51,233,227,1377,Paul George
2013-2014,Indiana Pacers,SF,80,80,2898,577,1362,0.424,182,500,0.364,395,862,0.458,0.49,401,464,0.864,64,478,542,283,151,22,224,198,1737,Paul George
2014-2015,Indiana Pacers,SF,6,0,91,18,49,0.367,9,22,0.409,9,27,0.333,0.459,8,11,0.727,4,18,22,6,5,1,12,11,53,Paul George
2015-2016,Indiana Pacers,SF,81,81,2819,605,1449,0.418,210,566,0.371,395,883,0.447,0.49,454,528,0.86,79,484,563,329,152,29,265,230,1874,Paul George
2016-2017,Indiana Pacers,SF,75,75,2689,622,1348,0.461,195,496,0.393,427,852,0.501,0.534,336,374,0.898,58,434,492,251,119,27,220,206,1775,Paul George
2017-2018,Oklahoma City Thunder,SF,79,79,2891,576,1340,0.43,244,609,0.401,332,731,0.454,0.521,338,411,0.822,72,375,447,263,161,39,212,233,1734,Paul George
2018-2019,Oklahoma City Thunder,SF,77,77,2841,707,1614,0.438,292,757,0.386,415,857,0.484,0.529,453,540,0.839,105,523,628,318,170,34,205,214,2159,Paul George
2019-2020,Los Angeles Clippers,SF,48,48,1419,343,782,0.439,157,381,0.412,186,401,0.464,0.539,190,217,0.876,24,248,272,185,68,20,125,113,1033,Paul George
2020-2021,Los Angeles Clippers,SF,54,54,1821,445,953,0.467,171,416,0.411,274,537,0.51,0.557,198,228,0.868,45,314,359,280,62,24,179,132,1259,Paul George
2021-2022,Los Angeles Clippers,PF,31,31,1077,268,636,0.421,91,257,0.354,177,379,0.467,0.493,127,148,0.858,12,201,213,176,67,13,126,74,754,Paul George
2022-2023,Los Angeles Clippers,SF,56,56,1939,459,1004,0.457,158,426,0.371,301,578,0.521,0.536,256,294,0.871,45,297,342,288,83,20,176,159,1332,Paul George
2023-2024,Los Angeles Clippers,PF,74,74,2502,582,1236,0.471,243,588,0.413,339,648,0.523,0.569,264,291,0.907,37,351,388,262,113,37,153,202,1671,Paul George
2024-2025,Philadelphia 76ers,PF,18,18,578,103,254,0.406,36,116,0.31,67,138,0.486,0.476,45,56,0.804,13,89,102,89,33,9,47,38,287,Paul George
2009-2010,Chicago Bulls,PF,82,70,2204,311,629,0.494,0,0,,311,629,0.494,0.494,113,175,0.646,226,385,611,70,50,104,114,282,735,Taj Gibson
2010-2011,Chicago Bulls,PF,80,19,1742,234,502,0.466,1,8,0.125,233,494,0.472,0.467,100,148,0.676,162,296,458,58,39,106,71,203,569,Taj Gibson
2011-2012,Chicago Bulls,PF,63,0,1284,200,404,0.495,0,0,,200,404,0.495,0.495,84,135,0.622,135,197,332,47,27,81,60,131,484,Taj Gibson
2012-2013,Chicago Bulls,PF,65,5,1459,214,441,0.485,0,4,0,214,437,0.49,0.485,89,131,0.679,125,220,345,61,27,90,76,166,517,Taj Gibson
2013-2014,Chicago Bulls,PF,82,8,2351,429,896,0.479,0,7,0,429,889,0.483,0.479,211,281,0.751,200,358,558,91,41,112,150,207,1069,Taj Gibson
2014-2015,Chicago Bulls,PF,62,17,1692,254,506,0.502,0,0,,254,506,0.502,0.502,132,184,0.717,162,234,396,71,36,75,77,162,640,Taj Gibson
2015-2016,Chicago Bulls,PF,73,55,1936,263,500,0.526,0,3,0,263,497,0.529,0.526,101,146,0.692,206,298,504,106,47,77,78,180,627,Taj Gibson
2016-2017,Total,PF,78,71,1989,365,709,0.515,3,13,0.231,362,696,0.52,0.517,113,158,0.715,158,327,485,73,41,65,105,163,846,Taj Gibson
2016-2017,Chicago Bulls,PF,55,55,1502,276,530,0.521,2,12,0.167,274,518,0.529,0.523,85,119,0.714,120,262,382,60,27,50,77,123,639,Taj Gibson
2016-2017,Oklahoma City Thunder,PF,23,16,487,89,179,0.497,1,1,1,88,178,0.494,0.5,28,39,0.718,38,65,103,13,14,15,28,40,207,Taj Gibson
2017-2018,Minnesota Timberwolves,PF,82,82,2726,425,737,0.577,7,35,0.2,418,702,0.595,0.581,142,185,0.768,194,390,584,99,62,59,89,218,999,Taj Gibson
2018-2019,Minnesota Timberwolves,PF,70,57,1686,304,537,0.566,11,34,0.324,293,503,0.583,0.576,134,177,0.757,172,286,458,84,53,39,73,186,753,Taj Gibson
2019-2020,New York Knicks,C,62,56,1025,167,286,0.584,4,14,0.286,163,272,0.599,0.591,41,56,0.732,111,156,267,52,27,30,47,122,379,Taj Gibson
2020-2021,New York Knicks,C,45,3,936,99,158,0.627,3,15,0.2,96,143,0.671,0.636,40,55,0.727,99,151,250,36,31,49,22,99,241,Taj Gibson
2021-2022,New York Knicks,C,52,4,946,86,166,0.518,15,38,0.395,71,128,0.555,0.563,42,52,0.808,88,141,229,32,22,40,27,137,229,Taj Gibson
2022-2023,Washington Wizards,C,49,2,480,65,125,0.52,8,24,0.333,57,101,0.564,0.552,30,42,0.714,32,61,93,34,15,12,26,84,168,Taj Gibson
2023-2024,Total,PF,20,1,204,15,37,0.405,2,10,0.2,13,27,0.481,0.432,2,2,1,12,25,37,11,3,7,5,31,34,Taj Gibson
2023-2024,New York Knicks,PF,16,1,165,7,23,0.304,0,6,0,7,17,0.412,0.304,2,2,1,10,18,28,9,2,6,5,28,16,Taj Gibson
2023-2024,Detroit Pistons,PF,4,0,39,8,14,0.571,2,4,0.5,6,10,0.6,0.643,0,0,,2,7,9,2,1,1,0,3,18,Taj Gibson
2024-2025,Charlotte Hornets,C,14,8,151,16,34,0.471,1,2,0.5,15,32,0.469,0.485,4,6,0.667,21,24,45,7,6,3,9,18,37,Taj Gibson
2021-2022,Oklahoma City Thunder,SF,54,54,1700,281,670,0.419,56,213,0.263,225,457,0.492,0.461,56,79,0.709,98,323,421,345,51,20,171,88,674,Josh Giddey
2022-2023,Oklahoma City Thunder,PF,76,76,2367,539,1118,0.482,76,234,0.325,463,884,0.524,0.516,106,145,0.731,148,451,599,469,57,31,211,143,1260,Josh Giddey
2023-2024,Oklahoma City Thunder,SG,80,80,2011,402,847,0.475,82,243,0.337,320,604,0.53,0.523,100,124,0.806,111,403,514,386,51,44,168,111,986,Josh Giddey
2024-2025,Chicago Bulls,PG,27,27,732,122,270,0.452,33,101,0.327,89,169,0.527,0.513,44,62,0.71,33,140,173,187,26,12,73,41,321,Josh Giddey
2018-2019,Sacramento Kings,PF,58,0,820,175,348,0.503,0,6,0,175,342,0.512,0.503,58,91,0.637,66,156,222,85,31,22,73,150,408,Harry Giles
2019-2020,Sacramento Kings,C,46,17,667,139,251,0.554,0,2,0,139,249,0.558,0.554,38,49,0.776,43,145,188,60,22,18,44,119,316,Harry Giles
2020-2021,Portland Trail Blazers,C,38,0,348,42,97,0.433,8,23,0.348,34,74,0.459,0.474,16,27,0.593,31,102,133,29,8,13,20,54,108,Harry Giles
2023-2024,Total,C,23,0,100,23,50,0.46,3,14,0.214,20,36,0.556,0.49,7,13,0.538,12,18,30,6,2,3,6,15,56,Harry Giles
2023-2024,Brooklyn Nets,C,16,0,81,22,44,0.5,3,11,0.273,19,33,0.576,0.534,7,13,0.538,12,14,26,6,1,3,6,15,54,Harry Giles
2023-2024,Los Angeles Lakers,C,7,0,19,1,6,0.167,0,3,0,1,3,0.333,0.167,0,0,,0,4,4,0,1,0,0,0,2,Harry Giles
2018-2019,Los Angeles Clippers,PG,82,73,2174,341,716,0.476,51,139,0.367,290,577,0.503,0.512,156,195,0.8,57,175,232,270,96,45,141,175,889,Shai Gilgeous-Alexander
2019-2020,Oklahoma City Thunder,SG,70,70,2428,478,1015,0.471,87,251,0.347,391,764,0.512,0.514,288,357,0.807,47,365,412,232,79,47,134,117,1331,Shai Gilgeous-Alexander
2020-2021,Oklahoma City Thunder,SG,35,35,1180,287,565,0.508,71,170,0.418,216,395,0.547,0.571,185,229,0.808,19,147,166,207,27,23,106,70,830,Shai Gilgeous-Alexander
2021-2022,Oklahoma City Thunder,PG,56,56,1942,477,1052,0.453,89,297,0.3,388,755,0.514,0.496,328,405,0.81,37,241,278,331,71,46,154,142,1371,Shai Gilgeous-Alexander
2022-2023,Oklahoma City Thunder,PG,68,68,2416,704,1381,0.51,58,168,0.345,646,1213,0.533,0.531,669,739,0.905,59,270,329,371,112,65,192,192,2135,Shai Gilgeous-Alexander
2023-2024,Oklahoma City Thunder,PG,75,75,2553,796,1487,0.535,95,269,0.353,701,1218,0.576,0.567,567,649,0.874,65,350,415,465,150,67,162,184,2254,Shai Gilgeous-Alexander
2024-2025,Oklahoma City Thunder,PG,29,29,1008,317,614,0.516,64,181,0.354,253,433,0.584,0.568,205,233,0.88,25,139,164,178,57,32,76,62,903,Shai Gilgeous-Alexander
2020-2021,Washington Wizards,PF,26,4,218,30,60,0.5,7,24,0.292,23,36,0.639,0.558,13,16,0.813,16,35,51,11,10,4,8,27,80,Anthony Gill
2021-2022,Washington Wizards,PF,44,0,463,62,109,0.569,14,26,0.538,48,83,0.578,0.633,42,52,0.808,33,52,85,27,5,11,18,58,180,Anthony Gill
2022-2023,Washington Wizards,PF,59,8,624,71,132,0.538,4,29,0.138,67,103,0.65,0.553,49,67,0.731,37,62,99,34,7,12,15,70,195,Anthony Gill
2023-2024,Washington Wizards,PF,50,3,466,75,160,0.469,10,41,0.244,65,119,0.546,0.5,29,36,0.806,37,57,94,34,13,11,23,48,189,Anthony Gill
2024-2025,Washington Wizards,PF,20,0,149,17,34,0.5,4,12,0.333,13,22,0.591,0.559,10,18,0.556,5,20,25,6,5,1,5,12,48,Anthony Gill
2023-2024,Denver Nuggets,PG,24,0,225,32,69,0.464,15,38,0.395,17,31,0.548,0.572,8,12,0.667,1,20,21,27,13,0,14,24,87,Collin Gillespie
2024-2025,Phoenix Suns,PG,1,0,3,1,2,0.5,1,1,1,0,1,0,0.75,0,0,,0,0,0,0,0,0,0,0,3,Collin Gillespie
2022-2023,Memphis Grizzlies,PG,1,0,41,1,3,0.333,1,3,0.333,0,0,,0.5,0,0,,0,4,4,7,3,0,2,3,3,Jacob Gilyard
2023-2024,Total,PG,41,14,699,60,150,0.4,51,126,0.405,9,24,0.375,0.57,2,2,1,9,37,46,137,33,5,30,39,173,Jacob Gilyard
2023-2024,Memphis Grizzlies,PG,37,14,654,60,144,0.417,51,120,0.425,9,24,0.375,0.594,2,2,1,8,35,43,131,27,5,29,35,173,Jacob Gilyard
2023-2024,Brooklyn Nets,PG,4,0,45,0,6,0,0,6,0,0,0,,0,0,0,,1,2,3,6,6,0,1,4,0,Jacob Gilyard
2013-2014,Utah Jazz,C,45,0,434,36,74,0.486,0,0,,36,74,0.486,0.486,32,65,0.492,51,104,155,7,8,41,32,57,104,Rudy Gobert
2014-2015,Utah Jazz,C,82,37,2158,258,427,0.604,0,2,0,258,425,0.607,0.604,170,273,0.623,265,510,775,109,64,189,111,175,686,Rudy Gobert
2015-2016,Utah Jazz,C,61,60,1932,198,354,0.559,0,0,,198,354,0.559,0.559,161,283,0.569,208,460,668,91,45,135,114,163,557,Rudy Gobert
2016-2017,Utah Jazz,C,81,81,2744,413,625,0.661,0,1,0,413,624,0.662,0.661,311,476,0.653,314,721,1035,97,49,214,147,246,1137,Rudy Gobert
2017-2018,Utah Jazz,C,56,56,1816,276,444,0.622,0,0,,276,444,0.622,0.622,204,299,0.682,165,436,601,80,44,129,107,153,756,Rudy Gobert
2018-2019,Utah Jazz,C,81,80,2577,476,712,0.669,0,0,,476,712,0.669,0.669,332,522,0.636,309,732,1041,161,66,187,130,231,1284,Rudy Gobert
2019-2020,Utah Jazz,C,68,68,2333,386,557,0.693,0,0,,386,557,0.693,0.693,254,403,0.63,230,686,916,101,51,135,130,215,1026,Rudy Gobert
2020-2021,Utah Jazz,C,71,71,2187,391,579,0.675,0,4,0,391,575,0.68,0.675,233,374,0.623,240,720,960,89,40,190,118,163,1015,Rudy Gobert
2021-2022,Utah Jazz,C,66,66,2120,362,508,0.713,0,4,0,362,504,0.718,0.713,303,439,0.69,241,727,968,72,45,137,119,176,1027,Rudy Gobert
2022-2023,Minnesota Timberwolves,C,70,70,2148,360,546,0.659,0,3,0,360,543,0.663,0.659,219,340,0.644,231,583,814,87,56,95,122,210,939,Rudy Gobert
2023-2024,Minnesota Timberwolves,C,76,76,2593,406,614,0.661,0,3,0,406,611,0.664,0.661,249,390,0.638,285,697,982,102,52,162,118,238,1061,Rudy Gobert
2024-2025,Minnesota Timberwolves,C,30,30,1016,118,183,0.645,0,0,,118,183,0.645,0.645,73,104,0.702,96,220,316,52,22,42,46,78,309,Rudy Gobert
2018-2019,Denver Nuggets,PG,16,0,57,6,23,0.261,2,6,0.333,4,17,0.235,0.304,9,11,0.818,1,2,3,14,0,0,3,7,23,Brandon Goodwin
2019-2020,Atlanta Hawks,PG,34,1,430,76,190,0.4,26,87,0.299,50,103,0.485,0.468,28,30,0.933,11,61,72,51,12,4,29,43,206,Brandon Goodwin
2020-2021,Atlanta Hawks,PG,47,5,620,84,223,0.377,32,103,0.311,52,120,0.433,0.448,28,43,0.651,8,61,69,95,17,0,36,41,228,Brandon Goodwin
2021-2022,Cleveland Cavaliers,PG,36,5,502,64,154,0.416,19,55,0.345,45,99,0.455,0.477,24,38,0.632,14,53,67,91,25,1,36,39,171,Brandon Goodwin
2021-2022,Washington Wizards,SG,2,0,6,0,3,0,0,1,0,0,2,0,0,0,0,,0,1,1,0,0,0,0,1,0,Jordan Goodwin
2022-2023,Washington Wizards,PG,62,7,1106,158,353,0.448,38,118,0.322,120,235,0.511,0.501,53,69,0.768,57,148,205,168,58,26,57,95,407,Jordan Goodwin
2023-2024,Total,PG,57,12,1055,141,382,0.369,42,141,0.298,99,241,0.411,0.424,44,59,0.746,88,165,253,155,48,18,56,76,368,Jordan Goodwin
2023-2024,Phoenix Suns,PG,40,0,558,75,193,0.389,23,80,0.288,52,113,0.46,0.448,25,29,0.862,40,77,117,78,23,9,29,43,198,Jordan Goodwin
2023-2024,Memphis Grizzlies,PG,17,12,497,66,189,0.349,19,61,0.311,47,128,0.367,0.399,19,30,0.633,48,88,136,77,25,9,27,33,170,Jordan Goodwin
2014-2015,Orlando Magic,PF,47,8,797,93,208,0.447,13,48,0.271,80,160,0.5,0.478,44,61,0.721,46,123,169,33,21,22,38,83,243,Aaron Gordon
2015-2016,Orlando Magic,PF,78,37,1863,274,579,0.473,42,142,0.296,232,437,0.531,0.509,129,193,0.668,154,353,507,128,59,55,66,153,719,Aaron Gordon
2016-2017,Orlando Magic,SF,80,72,2298,393,865,0.454,77,267,0.288,316,598,0.528,0.499,156,217,0.719,116,289,405,150,65,40,89,172,1019,Aaron Gordon
2017-2018,Orlando Magic,PF,58,57,1909,375,865,0.434,115,342,0.336,260,523,0.497,0.5,157,225,0.698,87,370,457,136,59,45,107,111,1022,Aaron Gordon
2018-2019,Orlando Magic,PF,78,78,2633,470,1046,0.449,121,347,0.349,349,699,0.499,0.507,185,253,0.731,129,445,574,289,57,56,162,172,1246,Aaron Gordon
2019-2020,Orlando Magic,PF,62,62,2017,335,767,0.437,73,237,0.308,262,530,0.494,0.484,151,224,0.674,107,368,475,228,51,39,100,125,894,Aaron Gordon
2020-2021,Total,PF,50,50,1384,231,499,0.463,59,176,0.335,172,323,0.533,0.522,97,149,0.651,77,207,284,161,33,34,97,89,618,Aaron Gordon
2020-2021,Orlando Magic,PF,25,25,736,128,293,0.437,42,112,0.375,86,181,0.475,0.509,66,105,0.629,39,127,166,105,16,20,67,49,364,Aaron Gordon
2020-2021,Denver Nuggets,PF,25,25,648,103,206,0.5,17,64,0.266,86,142,0.606,0.541,31,44,0.705,38,80,118,56,17,14,30,40,254,Aaron Gordon
2021-2022,Denver Nuggets,PF,75,75,2376,434,834,0.52,87,260,0.335,347,574,0.605,0.573,171,230,0.743,125,314,439,188,44,44,133,148,1126,Aaron Gordon
2022-2023,Denver Nuggets,PF,68,68,2055,429,761,0.564,60,173,0.347,369,588,0.628,0.603,191,314,0.608,164,282,446,203,54,51,98,129,1109,Aaron Gordon
2023-2024,Denver Nuggets,PF,73,73,2297,398,716,0.556,40,138,0.29,358,578,0.619,0.584,177,269,0.658,174,297,471,259,56,45,105,142,1013,Aaron Gordon
2024-2025,Denver Nuggets,PF,17,16,489,81,155,0.523,22,50,0.44,59,105,0.562,0.594,49,65,0.754,32,66,98,52,8,3,23,31,233,Aaron Gordon
2008-2009,Los Angeles Clippers,SG,78,65,2677,411,901,0.456,131,337,0.389,280,564,0.496,0.529,299,350,0.854,45,156,201,215,78,35,164,172,1252,Eric Gordon
2009-2010,Los Angeles Clippers,SG,62,60,2229,352,784,0.449,119,321,0.371,233,463,0.503,0.525,222,299,0.742,25,135,160,186,69,14,144,96,1045,Eric Gordon
2010-2011,Los Angeles Clippers,SG,56,56,2112,427,949,0.45,106,291,0.364,321,658,0.488,0.506,287,348,0.825,45,119,164,244,71,18,151,115,1247,Eric Gordon
2011-2012,New Orleans Pelicans,SG,9,9,310,63,140,0.45,10,40,0.25,53,100,0.53,0.486,49,65,0.754,2,23,25,31,13,4,24,20,185,Eric Gordon
2012-2013,New Orleans Pelicans,SG,42,40,1264,235,584,0.402,56,173,0.324,179,411,0.436,0.45,187,222,0.842,10,67,77,137,45,8,117,75,713,Eric Gordon
2013-2014,New Orleans Pelicans,SG,64,64,2057,356,817,0.436,101,258,0.391,255,559,0.456,0.498,175,223,0.785,30,135,165,208,74,12,134,114,988,Eric Gordon
2014-2015,New Orleans Pelicans,SG,61,60,2018,285,694,0.411,141,315,0.448,144,379,0.38,0.512,107,133,0.805,28,131,159,229,50,14,122,145,818,Eric Gordon
2015-2016,New Orleans Pelicans,SG,45,44,1481,231,552,0.418,113,294,0.384,118,258,0.457,0.521,111,125,0.888,10,89,99,121,43,14,73,98,686,Eric Gordon
2016-2017,Houston Rockets,SG,75,15,2323,412,1016,0.406,246,661,0.372,166,355,0.468,0.527,147,175,0.84,29,172,201,188,48,41,121,150,1217,Eric Gordon
2017-2018,Houston Rockets,SG,69,30,2154,415,970,0.428,218,608,0.359,197,362,0.544,0.54,195,241,0.809,25,145,170,154,44,27,130,116,1243,Eric Gordon
2018-2019,Houston Rockets,SG,68,53,2158,384,938,0.409,216,600,0.36,168,338,0.497,0.525,119,152,0.783,17,131,148,129,41,27,90,143,1103,Eric Gordon
2019-2020,Houston Rockets,SF,36,15,1016,171,463,0.369,96,303,0.317,75,160,0.469,0.473,82,107,0.766,9,62,71,54,23,13,43,70,520,Eric Gordon
2020-2021,Houston Rockets,SG,27,13,789,159,367,0.433,69,210,0.329,90,157,0.573,0.527,94,114,0.825,8,50,58,71,14,13,51,44,481,Eric Gordon
2021-2022,Houston Rockets,SG,57,46,1670,268,564,0.475,124,301,0.412,144,263,0.548,0.585,105,135,0.778,15,98,113,154,28,18,107,63,765,Eric Gordon
2022-2023,Total,SG,69,58,1965,291,653,0.446,132,356,0.371,159,297,0.535,0.547,142,173,0.821,16,118,134,183,43,25,104,78,856,Eric Gordon
2022-2023,Houston Rockets,SG,47,47,1418,210,478,0.439,85,245,0.347,125,233,0.536,0.528,110,135,0.815,12,85,97,136,30,17,83,45,615,Eric Gordon
2022-2023,Los Angeles Clippers,SG,22,11,547,81,175,0.463,47,111,0.423,34,64,0.531,0.597,32,38,0.842,4,33,37,47,13,8,21,33,241,Eric Gordon
2023-2024,Phoenix Suns,SG,68,24,1893,274,618,0.443,150,397,0.378,124,221,0.561,0.565,51,64,0.797,16,106,122,139,66,30,73,79,749,Eric Gordon
2024-2025,Philadelphia 76ers,SG,19,1,316,32,89,0.36,14,51,0.275,18,38,0.474,0.438,17,22,0.773,3,15,18,24,13,5,14,13,95,Eric Gordon
2024-2025,Dallas Mavericks,PG,11,0,36,6,15,0.4,3,7,0.429,3,8,0.375,0.5,1,2,0.5,1,2,3,3,1,1,2,5,16,Jazian Gortman
2018-2019,Charlotte Hornets,PG,46,3,676,74,216,0.343,34,121,0.281,40,95,0.421,0.421,35,46,0.761,10,53,63,121,23,2,30,48,217,Devonte' Graham
2019-2020,Charlotte Hornets,PG,63,53,2211,368,963,0.382,218,585,0.373,150,378,0.397,0.495,191,233,0.82,42,170,212,471,62,15,181,115,1145,Devonte' Graham
2020-2021,Charlotte Hornets,PG,55,44,1659,252,669,0.377,179,477,0.375,73,192,0.38,0.51,133,158,0.842,22,126,148,295,48,6,84,77,816,Devonte' Graham
2021-2022,New Orleans Pelicans,PG,76,63,2162,296,815,0.363,192,563,0.341,104,252,0.413,0.481,118,140,0.843,37,140,177,316,71,12,105,95,902,Devonte' Graham
2022-2023,Total,PG,73,8,1338,161,431,0.374,119,338,0.352,42,93,0.452,0.512,98,131,0.748,19,103,122,196,45,16,53,79,539,Devonte' Graham
2022-2023,New Orleans Pelicans,PG,53,0,811,85,231,0.368,66,190,0.347,19,41,0.463,0.511,44,59,0.746,12,60,72,116,30,10,27,48,280,Devonte' Graham
2022-2023,San Antonio Spurs,PG,20,8,527,76,200,0.38,53,148,0.358,23,52,0.442,0.513,54,72,0.75,7,43,50,80,15,6,26,31,259,Devonte' Graham
2023-2024,San Antonio Spurs,PG,23,0,313,38,108,0.352,25,83,0.301,13,25,0.52,0.468,13,16,0.813,5,31,36,49,9,2,17,14,114,Devonte' Graham
2016-2017,Charlotte Hornets,SG,27,1,189,19,40,0.475,9,15,0.6,10,25,0.4,0.588,10,15,0.667,5,17,22,6,6,1,3,18,57,Treveon Graham
2017-2018,Charlotte Hornets,SG,63,2,1050,96,221,0.434,40,97,0.412,56,124,0.452,0.525,41,59,0.695,42,79,121,59,33,2,27,109,273,Treveon Graham
2018-2019,Brooklyn Nets,SG,35,21,715,64,191,0.335,38,128,0.297,26,63,0.413,0.435,18,22,0.818,23,84,107,34,13,7,17,68,184,Treveon Graham
2019-2020,Total,SF,55,20,929,87,242,0.36,33,120,0.275,54,122,0.443,0.428,36,56,0.643,51,99,150,45,24,6,29,102,243,Treveon Graham
2019-2020,Minnesota Timberwolves,SF,33,20,663,62,175,0.354,20,83,0.241,42,92,0.457,0.411,27,37,0.73,29,71,100,30,17,2,19,66,171,Treveon Graham
2019-2020,Atlanta Hawks,SF,22,0,266,25,67,0.373,13,37,0.351,12,30,0.4,0.47,9,19,0.474,22,28,50,15,7,4,10,36,72,Treveon Graham
2014-2015,Philadelphia 76ers,SF,65,11,1377,124,352,0.352,49,156,0.314,75,196,0.383,0.422,114,193,0.591,49,149,198,79,40,68,85,144,411,Jerami Grant
2015-2016,Philadelphia 76ers,PF,77,52,2066,251,599,0.419,35,146,0.24,216,453,0.477,0.448,212,322,0.658,99,262,361,135,54,127,110,215,749,Jerami Grant
2016-2017,Total,PF,80,4,1531,152,328,0.463,43,116,0.371,109,212,0.514,0.529,90,147,0.612,38,167,205,46,33,79,44,149,437,Jerami Grant
2016-2017,Philadelphia 76ers,PF,2,0,41,6,17,0.353,0,2,0,6,15,0.4,0.353,4,8,0.5,0,6,6,0,0,4,3,5,16,Jerami Grant
2016-2017,Oklahoma City Thunder,PF,78,4,1490,146,311,0.469,43,114,0.377,103,197,0.523,0.539,86,139,0.619,38,161,199,46,33,75,41,144,421,Jerami Grant
2017-2018,Oklahoma City Thunder,PF,81,1,1647,244,456,0.535,32,110,0.291,212,346,0.613,0.57,162,240,0.675,86,233,319,57,31,77,54,155,682,Jerami Grant
2018-2019,Oklahoma City Thunder,PF,80,77,2612,409,823,0.497,115,293,0.392,294,530,0.555,0.567,157,221,0.71,96,321,417,79,61,100,67,214,1090,Jerami Grant
2019-2020,Denver Nuggets,PF,71,24,1892,303,634,0.478,98,252,0.389,205,382,0.537,0.555,147,196,0.75,58,190,248,88,50,57,63,154,851,Jerami Grant
2020-2021,Detroit Pistons,SF,54,54,1829,400,932,0.429,115,329,0.35,285,603,0.473,0.491,290,343,0.845,35,215,250,152,35,58,109,125,1205,Jerami Grant
2021-2022,Detroit Pistons,PF,47,47,1500,298,699,0.426,91,254,0.358,207,445,0.465,0.491,217,259,0.838,28,163,191,111,44,49,85,107,904,Jerami Grant
2022-2023,Portland Trail Blazers,PF,63,63,2246,434,913,0.475,144,359,0.401,290,554,0.523,0.554,278,342,0.813,53,230,283,150,51,53,116,152,1290,Jerami Grant
2023-2024,Portland Trail Blazers,PF,54,54,1830,383,850,0.451,111,276,0.402,272,574,0.474,0.516,255,312,0.817,37,154,191,152,45,34,116,117,1132,Jerami Grant
2024-2025,Portland Trail Blazers,PF,28,28,906,137,360,0.381,68,182,0.374,69,178,0.388,0.475,79,96,0.823,13,83,96,65,25,27,41,63,421,Jerami Grant
2021-2022,Orlando Magic,PG,8,3,171,18,38,0.474,11,26,0.423,7,12,0.583,0.618,3,4,0.75,1,20,21,20,5,1,9,13,50,Hassani Gravett
2022-2023,Brooklyn Nets,PF,1,0,35,6,12,0.5,2,5,0.4,4,7,0.571,0.583,2,2,1,3,6,9,7,0,1,4,5,16,RaiQuan Gray
2023-2024,San Antonio Spurs,PF,3,0,39,10,17,0.588,3,7,0.429,7,10,0.7,0.676,0,0,,2,5,7,6,1,1,1,0,23,RaiQuan Gray
2022-2023,Milwaukee Bucks,SG,35,1,345,53,125,0.424,44,105,0.419,9,20,0.45,0.6,4,4,1,6,39,45,22,6,0,9,31,154,A.J. Green
2023-2024,Milwaukee Bucks,SG,56,0,614,83,196,0.423,69,169,0.408,14,27,0.519,0.599,17,19,0.895,9,55,64,30,9,4,12,49,252,A.J. Green
2024-2025,Milwaukee Bucks,SG,28,4,608,73,163,0.448,64,145,0.441,9,18,0.5,0.644,8,9,0.889,5,59,64,38,15,3,18,55,218,A.J. Green
2012-2013,Golden State Warriors,SF,79,1,1061,84,257,0.327,14,67,0.209,70,190,0.368,0.354,45,55,0.818,58,202,260,53,42,25,51,159,227,Draymond Green
2013-2014,Golden State Warriors,SF,82,12,1797,187,459,0.407,55,165,0.333,132,294,0.449,0.467,82,123,0.667,86,323,409,152,102,72,91,231,511,Draymond Green
2014-2015,Golden State Warriors,PF,79,79,2490,339,765,0.443,111,329,0.337,228,436,0.523,0.516,132,200,0.66,114,533,647,291,123,99,133,253,921,Draymond Green
2015-2016,Golden State Warriors,PF,81,81,2808,401,819,0.49,100,258,0.388,301,561,0.537,0.551,229,329,0.696,134,635,769,598,119,113,259,240,1131,Draymond Green
2016-2017,Golden State Warriors,PF,76,76,2471,272,650,0.418,81,263,0.308,191,387,0.494,0.481,151,213,0.709,98,501,599,533,154,106,184,217,776,Draymond Green
2017-2018,Golden State Warriors,PF,70,70,2287,281,619,0.454,77,256,0.301,204,363,0.562,0.516,134,173,0.775,75,460,535,508,95,91,202,185,773,Draymond Green
2018-2019,Golden State Warriors,PF,66,66,2065,188,422,0.445,47,165,0.285,141,257,0.549,0.501,63,91,0.692,60,421,481,454,95,70,169,197,486,Draymond Green
2019-2020,Golden State Warriors,PF,43,43,1222,123,316,0.389,36,129,0.279,87,187,0.465,0.446,63,83,0.759,23,243,266,266,59,33,98,110,345,Draymond Green
2020-2021,Golden State Warriors,PF,63,63,1982,170,380,0.447,34,126,0.27,136,254,0.535,0.492,70,88,0.795,55,394,449,558,105,52,188,194,444,Draymond Green
2021-2022,Golden State Warriors,PF,46,44,1329,135,257,0.525,16,54,0.296,119,203,0.586,0.556,60,91,0.659,45,291,336,320,61,50,139,136,346,Draymond Green
2022-2023,Golden State Warriors,PF,73,73,2297,250,474,0.527,40,131,0.305,210,343,0.612,0.57,77,108,0.713,66,459,525,500,74,60,204,229,617,Draymond Green
2023-2024,Golden State Warriors,PF,55,52,1490,185,372,0.497,51,129,0.395,134,243,0.551,0.566,54,74,0.73,76,322,398,332,55,47,135,166,475,Draymond Green
2024-2025,Golden State Warriors,PF,26,24,737,74,178,0.416,37,99,0.374,37,79,0.468,0.52,35,57,0.614,26,134,160,146,27,27,65,86,220,Draymond Green
2021-2022,Houston Rockets,SG,67,67,2138,406,954,0.426,157,458,0.343,249,496,0.502,0.508,188,236,0.797,33,193,226,176,44,18,135,103,1157,Jalen Green
2022-2023,Houston Rockets,SG,76,76,2602,566,1359,0.416,187,554,0.338,379,805,0.471,0.485,364,463,0.786,43,241,284,281,59,18,200,131,1683,Jalen Green
2023-2024,Houston Rockets,SG,82,82,2601,563,1332,0.423,201,605,0.332,362,727,0.498,0.498,283,352,0.804,41,382,423,291,66,28,191,115,1610,Jalen Green
2024-2025,Houston Rockets,SG,31,31,1006,208,506,0.411,78,239,0.326,130,267,0.487,0.488,105,122,0.861,15,124,139,82,32,8,78,50,599,Jalen Green
2014-2015,Total,PF,24,1,164,27,47,0.574,0,6,0,27,41,0.659,0.574,8,10,0.8,19,26,45,4,5,5,14,25,62,JaMychal Green
2014-2015,San Antonio Spurs,PF,4,0,25,4,7,0.571,0,2,0,4,5,0.8,0.571,0,0,,3,3,6,0,0,2,2,6,8,JaMychal Green
2014-2015,Memphis Grizzlies,PF,20,1,139,23,40,0.575,0,4,0,23,36,0.639,0.575,8,10,0.8,16,23,39,4,5,3,12,19,54,JaMychal Green
2015-2016,Memphis Grizzlies,PF,78,15,1446,230,495,0.465,15,45,0.333,215,450,0.478,0.48,103,137,0.752,139,234,373,67,46,33,83,189,578,JaMychal Green
2016-2017,Memphis Grizzlies,PF,77,75,2101,250,500,0.5,55,145,0.379,195,355,0.549,0.555,134,167,0.802,167,377,544,84,47,34,94,248,689,JaMychal Green
2017-2018,Memphis Grizzlies,PF,55,54,1542,223,488,0.457,43,127,0.339,180,361,0.499,0.501,80,111,0.721,147,317,464,79,32,25,76,153,569,JaMychal Green
2018-2019,Total,PF,65,6,1371,230,476,0.483,71,176,0.403,159,300,0.53,0.558,80,101,0.792,104,305,409,50,45,34,87,193,611,JaMychal Green
2018-2019,Memphis Grizzlies,PF,41,4,900,151,312,0.484,38,96,0.396,113,216,0.523,0.545,63,80,0.788,72,180,252,36,33,26,64,123,403,JaMychal Green
2018-2019,Los Angeles Clippers,PF,24,2,471,79,164,0.482,33,80,0.413,46,84,0.548,0.582,17,21,0.81,32,125,157,14,12,8,23,70,208,JaMychal Green
2019-2020,Los Angeles Clippers,PF,63,1,1307,151,352,0.429,92,238,0.387,59,114,0.518,0.56,36,48,0.75,77,311,388,49,29,24,54,174,430,JaMychal Green
2020-2021,Denver Nuggets,PF,58,5,1120,173,374,0.463,79,198,0.399,94,176,0.534,0.568,46,57,0.807,85,192,277,53,26,22,53,144,471,JaMychal Green
2021-2022,Denver Nuggets,PF,67,8,1085,159,327,0.486,33,124,0.266,126,203,0.621,0.537,81,93,0.871,81,200,281,59,43,26,57,158,432,JaMychal Green
2022-2023,Golden State Warriors,PF,57,1,797,136,252,0.54,42,111,0.378,94,141,0.667,0.623,52,67,0.776,72,133,205,51,25,23,52,105,366,JaMychal Green
2019-2020,Boston Celtics,SG,48,2,468,63,126,0.5,9,33,0.273,54,93,0.581,0.536,28,42,0.667,24,69,93,26,24,8,23,43,163,Javonte Green
2020-2021,Total,SF,41,2,473,53,102,0.52,10,30,0.333,43,72,0.597,0.569,30,40,0.75,26,45,71,17,28,6,19,45,146,Javonte Green
2020-2021,Boston Celtics,SF,25,2,345,39,71,0.549,7,22,0.318,32,49,0.653,0.599,20,30,0.667,20,32,52,11,18,2,13,32,105,Javonte Green
2020-2021,Chicago Bulls,SG,16,0,128,14,31,0.452,3,8,0.375,11,23,0.478,0.5,10,10,1,6,13,19,6,10,4,6,13,41,Javonte Green
2021-2022,Chicago Bulls,SF,65,45,1519,176,325,0.542,36,101,0.356,140,224,0.625,0.597,80,96,0.833,91,185,276,60,67,32,30,132,468,Javonte Green
2022-2023,Chicago Bulls,SF,32,1,480,61,108,0.565,13,35,0.371,48,73,0.658,0.625,30,45,0.667,27,61,88,23,24,21,20,52,165,Javonte Green
2023-2024,Chicago Bulls,SF,9,5,230,45,75,0.6,10,27,0.37,35,48,0.729,0.667,10,13,0.769,20,47,67,5,10,8,7,19,110,Javonte Green
2024-2025,New Orleans Pelicans,SG,30,12,645,64,142,0.451,20,59,0.339,44,83,0.53,0.521,32,43,0.744,30,67,97,21,30,19,19,42,180,Javonte Green
2007-2008,Seattle SuperSonics,SF,80,52,2253,320,749,0.427,21,76,0.276,299,673,0.444,0.441,177,238,0.744,101,278,379,119,46,49,158,198,838,Jeff Green
2008-2009,Oklahoma City Thunder,PF,78,78,2873,476,1068,0.446,96,247,0.389,380,821,0.463,0.491,242,307,0.788,120,399,519,155,81,33,173,202,1290,Jeff Green
2009-2010,Oklahoma City Thunder,PF,82,82,3043,485,1070,0.453,104,312,0.333,381,758,0.503,0.502,165,223,0.74,112,378,490,134,104,72,135,221,1239,Jeff Green
2010-2011,Total,SF,75,51,2427,368,820,0.449,64,211,0.303,304,609,0.499,0.488,198,244,0.811,73,287,360,108,53,37,99,210,998,Jeff Green
2010-2011,Oklahoma City Thunder,PF,49,49,1815,270,618,0.437,56,184,0.304,214,434,0.493,0.482,148,181,0.818,57,217,274,89,40,21,76,142,744,Jeff Green
2010-2011,Boston Celtics,SF,26,2,612,98,202,0.485,8,27,0.296,90,175,0.514,0.505,50,63,0.794,16,70,86,19,13,16,23,68,254,Jeff Green
2012-2013,Boston Celtics,PF,81,17,2252,376,806,0.467,70,182,0.385,306,624,0.49,0.51,214,265,0.808,55,263,318,128,56,68,132,175,1036,Jeff Green
2013-2014,Boston Celtics,SF,82,82,2805,482,1171,0.412,135,396,0.341,347,775,0.448,0.469,283,356,0.795,54,326,380,138,57,47,165,180,1382,Jeff Green
2014-2015,Total,SF,78,70,2454,416,967,0.43,97,292,0.332,319,675,0.473,0.48,239,287,0.833,64,264,328,134,53,34,108,147,1168,Jeff Green
2014-2015,Boston Celtics,SF,33,33,1093,206,475,0.434,47,154,0.305,159,321,0.495,0.483,121,144,0.84,21,120,141,53,27,13,56,66,580,Jeff Green
2014-2015,Memphis Grizzlies,SF,45,37,1361,210,492,0.427,50,138,0.362,160,354,0.452,0.478,118,143,0.825,43,144,187,81,26,21,52,81,588,Jeff Green
2015-2016,Total,SF,80,41,2253,354,824,0.43,67,213,0.315,287,611,0.47,0.47,164,220,0.745,74,258,332,138,58,40,93,164,939,Jeff Green
2015-2016,Memphis Grizzlies,SF,53,31,1544,240,557,0.431,42,136,0.309,198,421,0.47,0.469,124,155,0.8,55,186,241,98,40,19,69,102,646,Jeff Green
2015-2016,Los Angeles Clippers,SF,27,10,709,114,267,0.427,25,77,0.325,89,190,0.468,0.474,40,65,0.615,19,72,91,40,18,21,24,62,293,Jeff Green
2016-2017,Orlando Magic,PF,69,11,1534,220,558,0.394,53,193,0.275,167,365,0.458,0.442,145,168,0.863,39,175,214,81,37,13,75,103,638,Jeff Green
2017-2018,Cleveland Cavaliers,PF,78,14,1828,295,618,0.477,53,170,0.312,242,448,0.54,0.52,203,234,0.868,60,186,246,99,41,34,75,149,846,Jeff Green
2018-2019,Washington Wizards,PF,77,44,2097,326,687,0.475,111,320,0.347,215,367,0.586,0.555,183,206,0.888,57,252,309,137,43,39,101,160,946,Jeff Green
2019-2020,Total,C,48,4,960,159,344,0.462,62,183,0.339,97,161,0.602,0.552,73,91,0.802,24,109,133,50,26,19,42,89,453,Jeff Green
2019-2020,Utah Jazz,PF,30,2,553,75,195,0.385,34,104,0.327,41,91,0.451,0.472,49,63,0.778,14,67,81,20,12,10,27,46,233,Jeff Green
2019-2020,Houston Rockets,C,18,2,407,84,149,0.564,28,79,0.354,56,70,0.8,0.658,24,28,0.857,10,42,52,30,14,9,15,43,220,Jeff Green
2020-2021,Brooklyn Nets,PF,68,38,1835,261,530,0.492,103,250,0.412,158,280,0.564,0.59,125,161,0.776,34,229,263,108,36,27,54,122,750,Jeff Green
2021-2022,Denver Nuggets,PF,75,63,1849,277,529,0.524,53,168,0.315,224,361,0.62,0.574,165,198,0.833,41,190,231,96,28,27,71,151,772,Jeff Green
2022-2023,Denver Nuggets,PF,56,4,1091,160,328,0.488,30,104,0.288,130,224,0.58,0.534,87,117,0.744,38,106,144,69,18,17,46,99,437,Jeff Green
2023-2024,Houston Rockets,PF,78,6,1307,167,366,0.456,53,160,0.331,114,206,0.553,0.529,122,149,0.819,46,132,178,70,16,31,46,100,509,Jeff Green
2024-2025,Houston Rockets,PF,9,0,55,9,18,0.5,4,11,0.364,5,7,0.714,0.611,1,2,0.5,1,6,7,1,2,0,2,4,23,Jeff Green
2020-2021,Dallas Mavericks,SG,39,5,445,42,93,0.452,4,25,0.16,38,68,0.559,0.473,13,23,0.565,28,50,78,28,16,3,17,35,101,Josh Green
2021-2022,Dallas Mavericks,SG,67,3,1039,130,256,0.508,28,78,0.359,102,178,0.573,0.563,31,45,0.689,52,109,161,79,45,14,44,115,319,Josh Green
2022-2023,Dallas Mavericks,SG,60,21,1539,205,382,0.537,68,169,0.402,137,213,0.643,0.626,68,94,0.723,55,127,182,103,42,5,72,156,546,Josh Green
2023-2024,Dallas Mavericks,SG,57,33,1505,179,374,0.479,72,187,0.385,107,187,0.572,0.575,39,57,0.684,40,144,184,130,47,9,60,107,469,Josh Green
2024-2025,Charlotte Hornets,SG,28,27,785,73,173,0.422,39,95,0.411,34,78,0.436,0.535,15,27,0.556,29,43,72,44,25,11,27,85,200,Josh Green
2022-2023,Atlanta Hawks,SF,72,12,1401,248,533,0.465,101,259,0.39,147,274,0.536,0.56,42,47,0.894,37,116,153,73,42,12,42,87,639,AJ Griffin
2023-2024,Atlanta Hawks,SF,20,0,171,18,62,0.29,10,39,0.256,8,23,0.348,0.371,2,2,1,2,16,18,5,1,2,8,6,48,AJ Griffin
2021-2022,New York Knicks,SG,46,6,786,95,235,0.404,72,189,0.381,23,46,0.5,0.557,13,19,0.684,24,70,94,44,31,11,28,72,275,Quentin Grimes
2022-2023,New York Knicks,SG,71,66,2121,282,602,0.468,157,407,0.386,125,195,0.641,0.599,78,98,0.796,49,180,229,150,47,26,69,177,799,Quentin Grimes
2023-2024,Total,SG,51,18,1025,122,328,0.372,81,240,0.338,41,88,0.466,0.495,34,45,0.756,15,85,100,66,35,7,28,75,359,Quentin Grimes
2023-2024,New York Knicks,SG,45,18,910,113,286,0.395,77,212,0.363,36,74,0.486,0.53,24,34,0.706,14,74,88,52,30,3,21,66,327,Quentin Grimes
2023-2024,Detroit Pistons,SG,6,0,115,9,42,0.214,4,28,0.143,5,14,0.357,0.262,10,11,0.909,1,11,12,14,5,4,7,9,32,Quentin Grimes
2024-2025,Dallas Mavericks,SG,29,9,611,91,192,0.474,45,109,0.413,46,83,0.554,0.591,36,50,0.72,21,90,111,45,19,6,33,47,263,Quentin Grimes
2023-2024,Toronto Raptors,PF,11,0,120,11,38,0.289,0,3,0,11,35,0.314,0.289,4,9,0.444,12,11,23,5,3,18,12,15,26,Mouhamadou Gueye
2023-2024,Atlanta Hawks,PF,6,0,73,8,23,0.348,3,9,0.333,5,14,0.357,0.413,5,6,0.833,10,12,22,4,5,4,1,13,24,Mouhamed Gueye
2024-2025,Atlanta Hawks,PF,2,0,11,1,4,0.25,0,2,0,1,2,0.5,0.25,0,0,,0,2,2,0,0,0,1,0,2,Mouhamed Gueye
2019-2020,Sacramento Kings,SG,3,0,10,2,5,0.4,0,3,0,2,2,1,0.4,0,0,,0,1,1,1,0,0,0,1,4,Kyle Guy
2020-2021,Sacramento Kings,PG,31,0,235,29,88,0.33,13,46,0.283,16,42,0.381,0.403,16,20,0.8,5,30,35,32,6,0,11,20,87,Kyle Guy
2021-2022,Miami Heat,SG,19,0,186,26,65,0.4,14,40,0.35,12,25,0.48,0.508,8,12,0.667,4,13,17,17,7,1,13,12,74,Kyle Guy
2019-2020,Washington Wizards,PF,48,48,1444,254,545,0.466,25,87,0.287,229,458,0.5,0.489,116,140,0.829,78,216,294,87,37,8,53,105,649,Rui Hachimura
2020-2021,Washington Wizards,PF,57,57,1797,310,648,0.478,45,137,0.328,265,511,0.519,0.513,124,161,0.77,49,263,312,82,44,7,68,120,789,Rui Hachimura
2021-2022,Washington Wizards,PF,42,13,943,187,381,0.491,55,123,0.447,132,258,0.512,0.563,46,66,0.697,25,135,160,48,23,9,33,53,475,Rui Hachimura
2022-2023,Total,PF,63,9,1466,284,584,0.486,51,160,0.319,233,424,0.55,0.53,88,119,0.739,53,230,283,58,19,26,53,72,707,Rui Hachimura
2022-2023,Washington Wizards,PF,30,0,728,158,324,0.488,30,89,0.337,128,235,0.545,0.534,44,58,0.759,19,109,128,35,11,12,36,39,390,Rui Hachimura
2022-2023,Los Angeles Lakers,PF,33,9,738,126,260,0.485,21,71,0.296,105,189,0.556,0.525,44,61,0.721,34,121,155,23,8,14,17,33,317,Rui Hachimura
2023-2024,Los Angeles Lakers,PF,68,39,1826,363,676,0.537,98,232,0.422,265,444,0.597,0.609,99,134,0.739,58,236,294,81,41,25,46,101,923,Rui Hachimura
2024-2025,Los Angeles Lakers,PF,25,25,836,112,235,0.477,38,88,0.432,74,147,0.503,0.557,42,51,0.824,43,93,136,41,24,16,24,52,304,Rui Hachimura
2020-2021,Minnesota Timberwolves,PG,2,0,4,0,0,,0,0,,0,0,,,0,0,,0,0,0,0,0,0,1,0,0,Ashton Hagans
2023-2024,Portland Trail Blazers,PG,19,1,316,29,71,0.408,8,25,0.32,21,46,0.457,0.465,14,17,0.824,14,31,45,54,11,9,30,40,80,Ashton Hagans
2020-2021,Sacramento Kings,PG,58,20,1746,292,619,0.472,121,296,0.409,171,323,0.529,0.569,48,56,0.857,39,134,173,309,77,28,92,83,753,Tyrese Haliburton
2021-2022,Total,PG,77,77,2695,430,909,0.473,161,389,0.414,269,520,0.517,0.562,160,190,0.842,61,250,311,628,134,49,199,121,1181,Tyrese Haliburton
2021-2022,Sacramento Kings,SG,51,51,1757,268,586,0.457,104,252,0.413,164,334,0.491,0.546,87,104,0.837,39,160,199,379,86,34,115,71,727,Tyrese Haliburton
2021-2022,Indiana Pacers,PG,26,26,938,162,323,0.502,57,137,0.416,105,186,0.565,0.59,73,86,0.849,22,90,112,249,48,15,84,50,454,Tyrese Haliburton
2022-2023,Indiana Pacers,PG,56,56,1883,412,841,0.49,161,402,0.4,251,439,0.572,0.586,175,201,0.871,33,172,205,585,91,25,141,69,1160,Tyrese Haliburton
2023-2024,Indiana Pacers,PG,69,68,2224,500,1048,0.477,195,535,0.364,305,513,0.595,0.57,194,227,0.855,35,236,271,752,83,48,159,75,1389,Tyrese Haliburton
2024-2025,Indiana Pacers,PG,32,32,1124,191,443,0.431,95,269,0.353,96,174,0.552,0.538,79,93,0.849,22,90,112,280,38,18,62,45,556,Tyrese Haliburton
2019-2020,Oklahoma City Thunder,PG,11,0,81,6,30,0.2,4,17,0.235,2,13,0.154,0.267,4,8,0.5,2,5,7,13,4,1,5,6,20,Devon Hall
2022-2023,San Antonio Spurs,SF,9,0,83,9,28,0.321,3,15,0.2,6,13,0.462,0.375,7,9,0.778,3,9,12,11,1,0,7,6,28,Jordan Hall
2020-2021,Oklahoma City Thunder,SF,21,1,336,30,99,0.303,4,37,0.108,26,62,0.419,0.323,22,44,0.5,6,53,59,28,4,1,25,37,86,Josh Hall
2024-2025,Denver Nuggets,C,6,0,14,2,5,0.4,0,2,0,2,3,0.667,0.4,0,0,0,3,3,0,0,1,0,1,4,0,PJ Hall
2020-2021,Total,SG,51,1,888,136,313,0.435,27,87,0.31,109,226,0.482,0.478,55,82,0.671,29,150,179,87,21,10,53,61,354,R.J. Hampton
2020-2021,Denver Nuggets,SG,25,0,233,25,60,0.417,5,18,0.278,20,42,0.476,0.458,9,12,0.75,10,40,50,14,5,2,11,22,64,R.J. Hampton
2020-2021,Orlando Magic,SG,26,1,655,111,253,0.439,22,69,0.319,89,184,0.484,0.482,46,70,0.657,19,110,129,73,16,8,42,39,290,R.J. Hampton
2021-2022,Orlando Magic,SG,64,14,1402,175,457,0.383,64,183,0.35,111,274,0.405,0.453,75,117,0.641,23,171,194,158,42,13,87,101,489,R.J. Hampton
2022-2023,Total,SG,47,3,750,102,237,0.43,41,116,0.353,61,121,0.504,0.517,57,76,0.75,18,69,87,54,27,9,42,51,302,R.J. Hampton
2022-2023,Orlando Magic,SG,26,0,361,50,114,0.439,18,53,0.34,32,61,0.525,0.518,31,37,0.838,9,30,39,34,16,4,21,22,149,R.J. Hampton
2022-2023,Detroit Pistons,SG,21,3,389,52,123,0.423,23,63,0.365,29,60,0.483,0.516,26,39,0.667,9,39,48,20,11,5,21,29,153,R.J. Hampton
2023-2024,Miami Heat,PG,8,2,76,4,14,0.286,1,8,0.125,3,6,0.5,0.321,1,2,0.5,2,4,6,8,0,0,3,8,10,R.J. Hampton
2018-2019,Memphis Grizzlies,SG,2,0,26,3,12,0.25,0,5,0,3,7,0.429,0.25,2,2,1,0,1,1,5,1,0,1,1,8,Dusty Hannahs
2019-2020,Memphis Grizzlies,SG,2,0,13,4,9,0.444,2,3,0.667,2,6,0.333,0.556,2,2,1,0,1,1,0,0,0,0,1,12,Dusty Hannahs
2013-2014,New York Knicks,SG,81,1,1875,294,687,0.428,130,358,0.363,164,329,0.498,0.523,106,128,0.828,19,102,121,66,44,7,47,144,824,Tim Hardaway Jr.
2014-2015,New York Knicks,SG,70,30,1681,279,717,0.389,121,354,0.342,158,363,0.435,0.474,125,156,0.801,12,144,156,127,20,14,82,119,804,Tim Hardaway Jr.
2015-2016,Atlanta Hawks,SG,51,1,864,114,265,0.43,48,142,0.338,66,123,0.537,0.521,50,56,0.893,7,79,86,51,21,7,23,48,326,Tim Hardaway Jr.
2016-2017,Atlanta Hawks,SG,79,30,2154,415,912,0.455,149,417,0.357,266,495,0.537,0.537,164,214,0.766,35,189,224,182,55,15,106,103,1143,Tim Hardaway Jr.
2017-2018,New York Knicks,SG,57,54,1885,360,856,0.421,130,410,0.317,230,446,0.516,0.496,146,179,0.816,32,192,224,155,62,10,92,123,996,Tim Hardaway Jr.
2018-2019,Total,SG,65,63,2057,390,993,0.393,162,477,0.34,228,516,0.442,0.474,232,276,0.841,33,189,222,159,54,8,105,141,1174,Tim Hardaway Jr.
2018-2019,New York Knicks,SG,46,46,1499,282,726,0.388,117,337,0.347,165,389,0.424,0.469,199,233,0.854,26,135,161,122,42,6,81,106,880,Tim Hardaway Jr.
2018-2019,Dallas Mavericks,SG,19,17,558,108,267,0.404,45,140,0.321,63,127,0.496,0.489,33,43,0.767,7,54,61,37,12,2,24,35,294,Tim Hardaway Jr.
2019-2020,Dallas Mavericks,SG,71,58,2091,384,884,0.434,204,513,0.398,180,371,0.485,0.55,149,182,0.819,25,207,232,137,41,5,69,125,1121,Tim Hardaway Jr.
2020-2021,Dallas Mavericks,SG,70,31,1985,407,911,0.447,207,529,0.391,200,382,0.524,0.56,142,174,0.816,20,209,229,126,31,11,64,111,1163,Tim Hardaway Jr.
2021-2022,Dallas Mavericks,SG,42,20,1245,209,530,0.394,102,304,0.336,107,226,0.473,0.491,78,103,0.757,13,143,156,92,38,6,34,74,598,Tim Hardaway Jr.
2022-2023,Dallas Mavericks,SF,71,45,2152,340,847,0.401,212,550,0.385,128,297,0.431,0.527,127,165,0.77,21,230,251,129,49,12,60,120,1019,Tim Hardaway Jr.
2023-2024,Dallas Mavericks,SF,79,12,2120,392,976,0.402,211,597,0.353,181,379,0.478,0.51,144,169,0.852,22,232,254,139,42,6,69,106,1139,Tim Hardaway Jr.
2024-2025,Detroit Pistons,SG,28,28,770,94,226,0.416,55,154,0.357,39,72,0.542,0.538,39,45,0.867,6,51,57,44,10,0,19,36,282,Tim Hardaway Jr.
2009-2010,Oklahoma City Thunder,SG,76,0,1738,233,578,0.403,93,248,0.375,140,330,0.424,0.484,194,240,0.808,47,197,244,137,80,20,106,200,753,James Harden
2010-2011,Oklahoma City Thunder,SG,82,5,2189,298,684,0.436,113,324,0.349,185,360,0.514,0.518,289,343,0.843,42,213,255,176,92,24,106,207,998,James Harden
2011-2012,Oklahoma City Thunder,SG,62,2,1946,309,629,0.491,114,292,0.39,195,337,0.579,0.582,312,369,0.846,30,222,252,229,62,15,137,150,1044,James Harden
2012-2013,Houston Rockets,SG,78,78,2985,585,1337,0.438,179,486,0.368,406,851,0.477,0.504,674,792,0.851,62,317,379,455,142,38,295,178,2023,James Harden
2013-2014,Houston Rockets,SG,73,73,2777,549,1205,0.456,177,483,0.366,372,722,0.515,0.529,576,665,0.866,61,283,344,446,115,29,265,177,1851,James Harden
2014-2015,Houston Rockets,SG,81,81,2981,647,1470,0.44,208,555,0.375,439,915,0.48,0.511,715,824,0.868,75,384,459,565,154,60,321,208,2217,James Harden
2015-2016,Houston Rockets,SG,82,82,3125,710,1617,0.439,236,657,0.359,474,960,0.494,0.512,720,837,0.86,63,438,501,612,139,51,374,229,2376,James Harden
2016-2017,Houston Rockets,PG,81,81,2947,674,1533,0.44,262,756,0.347,412,777,0.53,0.525,746,881,0.847,95,564,659,907,121,38,464,215,2356,James Harden
2017-2018,Houston Rockets,SG,72,72,2551,651,1449,0.449,265,722,0.367,386,727,0.531,0.541,624,727,0.858,41,348,389,630,126,50,315,169,2191,James Harden
2018-2019,Houston Rockets,PG,78,78,2867,843,1909,0.442,378,1028,0.368,465,881,0.528,0.541,754,858,0.879,66,452,518,586,158,58,387,244,2818,James Harden
2019-2020,Houston Rockets,SG,68,68,2483,672,1514,0.444,299,843,0.355,373,671,0.556,0.543,692,800,0.865,70,376,446,512,125,60,308,227,2335,James Harden
2020-2021,Total,PG,44,43,1609,342,734,0.466,121,334,0.362,221,400,0.553,0.548,278,323,0.861,35,313,348,475,53,33,177,99,1083,James Harden
2020-2021,Houston Rockets,PG,8,8,290,60,135,0.444,25,72,0.347,35,63,0.556,0.537,53,60,0.883,5,36,41,83,7,6,34,14,198,James Harden
2020-2021,Brooklyn Nets,PG,36,35,1319,282,599,0.471,96,262,0.366,186,337,0.552,0.551,225,263,0.856,30,277,307,392,46,27,143,85,885,James Harden
2021-2022,Total,PG,65,65,2419,407,992,0.41,148,448,0.33,259,544,0.476,0.485,470,536,0.877,55,445,500,667,82,36,284,153,1432,James Harden
2021-2022,Brooklyn Nets,PG,44,44,1627,292,706,0.414,102,307,0.332,190,399,0.476,0.486,304,350,0.869,42,309,351,447,56,31,212,105,990,James Harden
2021-2022,Philadelphia 76ers,PG,21,21,792,115,286,0.402,46,141,0.326,69,145,0.476,0.483,166,186,0.892,13,136,149,220,26,5,72,48,442,James Harden
2022-2023,Philadelphia 76ers,PG,58,58,2135,371,842,0.441,161,418,0.385,210,424,0.495,0.536,313,361,0.867,40,314,354,618,71,31,195,112,1216,James Harden
2023-2024,Los Angeles Clippers,PG,72,72,2470,352,822,0.428,186,488,0.381,166,334,0.497,0.541,302,344,0.878,34,335,369,614,77,57,185,127,1192,James Harden
2024-2025,Los Angeles Clippers,PG,30,30,1023,189,484,0.39,84,246,0.341,105,238,0.441,0.477,195,218,0.894,18,173,191,243,45,19,141,61,657,James Harden
2022-2023,Dallas Mavericks,SG,48,5,708,146,333,0.438,63,156,0.404,83,177,0.469,0.533,65,79,0.823,11,78,89,65,17,7,46,64,420,Jaden Hardy
2023-2024,Dallas Mavericks,SG,73,7,989,195,479,0.407,81,224,0.362,114,255,0.447,0.492,59,76,0.776,20,111,131,109,22,4,62,80,530,Jaden Hardy
2024-2025,Dallas Mavericks,SG,23,2,321,52,134,0.388,18,60,0.3,34,74,0.459,0.455,22,25,0.88,4,26,30,27,14,1,31,30,144,Jaden Hardy
2012-2013,Orlando Magic,SF,76,59,1974,260,564,0.461,32,117,0.274,228,447,0.51,0.489,73,128,0.57,122,213,335,50,88,62,69,144,625,Maurice Harkless
2013-2014,Orlando Magic,SF,80,41,1950,224,483,0.464,59,154,0.383,165,329,0.502,0.525,85,143,0.594,69,195,264,80,97,50,86,140,592,Maurice Harkless
2014-2015,Orlando Magic,SF,45,4,674,63,158,0.399,10,56,0.179,53,102,0.52,0.43,22,41,0.537,38,68,106,25,32,9,27,66,158,Maurice Harkless
2015-2016,Portland Trail Blazers,SF,78,14,1457,195,411,0.474,39,140,0.279,156,271,0.576,0.522,69,111,0.622,101,179,280,67,49,35,62,124,498,Maurice Harkless
2016-2017,Portland Trail Blazers,SF,77,69,2223,314,624,0.503,68,194,0.351,246,430,0.572,0.558,77,124,0.621,125,216,341,88,85,70,86,214,773,Maurice Harkless
2017-2018,Portland Trail Blazers,SF,59,37,1264,147,297,0.495,49,118,0.415,98,179,0.547,0.577,42,59,0.712,46,116,162,53,48,43,40,103,385,Maurice Harkless
2018-2019,Portland Trail Blazers,SF,60,53,1415,189,388,0.487,33,120,0.275,156,268,0.582,0.53,49,73,0.671,77,192,269,74,67,53,45,163,460,Maurice Harkless
2019-2020,Total,PF,62,48,1427,142,283,0.502,34,98,0.347,108,185,0.584,0.562,39,66,0.591,55,185,240,68,58,33,53,148,357,Maurice Harkless
2019-2020,Los Angeles Clippers,PF,50,38,1141,112,217,0.516,27,73,0.37,85,144,0.59,0.578,24,42,0.571,47,153,200,48,49,30,46,120,275,Maurice Harkless
2019-2020,New York Knicks,SF,12,10,286,30,66,0.455,7,25,0.28,23,41,0.561,0.508,15,24,0.625,8,32,40,20,9,3,7,28,82,Maurice Harkless
2020-2021,Total,SF,37,23,772,69,165,0.418,23,84,0.274,46,81,0.568,0.488,33,43,0.767,13,76,89,44,30,20,22,86,194,Maurice Harkless
2020-2021,Miami Heat,SF,11,3,124,5,13,0.385,5,11,0.455,0,2,0,0.577,0,2,0,2,11,13,7,2,4,3,14,15,Maurice Harkless
2020-2021,Sacramento Kings,PF,26,20,648,64,152,0.421,18,73,0.247,46,79,0.582,0.48,33,41,0.805,11,65,76,37,28,16,19,72,179,Maurice Harkless
2021-2022,Sacramento Kings,SF,47,24,863,83,181,0.459,31,101,0.307,52,80,0.65,0.544,20,28,0.714,12,100,112,23,29,24,31,77,217,Maurice Harkless
2022-2023,Toronto Raptors,PF,9,0,48,8,16,0.5,3,9,0.333,5,7,0.714,0.594,1,1,1,3,4,7,4,0,1,0,3,20,Ron Harper Jr.
2023-2024,Toronto Raptors,PF,1,0,4,0,0,,0,0,,0,0,,,0,0,,0,0,0,1,0,0,0,2,0,Ron Harper Jr.
2015-2016,Houston Rockets,PF,39,1,379,58,90,0.644,0,1,0,58,89,0.652,0.644,24,46,0.522,25,40,65,17,11,11,17,48,140,Montrezl Harrell
2016-2017,Houston Rockets,C,58,14,1064,225,345,0.652,1,7,0.143,224,338,0.663,0.654,76,121,0.628,81,138,219,64,20,42,44,126,527,Montrezl Harrell
2017-2018,Los Angeles Clippers,C,76,3,1293,348,548,0.635,1,7,0.143,347,541,0.641,0.636,139,222,0.626,103,203,306,74,36,52,68,143,836,Montrezl Harrell
2018-2019,Los Angeles Clippers,C,82,5,2158,546,888,0.615,3,17,0.176,543,871,0.623,0.617,266,414,0.643,184,351,535,162,71,110,132,255,1361,Montrezl Harrell
2019-2020,Los Angeles Clippers,C,63,2,1749,471,812,0.58,0,18,0,471,794,0.593,0.58,231,351,0.658,163,282,445,107,39,72,108,146,1173,Montrezl Harrell
2020-2021,Los Angeles Lakers,C,69,1,1580,375,603,0.622,0,10,0,375,593,0.632,0.622,181,256,0.707,158,270,428,73,46,49,74,128,931,Montrezl Harrell
2021-2022,Total,C,71,3,1641,358,555,0.645,4,17,0.235,354,538,0.658,0.649,212,296,0.716,149,282,431,145,29,43,72,137,932,Montrezl Harrell
2021-2022,Washington Wizards,C,46,3,1117,247,383,0.645,4,15,0.267,243,368,0.66,0.65,149,205,0.727,96,213,309,96,18,31,50,88,647,Montrezl Harrell
2021-2022,Charlotte Hornets,C,25,0,524,111,172,0.645,0,2,0,111,170,0.653,0.645,63,91,0.692,53,69,122,49,11,12,22,49,285,Montrezl Harrell
2022-2023,Philadelphia 76ers,C,57,7,681,125,209,0.598,0,6,0,125,203,0.616,0.598,70,101,0.693,67,92,159,33,17,25,35,75,320,Montrezl Harrell
2014-2015,Denver Nuggets,SG,55,6,719,66,217,0.304,21,103,0.204,45,114,0.395,0.353,35,47,0.745,21,43,64,29,39,7,38,71,188,Gary Harris
2015-2016,Denver Nuggets,SG,76,76,2439,359,765,0.469,105,297,0.354,254,468,0.543,0.538,109,133,0.82,54,166,220,147,97,18,98,143,932,Gary Harris
2016-2017,Denver Nuggets,SG,57,56,1782,320,637,0.502,107,255,0.42,213,382,0.558,0.586,104,134,0.776,48,130,178,164,71,8,76,92,851,Gary Harris
2017-2018,Denver Nuggets,SG,67,65,2304,440,908,0.485,156,394,0.396,284,514,0.553,0.57,134,162,0.827,37,139,176,194,122,15,119,119,1170,Gary Harris
2018-2019,Denver Nuggets,SG,57,48,1639,270,637,0.424,82,242,0.339,188,395,0.476,0.488,115,144,0.799,41,119,160,127,55,19,68,113,737,Gary Harris
2019-2020,Denver Nuggets,SG,56,55,1780,218,519,0.42,70,210,0.333,148,309,0.479,0.487,75,92,0.815,26,137,163,118,76,14,60,116,581,Gary Harris
2020-2021,Total,SG,39,38,1080,138,345,0.4,48,141,0.34,90,204,0.441,0.47,64,78,0.821,21,58,79,78,28,11,37,71,388,Gary Harris
2020-2021,Denver Nuggets,SG,19,19,581,69,156,0.442,24,75,0.32,45,81,0.556,0.519,22,30,0.733,13,34,47,32,17,4,14,37,184,Gary Harris
2020-2021,Orlando Magic,SG,20,19,499,69,189,0.365,24,66,0.364,45,123,0.366,0.429,42,48,0.875,8,24,32,46,11,7,23,34,204,Gary Harris
2021-2022,Orlando Magic,SG,61,30,1730,240,553,0.434,116,302,0.384,124,251,0.494,0.539,83,95,0.874,36,86,122,108,59,9,61,112,679,Gary Harris
2022-2023,Orlando Magic,SG,48,42,1184,138,307,0.45,94,218,0.431,44,89,0.494,0.603,27,30,0.9,21,77,98,59,45,12,28,93,397,Gary Harris
2023-2024,Orlando Magic,SG,54,27,1297,131,297,0.441,76,205,0.371,55,92,0.598,0.569,34,45,0.756,24,67,91,87,49,14,31,91,372,Gary Harris
2024-2025,Orlando Magic,SG,18,2,296,25,63,0.397,17,48,0.354,8,15,0.533,0.532,4,6,0.667,9,14,23,8,9,5,7,13,71,Gary Harris
2020-2021,Toronto Raptors,SG,13,2,172,36,72,0.5,17,36,0.472,19,36,0.528,0.618,7,9,0.778,3,15,18,17,8,0,14,15,96,Jalen Harris
2022-2023,Orlando Magic,SG,34,0,457,47,107,0.439,16,43,0.372,31,64,0.484,0.514,31,41,0.756,28,42,70,16,17,5,21,53,141,Kevon Harris
2023-2024,Orlando Magic,SG,2,0,6,2,3,0.667,0,0,,2,3,0.667,0.667,0,0,,0,2,2,1,0,0,1,3,4,Kevon Harris
2011-2012,Milwaukee Bucks,SF,42,9,479,79,169,0.467,6,23,0.261,73,146,0.5,0.485,44,54,0.815,30,71,101,22,13,7,31,45,208,Tobias Harris
2012-2013,Total,SF,55,34,1299,233,512,0.455,34,108,0.315,199,404,0.493,0.488,103,137,0.752,73,214,287,69,32,44,66,120,603,Tobias Harris
2012-2013,Milwaukee Bucks,SF,28,14,325,53,115,0.461,7,21,0.333,46,94,0.489,0.491,23,26,0.885,17,40,57,13,8,7,18,31,136,Tobias Harris
2012-2013,Orlando Magic,PF,27,20,974,180,397,0.453,27,87,0.31,153,310,0.494,0.487,80,111,0.721,56,174,230,56,24,37,48,89,467,Tobias Harris
2013-2014,Orlando Magic,PF,61,36,1850,332,716,0.464,32,126,0.254,300,590,0.508,0.486,197,244,0.807,88,336,424,82,41,24,78,143,893,Tobias Harris
2014-2015,Orlando Magic,SF,68,63,2369,442,949,0.466,87,239,0.364,355,710,0.5,0.512,193,245,0.788,73,357,430,124,69,36,115,134,1164,Tobias Harris
2015-2016,Total,PF,76,74,2513,417,889,0.469,80,239,0.335,337,650,0.518,0.514,202,243,0.831,96,414,510,169,65,40,108,153,1116,Tobias Harris
2015-2016,Orlando Magic,PF,49,49,1610,251,541,0.464,47,151,0.311,204,390,0.523,0.507,120,153,0.784,71,271,342,99,47,28,78,91,669,Tobias Harris
2015-2016,Detroit Pistons,PF,27,25,903,166,348,0.477,33,88,0.375,133,260,0.512,0.524,82,90,0.911,25,143,168,70,18,12,30,62,447,Tobias Harris
2016-2017,Detroit Pistons,PF,82,48,2567,511,1063,0.481,109,314,0.347,402,749,0.537,0.532,190,226,0.841,63,353,416,142,60,39,96,133,1321,Tobias Harris
2017-2018,Total,PF,80,80,2668,562,1221,0.46,183,445,0.411,379,776,0.488,0.535,179,216,0.829,58,379,437,192,71,35,105,164,1486,Tobias Harris
2017-2018,Detroit Pistons,PF,48,48,1563,320,709,0.451,113,276,0.409,207,433,0.478,0.531,115,136,0.846,36,208,244,94,34,15,51,91,868,Tobias Harris
2017-2018,Los Angeles Clippers,PF,32,32,1105,242,512,0.473,70,169,0.414,172,343,0.501,0.541,64,80,0.8,22,171,193,98,37,20,54,73,618,Tobias Harris
2018-2019,Total,PF,82,82,2847,611,1254,0.487,156,393,0.397,455,861,0.528,0.549,266,307,0.866,69,576,645,229,51,37,151,184,1644,Tobias Harris
2018-2019,Los Angeles Clippers,PF,55,55,1903,424,855,0.496,112,258,0.434,312,597,0.523,0.561,192,219,0.877,37,395,432,150,40,24,109,123,1152,Tobias Harris
2018-2019,Philadelphia 76ers,PF,27,27,944,187,399,0.469,44,135,0.326,143,264,0.542,0.524,74,88,0.841,32,181,213,79,11,13,42,61,492,Tobias Harris
2019-2020,Philadelphia 76ers,PF,72,72,2469,553,1173,0.471,131,357,0.367,422,816,0.517,0.527,174,216,0.806,69,426,495,227,53,40,104,165,1411,Tobias Harris
2020-2021,Philadelphia 76ers,PF,62,62,2014,473,924,0.512,82,208,0.394,391,716,0.546,0.556,182,204,0.892,62,357,419,220,55,51,107,119,1210,Tobias Harris
2021-2022,Philadelphia 76ers,PF,73,73,2543,493,1022,0.482,101,275,0.367,392,747,0.525,0.532,170,202,0.842,77,419,496,252,47,43,116,164,1257,Tobias Harris
2022-2023,Philadelphia 76ers,SF,74,74,2436,423,845,0.501,126,324,0.389,297,521,0.57,0.575,113,129,0.876,67,357,424,186,68,40,89,149,1085,Tobias Harris
2023-2024,Philadelphia 76ers,PF,70,70,2368,463,951,0.487,91,258,0.353,372,693,0.537,0.535,187,213,0.878,80,373,453,217,70,46,93,115,1204,Tobias Harris
2024-2025,Detroit Pistons,PF,29,29,922,141,327,0.431,39,121,0.322,102,206,0.495,0.491,54,64,0.844,28,159,187,70,23,26,33,58,375,Tobias Harris
2017-2018,Phoenix Suns,PG,23,2,384,59,124,0.476,6,26,0.231,53,98,0.541,0.5,28,38,0.737,9,52,61,55,26,7,22,42,152,Shaquille Harrison
2018-2019,Chicago Bulls,SG,73,11,1430,184,426,0.432,24,89,0.27,160,337,0.475,0.46,82,123,0.667,33,189,222,139,89,30,60,124,474,Shaquille Harrison
2019-2020,Chicago Bulls,SG,43,10,484,77,165,0.467,16,42,0.381,61,123,0.496,0.515,39,50,0.78,22,64,86,49,34,19,19,55,209,Shaquille Harrison
2020-2021,Total,SG,34,0,333,26,78,0.333,3,16,0.188,23,62,0.371,0.353,18,22,0.818,7,41,48,25,17,5,11,33,73,Shaquille Harrison
2020-2021,Utah Jazz,SG,17,0,56,6,20,0.3,0,2,0,6,18,0.333,0.3,5,6,0.833,3,6,9,9,2,0,5,3,17,Shaquille Harrison
2020-2021,Denver Nuggets,SG,17,0,277,20,58,0.345,3,14,0.214,17,44,0.386,0.371,13,16,0.813,4,35,39,16,15,5,6,30,56,Shaquille Harrison
2021-2022,Brooklyn Nets,SG,2,0,23,2,6,0.333,0,2,0,2,4,0.5,0.333,0,0,,1,3,4,3,1,1,2,3,4,Shaquille Harrison
2022-2023,Portland Trail Blazers,SG,5,0,120,15,36,0.417,3,10,0.3,12,26,0.462,0.458,11,15,0.733,1,21,22,30,11,2,6,12,44,Shaquille Harrison
2023-2024,Memphis Grizzlies,SG,3,0,6,1,2,0.5,0,0,,1,2,0.5,0.5,0,0,,0,2,2,0,0,1,0,0,2,Shaquille Harrison
2017-2018,Los Angeles Lakers,SG,63,23,1461,176,375,0.469,78,197,0.396,98,178,0.551,0.573,66,94,0.702,42,221,263,80,47,16,47,107,496,Josh Hart
2018-2019,Los Angeles Lakers,SG,67,22,1715,189,464,0.407,92,274,0.336,97,190,0.511,0.506,55,80,0.688,35,213,248,93,64,40,58,147,525,Josh Hart
2019-2020,New Orleans Pelicans,SF,65,16,1755,225,532,0.423,121,354,0.342,104,178,0.584,0.537,85,115,0.739,61,364,425,108,63,23,75,160,656,Josh Hart
2020-2021,New Orleans Pelicans,SF,47,4,1349,151,344,0.439,63,193,0.326,88,151,0.583,0.531,69,89,0.775,53,324,377,109,38,12,49,111,434,Josh Hart
2021-2022,Total,SG,54,53,1791,287,569,0.504,73,213,0.343,214,356,0.601,0.569,160,211,0.758,62,326,388,224,61,13,114,150,807,Josh Hart
2021-2022,New Orleans Pelicans,SG,41,40,1374,195,386,0.505,42,130,0.323,153,256,0.598,0.56,116,154,0.753,53,265,318,168,45,11,81,118,548,Josh Hart
2021-2022,Portland Trail Blazers,SG,13,13,417,92,183,0.503,31,83,0.373,61,100,0.61,0.587,44,57,0.772,9,61,70,56,16,2,33,32,259,Josh Hart
2022-2023,Total,SF,76,52,2454,275,520,0.529,61,164,0.372,214,356,0.601,0.588,132,176,0.75,142,451,593,290,88,21,117,195,743,Josh Hart
2022-2023,Portland Trail Blazers,SF,51,51,1704,183,363,0.504,34,112,0.304,149,251,0.594,0.551,87,119,0.731,95,322,417,200,54,9,79,133,487,Josh Hart
2022-2023,New York Knicks,SF,25,1,750,92,157,0.586,27,52,0.519,65,105,0.619,0.672,45,57,0.789,47,129,176,90,34,12,38,62,256,Josh Hart
2023-2024,New York Knicks,SF,81,42,2707,295,679,0.434,80,258,0.31,215,421,0.511,0.493,91,115,0.791,128,547,675,331,75,23,118,171,761,Josh Hart
2024-2025,New York Knicks,SG,30,30,1106,162,277,0.585,40,101,0.396,122,176,0.693,0.657,62,76,0.816,49,200,249,159,44,12,55,73,426,Josh Hart
2018-2019,Houston Rockets,PF,28,0,221,20,41,0.488,2,6,0.333,18,35,0.514,0.512,11,14,0.786,21,26,47,15,7,12,13,56,53,Isaiah Hartenstein
2019-2020,Houston Rockets,C,23,2,266,44,67,0.657,0,5,0,44,62,0.71,0.657,19,28,0.679,29,61,90,18,9,12,16,41,107,Isaiah Hartenstein
2020-2021,Total,C,46,2,559,94,171,0.55,2,6,0.333,92,165,0.558,0.556,46,71,0.648,65,116,181,55,19,39,44,104,236,Isaiah Hartenstein
2020-2021,Denver Nuggets,C,30,0,272,41,80,0.513,0,0,,41,80,0.513,0.513,22,36,0.611,40,45,85,15,11,20,21,59,104,Isaiah Hartenstein
2020-2021,Cleveland Cavaliers,C,16,2,287,53,91,0.582,2,6,0.333,51,85,0.6,0.593,24,35,0.686,25,71,96,40,8,19,23,45,132,Isaiah Hartenstein
2021-2022,Los Angeles Clippers,C,68,0,1216,229,366,0.626,14,30,0.467,215,336,0.64,0.645,91,132,0.689,117,215,332,160,50,77,84,167,563,Isaiah Hartenstein
2022-2023,New York Knicks,C,82,8,1626,175,327,0.535,8,37,0.216,167,290,0.576,0.547,48,71,0.676,209,327,536,102,53,64,66,213,406,Isaiah Hartenstein
2023-2024,New York Knicks,C,75,49,1896,235,365,0.644,1,3,0.333,234,362,0.646,0.645,111,157,0.707,244,382,626,188,87,85,93,210,582,Isaiah Hartenstein
2024-2025,Oklahoma City Thunder,C,14,13,429,74,128,0.578,0,4,0,74,124,0.597,0.578,29,45,0.644,43,134,177,51,12,16,25,43,177,Isaiah Hartenstein
2021-2022,Boston Celtics,SF,26,0,158,23,50,0.46,19,44,0.432,4,6,0.667,0.65,0,0,,5,24,29,10,1,2,2,7,65,Sam Hauser
2022-2023,Boston Celtics,SF,80,8,1290,180,396,0.455,140,335,0.418,40,61,0.656,0.631,12,17,0.706,35,169,204,71,29,21,30,99,512,Sam Hauser
2023-2024,Boston Celtics,SF,79,13,1741,249,558,0.446,197,465,0.424,52,93,0.559,0.623,17,19,0.895,45,231,276,82,40,25,32,99,712,Sam Hauser
2024-2025,Boston Celtics,PF,24,3,520,68,160,0.425,47,132,0.356,21,28,0.75,0.572,2,2,1,20,60,80,26,20,5,8,30,185,Sam Hauser
2023-2024,New Orleans Pelicans,SG,67,10,1160,174,456,0.382,109,298,0.366,65,158,0.411,0.501,67,80,0.838,29,119,148,70,19,7,40,72,524,Jordan Hawkins
2024-2025,New Orleans Pelicans,SG,16,3,406,64,176,0.364,32,98,0.327,32,78,0.41,0.455,37,42,0.881,6,42,48,17,7,9,16,13,197,Jordan Hawkins
2019-2020,New Orleans Pelicans,C,64,14,1080,174,259,0.672,1,4,0.25,173,255,0.678,0.674,123,190,0.647,97,162,259,56,26,55,53,161,472,Jaxson Hayes
2020-2021,New Orleans Pelicans,C,60,3,964,175,280,0.625,6,14,0.429,169,266,0.635,0.636,93,120,0.775,92,165,257,35,25,38,39,101,449,Jaxson Hayes
2021-2022,New Orleans Pelicans,C,70,28,1398,245,398,0.616,20,57,0.351,225,341,0.66,0.641,144,188,0.766,115,200,315,43,33,55,54,155,654,Jaxson Hayes
2022-2023,New Orleans Pelicans,C,47,2,610,86,156,0.551,3,29,0.103,83,127,0.654,0.561,58,83,0.699,39,93,132,34,20,19,31,67,233,Jaxson Hayes
2023-2024,Los Angeles Lakers,C,70,5,877,126,175,0.72,0,8,0,126,167,0.754,0.72,51,82,0.622,69,142,211,33,34,29,43,123,303,Jaxson Hayes
2024-2025,Los Angeles Lakers,C,11,1,192,26,36,0.722,0,0,,26,36,0.722,0.722,18,23,0.783,21,29,50,9,4,9,8,28,70,Jaxson Hayes
2020-2021,Detroit Pistons,PG,26,18,670,71,201,0.353,20,72,0.278,51,129,0.395,0.403,14,17,0.824,6,63,69,138,27,10,83,57,176,Killian Hayes
2021-2022,Detroit Pistons,PG,66,40,1647,176,459,0.383,44,167,0.263,132,292,0.452,0.431,57,74,0.77,36,174,210,277,78,35,111,183,453,Killian Hayes
2022-2023,Detroit Pistons,PG,76,56,2154,307,815,0.377,80,286,0.28,227,529,0.429,0.426,92,112,0.821,28,193,221,470,104,28,173,219,786,Killian Hayes
2023-2024,Detroit Pistons,PG,42,31,1008,117,283,0.413,22,74,0.297,95,209,0.455,0.452,33,50,0.66,11,108,119,205,36,20,51,75,289,Killian Hayes
2023-2024,Portland Trail Blazers,PG,62,32,1765,307,797,0.385,87,268,0.325,220,529,0.416,0.44,167,204,0.819,53,141,194,336,48,13,212,195,868,Scoot Henderson
2024-2025,Portland Trail Blazers,PG,23,3,593,90,229,0.393,25,79,0.316,65,150,0.433,0.448,52,67,0.776,16,49,65,115,21,5,62,63,257,Scoot Henderson
2023-2024,Utah Jazz,PF,40,23,856,108,240,0.45,53,140,0.379,55,100,0.55,0.56,23,29,0.793,46,139,185,32,28,30,27,77,292,Taylor Hendricks
2024-2025,Utah Jazz,PF,3,3,75,4,18,0.222,3,12,0.25,1,6,0.167,0.306,3,4,0.75,5,10,15,2,5,4,2,8,14,Taylor Hendricks
2019-2020,Toronto Raptors,C,6,0,28,5,14,0.357,1,2,0.5,4,12,0.333,0.393,3,5,0.6,5,9,14,3,1,0,3,6,14,Dewan Hernandez
2016-2017,Denver Nuggets,PF,62,9,842,101,224,0.451,46,113,0.407,55,111,0.495,0.554,57,76,0.75,43,144,187,29,30,12,31,62,305,Juancho Hernangómez
2017-2018,Denver Nuggets,PF,25,3,277,29,75,0.387,14,50,0.28,15,25,0.6,0.48,10,12,0.833,18,36,54,12,6,3,9,25,82,Juancho Hernangómez
2018-2019,Denver Nuggets,PF,70,25,1358,138,314,0.439,66,181,0.365,72,133,0.541,0.545,66,86,0.767,64,201,265,55,27,24,37,94,408,Juancho Hernangómez
2019-2020,Total,PF,48,14,833,100,247,0.405,44,129,0.341,56,118,0.475,0.494,44,71,0.62,43,154,197,40,19,9,32,64,288,Juancho Hernangómez
2019-2020,Denver Nuggets,PF,34,0,422,38,110,0.345,15,60,0.25,23,50,0.46,0.414,16,25,0.64,24,71,95,22,5,5,18,29,107,Juancho Hernangómez
2019-2020,Minnesota Timberwolves,PF,14,14,411,62,137,0.453,29,69,0.42,33,68,0.485,0.558,28,46,0.609,19,83,102,18,14,4,14,35,181,Juancho Hernangómez
2020-2021,Minnesota Timberwolves,PF,52,6,900,130,299,0.435,55,168,0.327,75,131,0.573,0.527,60,97,0.619,45,160,205,35,19,7,27,52,375,Juancho Hernangómez
2021-2022,Total,PF,40,9,445,44,106,0.415,24,69,0.348,20,37,0.541,0.528,19,34,0.559,28,72,100,20,14,10,16,25,131,Juancho Hernangómez
2021-2022,Boston Celtics,PF,18,0,96,5,27,0.185,3,18,0.167,2,9,0.222,0.241,6,9,0.667,9,16,25,3,4,2,6,7,19,Juancho Hernangómez
2021-2022,San Antonio Spurs,PF,5,0,51,2,6,0.333,0,3,0,2,3,0.667,0.333,3,4,0.75,4,11,15,3,1,1,2,0,7,Juancho Hernangómez
2021-2022,Utah Jazz,PF,17,9,298,37,73,0.507,21,48,0.438,16,25,0.64,0.651,10,21,0.476,15,45,60,14,9,7,8,18,105,Juancho Hernangómez
2022-2023,Toronto Raptors,PF,42,10,614,48,114,0.421,17,67,0.254,31,47,0.66,0.496,9,16,0.563,27,96,123,25,16,6,15,43,122,Juancho Hernangómez
2016-2017,New York Knicks,C,72,22,1324,246,465,0.529,4,15,0.267,242,450,0.538,0.533,91,125,0.728,170,332,502,96,41,36,100,150,587,Willy Hernangómez
2017-2018,Total,C,48,1,495,91,164,0.555,5,12,0.417,86,152,0.566,0.57,59,90,0.656,61,122,183,33,18,16,35,64,246,Willy Hernangómez
2017-2018,New York Knicks,C,26,0,233,49,81,0.605,1,5,0.2,48,76,0.632,0.611,12,28,0.429,22,45,67,21,8,7,26,32,111,Willy Hernangómez
2017-2018,Charlotte Hornets,C,22,1,262,42,83,0.506,4,7,0.571,38,76,0.5,0.53,47,62,0.758,39,77,116,12,10,9,9,32,135,Willy Hernangómez
2018-2019,Charlotte Hornets,C,58,3,812,153,295,0.519,15,39,0.385,138,256,0.539,0.544,100,144,0.694,117,194,311,60,16,20,58,98,421,Willy Hernangómez
2019-2020,Charlotte Hornets,C,31,0,375,74,139,0.532,5,22,0.227,69,117,0.59,0.55,37,59,0.627,43,91,134,29,10,7,30,32,190,Willy Hernangómez
2020-2021,New Orleans Pelicans,C,47,12,846,151,268,0.563,1,10,0.1,150,258,0.581,0.565,62,93,0.667,117,217,334,50,22,23,34,68,365,Willy Hernangómez
2021-2022,New Orleans Pelicans,C,50,8,839,170,327,0.52,4,12,0.333,166,315,0.527,0.526,109,141,0.773,143,195,338,63,21,19,51,97,453,Willy Hernangómez
2022-2023,New Orleans Pelicans,C,38,2,458,89,169,0.527,3,11,0.273,86,158,0.544,0.536,81,104,0.779,58,122,180,33,17,13,39,64,262,Willy Hernangómez
2019-2020,Miami Heat,SG,55,8,1508,270,631,0.428,116,298,0.389,154,333,0.462,0.52,87,100,0.87,16,208,224,121,34,9,87,76,743,Tyler Herro
2020-2021,Miami Heat,SG,54,15,1635,307,699,0.439,107,297,0.36,200,402,0.498,0.516,94,117,0.803,25,243,268,184,35,17,101,71,815,Tyler Herro
2021-2022,Miami Heat,SG,66,10,2151,501,1122,0.447,175,439,0.399,326,683,0.477,0.525,190,219,0.868,32,297,329,263,44,8,174,95,1367,Tyler Herro
2022-2023,Miami Heat,SG,67,67,2337,487,1109,0.439,203,537,0.378,284,572,0.497,0.531,170,182,0.934,27,333,360,280,51,16,158,101,1347,Tyler Herro
2023-2024,Miami Heat,SG,42,40,1407,324,735,0.441,132,333,0.396,192,402,0.478,0.531,95,111,0.856,19,203,222,188,30,3,93,63,875,Tyler Herro
2024-2025,Miami Heat,SG,28,28,982,232,493,0.471,111,274,0.405,121,219,0.553,0.583,91,107,0.85,10,149,159,137,22,3,71,42,666,Tyler Herro
2019-2020,Oklahoma City Thunder,PF,10,0,52,7,27,0.259,3,20,0.15,4,7,0.571,0.315,0,0,1,11,12,5,1,1,0,4,17,0,Kevin Hervey
2016-2017,Total,SG,82,55,1888,327,767,0.426,148,379,0.391,179,388,0.461,0.523,64,76,0.842,35,234,269,121,38,9,101,115,866,Buddy Hield
2016-2017,New Orleans Pelicans,SG,57,37,1161,185,471,0.393,89,241,0.369,96,230,0.417,0.487,29,33,0.879,19,147,166,77,18,7,48,81,488,Buddy Hield
2016-2017,Sacramento Kings,SG,25,18,727,142,296,0.48,59,138,0.428,83,158,0.525,0.579,35,43,0.814,16,87,103,44,20,2,53,34,378,Buddy Hield
2017-2018,Sacramento Kings,SG,80,13,2024,416,933,0.446,176,408,0.431,240,525,0.457,0.54,71,81,0.877,55,252,307,155,85,22,124,148,1079,Buddy Hield
2018-2019,Sacramento Kings,SG,82,82,2615,623,1360,0.458,278,651,0.427,345,709,0.487,0.56,171,193,0.886,106,306,412,205,58,33,146,202,1695,Buddy Hield
2019-2020,Sacramento Kings,SG,72,44,2216,498,1162,0.429,271,688,0.394,227,474,0.479,0.545,115,136,0.846,57,271,328,213,66,17,168,165,1382,Buddy Hield
2020-2021,Sacramento Kings,SG,71,71,2433,403,992,0.406,282,721,0.391,121,271,0.446,0.548,88,104,0.846,29,305,334,257,63,30,130,175,1176,Buddy Hield
2021-2022,Total,SG,81,32,2499,446,1098,0.406,262,716,0.366,184,382,0.482,0.526,111,127,0.874,66,287,353,229,73,25,153,184,1265,Buddy Hield
2021-2022,Sacramento Kings,SG,55,6,1574,265,693,0.382,182,495,0.368,83,198,0.419,0.514,80,92,0.87,43,178,221,105,48,15,90,113,792,Buddy Hield
2021-2022,Indiana Pacers,SG,26,26,925,181,405,0.447,80,221,0.362,101,184,0.549,0.546,31,35,0.886,23,109,132,124,25,10,63,71,473,Buddy Hield
2022-2023,Indiana Pacers,SF,80,73,2482,475,1038,0.458,288,677,0.425,187,361,0.518,0.596,106,129,0.822,67,333,400,225,92,26,139,156,1344,Buddy Hield
2023-2024,Total,SF,84,42,2160,371,850,0.436,219,568,0.386,152,282,0.539,0.565,52,59,0.881,61,208,269,236,70,42,103,169,1013,Buddy Hield
2023-2024,Indiana Pacers,SF,52,28,1336,229,517,0.443,137,357,0.384,92,160,0.575,0.575,28,33,0.848,34,133,167,139,43,31,62,103,623,Buddy Hield
2023-2024,Philadelphia 76ers,SG,32,14,824,142,333,0.426,82,211,0.389,60,122,0.492,0.55,24,26,0.923,27,75,102,97,27,11,41,66,390,Buddy Hield
2024-2025,Golden State Warriors,SG,30,6,696,143,321,0.445,90,219,0.411,53,102,0.52,0.586,24,26,0.923,19,86,105,38,25,9,39,58,400,Buddy Hield
2018-2019,Philadelphia 76ers,SF,5,0,40,4,10,0.4,1,5,0.2,3,5,0.6,0.45,0,2,0,0,5,5,2,1,0,1,1,9,Haywood Highsmith
2021-2022,Miami Heat,SF,19,1,163,16,46,0.348,9,28,0.321,7,18,0.389,0.446,2,5,0.4,10,16,26,6,2,3,3,13,43,Haywood Highsmith
2022-2023,Miami Heat,PF,54,11,969,93,216,0.431,37,109,0.339,56,107,0.523,0.516,13,28,0.464,57,131,188,43,36,17,45,82,236,Haywood Highsmith
2023-2024,Miami Heat,PF,66,26,1366,153,329,0.465,76,192,0.396,77,137,0.562,0.581,23,36,0.639,65,145,210,70,53,30,34,117,405,Haywood Highsmith
2024-2025,Miami Heat,SF,26,19,624,62,133,0.466,34,79,0.43,28,54,0.519,0.594,13,19,0.684,17,60,77,25,27,17,21,55,171,Haywood Highsmith
2008-2009,San Antonio Spurs,PG,77,7,1270,150,372,0.403,24,73,0.329,126,299,0.421,0.435,114,146,0.781,30,128,158,136,45,21,74,150,438,George Hill
2009-2010,San Antonio Spurs,PG,78,43,2276,353,738,0.478,75,188,0.399,278,550,0.505,0.529,183,237,0.772,42,163,205,226,69,26,101,222,964,George Hill
2010-2011,San Antonio Spurs,PG,76,5,2148,287,633,0.453,77,204,0.377,210,429,0.49,0.514,233,270,0.863,24,175,199,193,66,21,99,153,884,George Hill
2011-2012,Indiana Pacers,PG,50,9,1274,168,380,0.442,54,147,0.367,114,233,0.489,0.513,91,117,0.778,31,120,151,145,42,17,52,98,481,George Hill
2012-2013,Indiana Pacers,PG,76,76,2620,386,871,0.443,130,353,0.368,256,518,0.494,0.518,174,213,0.817,47,237,284,355,81,26,116,134,1076,George Hill
2013-2014,Indiana Pacers,PG,76,76,2434,272,616,0.442,95,260,0.365,177,356,0.497,0.519,142,176,0.807,53,230,283,265,75,23,92,158,781,George Hill
2014-2015,Indiana Pacers,PG,43,36,1267,255,535,0.477,69,193,0.358,186,342,0.544,0.541,113,143,0.79,25,154,179,220,44,14,69,111,692,George Hill
2015-2016,Indiana Pacers,PG,74,73,2524,326,739,0.441,128,314,0.408,198,425,0.466,0.528,114,150,0.76,58,240,298,259,83,17,101,149,894,George Hill
2016-2017,Utah Jazz,PG,49,49,1544,289,606,0.477,94,233,0.403,195,373,0.523,0.554,157,196,0.801,23,144,167,204,50,11,85,114,829,George Hill
2017-2018,Total,PG,67,60,1812,236,513,0.46,85,205,0.415,151,308,0.49,0.543,110,140,0.786,42,139,181,186,61,27,88,128,667,George Hill
2017-2018,Sacramento Kings,PG,43,36,1143,153,326,0.469,58,128,0.453,95,198,0.48,0.558,77,99,0.778,22,95,117,119,39,12,60,75,441,George Hill
2017-2018,Cleveland Cavaliers,PG,24,24,669,83,187,0.444,27,77,0.351,56,110,0.509,0.516,33,41,0.805,20,44,64,67,22,15,28,53,226,George Hill
2018-2019,Total,PG,60,13,1302,170,376,0.452,48,153,0.314,122,223,0.547,0.516,70,85,0.824,39,109,148,135,52,8,51,102,458,George Hill
2018-2019,Cleveland Cavaliers,PG,13,13,344,55,107,0.514,13,28,0.464,42,79,0.532,0.575,17,20,0.85,12,15,27,36,12,1,20,35,140,George Hill
2018-2019,Milwaukee Bucks,PG,47,0,958,115,269,0.428,35,125,0.28,80,144,0.556,0.493,53,65,0.815,27,94,121,99,40,7,31,67,318,George Hill
2019-2020,Milwaukee Bucks,PG,59,2,1271,194,376,0.516,81,176,0.46,113,200,0.565,0.624,85,101,0.842,50,127,177,180,47,5,57,84,554,George Hill
2020-2021,Total,PG,30,17,672,95,197,0.482,31,80,0.388,64,117,0.547,0.561,40,50,0.8,16,45,61,73,23,5,31,31,261,George Hill
2020-2021,Oklahoma City Thunder,PG,14,14,369,61,120,0.508,22,57,0.386,39,63,0.619,0.6,21,25,0.84,8,21,29,43,12,2,12,12,165,George Hill
2020-2021,Philadelphia 76ers,PG,16,3,303,34,77,0.442,9,23,0.391,25,54,0.463,0.5,19,25,0.76,8,24,32,30,11,3,19,19,96,George Hill
2021-2022,Milwaukee Bucks,PG,54,17,1253,118,275,0.429,41,134,0.306,77,141,0.546,0.504,57,62,0.919,38,117,155,120,42,6,41,70,334,George Hill
2022-2023,Total,SG,46,1,834,78,166,0.47,34,95,0.358,44,71,0.62,0.572,42,55,0.764,15,70,85,110,26,6,34,55,232,George Hill
2022-2023,Milwaukee Bucks,PG,35,0,668,59,132,0.447,23,74,0.311,36,58,0.621,0.534,34,46,0.739,13,54,67,89,19,3,27,41,175,George Hill
2022-2023,Indiana Pacers,SG,11,1,166,19,34,0.559,11,21,0.524,8,13,0.615,0.721,8,9,0.889,2,16,18,21,7,3,7,14,57,George Hill
2021-2022,Total,SG,19,0,212,24,52,0.462,13,36,0.361,11,16,0.688,0.587,11,14,0.786,11,24,35,8,7,3,3,24,72,Malcolm Hill
2021-2022,Atlanta Hawks,SG,3,0,46,5,8,0.625,3,5,0.6,2,3,0.667,0.813,4,4,1,2,4,6,1,4,1,0,7,17,Malcolm Hill
2021-2022,Chicago Bulls,SF,16,0,166,19,44,0.432,10,31,0.323,9,13,0.692,0.545,7,10,0.7,9,20,29,7,3,2,3,17,55,Malcolm Hill
2022-2023,Chicago Bulls,SF,5,0,9,2,4,0.5,1,3,0.333,1,1,1,0.625,0,0,,0,3,3,0,0,0,0,1,5,Malcolm Hill
2020-2021,Dallas Mavericks,SG,21,0,93,15,42,0.357,4,19,0.211,11,23,0.478,0.405,7,10,0.7,1,8,9,8,7,2,5,8,41,Nate Hinton
2021-2022,Indiana Pacers,SG,2,0,2,0,1,0,0,0,,0,1,0,0,0,0,,0,0,0,0,0,0,1,0,0,Nate Hinton
2023-2024,Houston Rockets,SG,15,0,75,11,26,0.423,7,14,0.5,4,12,0.333,0.558,4,5,0.8,7,15,22,10,3,2,3,11,33,Nate Hinton
2023-2024,Los Angeles Lakers,SG,7,0,41,5,15,0.333,3,12,0.25,2,3,0.667,0.433,1,2,0.5,0,0,0,5,1,1,1,4,14,D'Moi Hodge
2018-2019,Indiana Pacers,PG,50,0,646,105,262,0.401,43,127,0.339,62,135,0.459,0.483,41,50,0.82,5,62,67,87,21,13,40,71,294,Aaron Holiday
2019-2020,Indiana Pacers,PG,66,33,1617,233,563,0.414,87,221,0.394,146,342,0.427,0.491,74,87,0.851,22,134,156,225,55,16,88,120,627,Aaron Holiday
2020-2021,Indiana Pacers,PG,66,8,1176,170,436,0.39,67,182,0.368,103,254,0.406,0.467,68,83,0.819,15,74,89,123,46,13,66,94,475,Aaron Holiday
2021-2022,Total,PG,63,15,1021,151,338,0.447,39,103,0.379,112,235,0.477,0.504,59,68,0.868,24,98,122,153,42,9,67,92,400,Aaron Holiday
2021-2022,Washington Wizards,PG,41,14,663,100,214,0.467,23,67,0.343,77,147,0.524,0.521,28,35,0.8,9,58,67,78,24,9,39,60,251,Aaron Holiday
2021-2022,Phoenix Suns,PG,22,1,358,51,124,0.411,16,36,0.444,35,88,0.398,0.476,31,33,0.939,15,40,55,75,18,0,28,32,149,Aaron Holiday
2022-2023,Atlanta Hawks,PG,63,6,845,92,220,0.418,36,88,0.409,56,132,0.424,0.5,27,32,0.844,25,49,74,89,37,12,36,79,247,Aaron Holiday
2023-2024,Houston Rockets,PG,78,1,1269,186,417,0.446,84,217,0.387,102,200,0.51,0.547,58,63,0.921,23,100,123,140,42,6,53,125,514,Aaron Holiday
2024-2025,Houston Rockets,PG,20,0,184,26,55,0.473,17,39,0.436,9,16,0.563,0.627,11,13,0.846,0,18,18,23,5,2,6,12,80,Aaron Holiday
2009-2010,Philadelphia 76ers,PG,73,51,1767,230,520,0.442,62,159,0.39,168,361,0.465,0.502,65,86,0.756,56,135,191,280,79,18,156,153,587,Jrue Holiday
2010-2011,Philadelphia 76ers,PG,82,82,2901,446,999,0.446,81,222,0.365,365,777,0.47,0.487,172,209,0.823,68,264,332,531,120,29,218,203,1145,Jrue Holiday
2011-2012,Philadelphia 76ers,PG,65,65,2196,360,834,0.432,65,171,0.38,295,663,0.445,0.471,94,120,0.783,57,155,212,290,103,18,135,137,879,Jrue Holiday
2012-2013,Philadelphia 76ers,PG,78,78,2926,555,1288,0.431,91,247,0.368,464,1041,0.446,0.466,182,242,0.752,89,240,329,625,123,32,292,170,1383,Jrue Holiday
2013-2014,New Orleans Pelicans,PG,34,34,1143,203,454,0.447,30,77,0.39,173,377,0.459,0.48,51,63,0.81,28,114,142,268,56,12,105,92,487,Jrue Holiday
2014-2015,New Orleans Pelicans,PG,40,37,1303,238,534,0.446,51,135,0.378,187,399,0.469,0.493,65,76,0.855,32,103,135,274,63,23,91,110,592,Jrue Holiday
2015-2016,New Orleans Pelicans,PG,65,23,1831,410,935,0.439,87,259,0.336,323,676,0.478,0.485,182,216,0.843,27,168,195,391,88,22,167,148,1089,Jrue Holiday
2016-2017,New Orleans Pelicans,PG,67,61,2190,405,893,0.454,100,281,0.356,305,612,0.498,0.51,119,168,0.708,46,218,264,488,100,44,194,133,1029,Jrue Holiday
2017-2018,New Orleans Pelicans,SG,81,81,2927,615,1244,0.494,120,356,0.337,495,888,0.557,0.543,187,238,0.786,62,303,365,486,123,64,213,201,1537,Jrue Holiday
2018-2019,New Orleans Pelicans,SG,67,67,2402,547,1159,0.472,118,363,0.325,429,796,0.539,0.523,208,271,0.768,75,259,334,518,109,54,210,148,1420,Jrue Holiday
2019-2020,New Orleans Pelicans,SG,61,61,2117,458,1006,0.455,122,346,0.353,336,660,0.509,0.516,129,182,0.709,77,216,293,408,99,48,184,145,1167,Jrue Holiday
2020-2021,Milwaukee Bucks,PG,59,56,1907,414,823,0.503,111,283,0.392,303,540,0.561,0.57,107,136,0.787,73,195,268,357,96,37,127,98,1046,Jrue Holiday
2021-2022,Milwaukee Bucks,PG,67,64,2208,478,954,0.501,132,321,0.411,346,633,0.547,0.57,137,180,0.761,69,232,301,457,108,29,183,133,1225,Jrue Holiday
2022-2023,Milwaukee Bucks,PG,67,65,2183,490,1023,0.479,158,411,0.384,332,612,0.542,0.556,152,177,0.859,79,262,341,495,79,25,197,116,1290,Jrue Holiday
2023-2024,Boston Celtics,PG,69,69,2263,331,689,0.48,138,322,0.429,193,367,0.526,0.581,60,72,0.833,84,289,373,333,61,53,124,108,860,Jrue Holiday
2024-2025,Boston Celtics,PG,26,26,796,116,259,0.448,46,141,0.326,70,118,0.593,0.537,40,45,0.889,29,83,112,96,23,11,39,38,318,Jrue Holiday
2012-2013,Philadelphia 76ers,SG,9,0,142,16,48,0.333,4,16,0.25,12,32,0.375,0.375,6,8,0.75,0,14,14,15,3,6,9,7,42,Justin Holiday
2014-2015,Golden State Warriors,SG,59,4,657,91,235,0.387,35,109,0.321,56,126,0.444,0.462,37,45,0.822,12,61,73,48,40,12,29,54,254,Justin Holiday
2015-2016,Total,SG,53,5,773,88,228,0.386,36,105,0.343,52,123,0.423,0.465,27,37,0.73,12,78,90,56,32,19,39,61,239,Justin Holiday
2015-2016,Atlanta Hawks,SG,26,1,263,24,73,0.329,10,45,0.222,14,28,0.5,0.397,5,10,0.5,4,23,27,11,13,4,13,21,63,Justin Holiday
2015-2016,Chicago Bulls,SG,27,4,510,64,155,0.413,26,60,0.433,38,95,0.4,0.497,22,27,0.815,8,55,63,45,19,15,26,40,176,Justin Holiday
2016-2017,New York Knicks,SG,82,4,1639,233,538,0.433,97,273,0.355,136,265,0.513,0.523,66,80,0.825,27,198,225,102,65,31,66,109,629,Justin Holiday
2017-2018,Chicago Bulls,SG,72,72,2265,290,782,0.371,161,449,0.359,129,333,0.387,0.474,135,164,0.823,31,260,291,153,80,31,93,134,876,Justin Holiday
2018-2019,Total,SG,82,77,2607,300,777,0.386,162,465,0.348,138,312,0.442,0.49,95,106,0.896,46,277,323,146,121,36,104,164,857,Justin Holiday
2018-2019,Chicago Bulls,SG,38,38,1325,151,394,0.383,97,270,0.359,54,124,0.435,0.506,41,46,0.891,19,150,169,85,67,21,47,79,440,Justin Holiday
2018-2019,Memphis Grizzlies,SG,44,39,1282,149,383,0.389,65,195,0.333,84,188,0.447,0.474,54,60,0.9,27,127,154,61,54,15,57,85,417,Justin Holiday
2019-2020,Indiana Pacers,SF,73,6,1826,208,486,0.428,134,331,0.405,74,155,0.477,0.566,53,67,0.791,32,206,238,93,87,46,44,137,603,Justin Holiday
2020-2021,Indiana Pacers,SG,72,52,2183,258,625,0.413,173,453,0.382,85,172,0.494,0.551,67,85,0.788,32,224,256,119,74,41,54,135,756,Justin Holiday
2021-2022,Total,SF,74,65,2057,261,662,0.394,177,482,0.367,84,180,0.467,0.528,50,62,0.806,29,161,190,128,57,33,70,154,749,Justin Holiday
2021-2022,Indiana Pacers,SF,49,40,1416,190,458,0.415,127,336,0.378,63,122,0.516,0.553,34,41,0.829,18,117,135,90,36,18,49,105,541,Justin Holiday
2021-2022,Sacramento Kings,SG,25,25,641,71,204,0.348,50,146,0.342,21,58,0.362,0.471,16,21,0.762,11,44,55,38,21,15,21,49,208,Justin Holiday
2022-2023,Total,SF,46,2,706,77,204,0.377,46,143,0.322,31,61,0.508,0.49,5,8,0.625,5,50,55,41,19,19,22,68,205,Justin Holiday
2022-2023,Atlanta Hawks,SF,28,0,411,48,125,0.384,30,87,0.345,18,38,0.474,0.504,0,0,,2,21,23,25,5,10,12,37,126,Justin Holiday
2022-2023,Dallas Mavericks,SF,18,2,295,29,79,0.367,16,56,0.286,13,23,0.565,0.468,5,8,0.625,3,29,32,16,14,9,10,31,79,Justin Holiday
2023-2024,Denver Nuggets,SG,58,9,862,88,194,0.454,55,136,0.404,33,58,0.569,0.595,3,4,0.75,9,62,71,67,36,9,14,69,234,Justin Holiday
2024-2025,Detroit Pistons,SF,31,1,486,76,161,0.472,12,59,0.203,64,102,0.627,0.509,27,34,0.794,17,77,94,21,15,5,28,48,191,Ron Holland
2015-2016,Philadelphia 76ers,PF,51,1,702,114,222,0.514,8,44,0.182,106,178,0.596,0.532,51,74,0.689,62,73,135,33,19,40,32,92,287,Richaun Holmes
2016-2017,Philadelphia 76ers,C,57,17,1193,230,412,0.558,27,77,0.351,203,335,0.606,0.591,72,103,0.699,94,217,311,58,42,55,55,136,559,Richaun Holmes
2017-2018,Philadelphia 76ers,C,48,2,746,135,241,0.56,4,31,0.129,131,210,0.624,0.568,37,56,0.661,57,154,211,61,20,29,25,97,311,Richaun Holmes
2018-2019,Phoenix Suns,C,70,4,1184,222,365,0.608,0,0,,222,365,0.608,0.608,128,175,0.731,115,216,331,60,42,79,52,194,572,Richaun Holmes
2019-2020,Sacramento Kings,C,44,38,1242,223,344,0.648,0,0,,223,344,0.648,0.648,93,118,0.788,127,231,358,42,41,56,52,169,539,Richaun Holmes
2020-2021,Sacramento Kings,C,61,61,1782,366,575,0.637,2,11,0.182,364,564,0.645,0.638,135,170,0.794,144,360,504,101,39,96,75,213,869,Richaun Holmes
2021-2022,Sacramento Kings,C,45,37,1074,198,300,0.66,2,5,0.4,196,295,0.664,0.663,70,90,0.778,93,224,317,48,17,41,56,128,468,Richaun Holmes
2022-2023,Sacramento Kings,C,42,1,348,55,89,0.618,5,8,0.625,50,81,0.617,0.646,15,19,0.789,29,51,80,9,3,11,14,50,130,Richaun Holmes
2023-2024,Total,C,40,10,555,82,147,0.558,1,3,0.333,81,144,0.563,0.561,34,47,0.723,71,111,182,25,11,19,24,74,199,Richaun Holmes
2023-2024,Dallas Mavericks,C,23,2,237,33,59,0.559,0,0,,33,59,0.559,0.559,12,21,0.571,33,45,78,15,3,9,12,33,78,Richaun Holmes
2023-2024,Washington Wizards,PF,17,8,318,49,88,0.557,1,3,0.333,48,85,0.565,0.563,22,26,0.846,38,66,104,10,8,10,12,41,121,Richaun Holmes
2024-2025,Washington Wizards,PF,4,0,24,5,11,0.455,0,1,0,5,10,0.5,0.455,2,2,1,3,4,7,0,0,2,2,1,12,Richaun Holmes
2023-2024,Oklahoma City Thunder,C,82,82,2413,505,953,0.53,129,349,0.37,376,604,0.623,0.598,218,275,0.793,129,519,648,200,53,190,131,197,1357,Chet Holmgren
2024-2025,Oklahoma City Thunder,C,10,10,265,56,111,0.505,14,37,0.378,42,74,0.568,0.568,38,49,0.776,16,71,87,20,8,26,23,18,164,Chet Holmgren
2023-2024,Los Angeles Lakers,SG,21,0,109,10,45,0.222,2,15,0.133,8,30,0.267,0.244,12,20,0.6,2,11,13,8,3,2,9,13,34,Jalen Hood-Schifino
2024-2025,Los Angeles Lakers,SG,2,0,14,1,1,1,0,0,,1,1,1,1,2,2,1,1,0,1,1,0,1,1,3,4,Jalen Hood-Schifino
2013-2014,Cleveland Cavaliers,SG,2,0,7,0,4,0,0,2,0,0,2,0,0,1,2,0.5,0,0,0,1,1,0,0,0,1,Scotty Hopson
2017-2018,Dallas Mavericks,SG,1,0,8,0,1,0,0,0,,0,1,0,0,1,2,0.5,0,0,0,1,0,0,1,0,1,Scotty Hopson
2021-2022,Oklahoma City Thunder,SG,1,0,18,2,4,0.5,0,1,0,2,3,0.667,0.5,0,0,,0,1,1,1,0,0,2,1,4,Scotty Hopson
2007-2008,Atlanta Hawks,C,81,77,2540,333,668,0.499,0,5,0,333,663,0.502,0.499,155,212,0.731,248,537,785,124,60,76,137,267,821,Al Horford
2008-2009,Atlanta Hawks,C,67,67,2242,312,594,0.525,0,1,0,312,593,0.526,0.525,149,205,0.727,145,479,624,163,53,95,103,190,773,Al Horford
2009-2010,Atlanta Hawks,C,81,81,2845,467,847,0.551,1,1,1,466,846,0.551,0.552,213,270,0.789,236,563,799,189,59,91,122,225,1148,Al Horford
2010-2011,Atlanta Hawks,C,77,77,2704,513,921,0.557,2,4,0.5,511,917,0.557,0.558,150,188,0.798,182,536,718,266,59,80,119,193,1178,Al Horford
2011-2012,Atlanta Hawks,C,11,11,348,57,103,0.553,0,1,0,57,102,0.559,0.553,22,30,0.733,26,51,77,24,10,14,16,21,136,Al Horford
2012-2013,Atlanta Hawks,C,74,74,2756,576,1060,0.543,3,6,0.5,573,1054,0.544,0.545,134,208,0.644,195,562,757,240,78,78,147,163,1289,Al Horford
2013-2014,Atlanta Hawks,C,29,29,958,238,420,0.567,4,11,0.364,234,409,0.572,0.571,58,85,0.682,66,178,244,76,27,44,64,56,538,Al Horford
2014-2015,Atlanta Hawks,C,76,76,2318,519,965,0.538,11,36,0.306,508,929,0.547,0.544,107,141,0.759,131,413,544,244,68,98,100,121,1156,Al Horford
2015-2016,Atlanta Hawks,C,82,82,2631,529,1048,0.505,88,256,0.344,441,792,0.557,0.547,103,129,0.798,148,448,596,263,68,121,107,163,1249,Al Horford
2016-2017,Boston Celtics,C,68,68,2193,379,801,0.473,86,242,0.355,293,559,0.524,0.527,108,135,0.8,95,370,465,337,52,86,115,138,952,Al Horford
2017-2018,Boston Celtics,C,72,72,2277,368,753,0.489,97,226,0.429,271,527,0.514,0.553,94,120,0.783,103,427,530,339,43,78,132,138,927,Al Horford
2018-2019,Boston Celtics,C,68,68,1973,387,723,0.535,73,203,0.36,314,520,0.604,0.586,78,95,0.821,120,338,458,283,59,86,102,126,925,Al Horford
2019-2020,Philadelphia 76ers,C,67,61,2025,319,709,0.45,99,283,0.35,220,426,0.516,0.52,61,80,0.763,103,353,456,270,52,61,80,142,798,Al Horford
2020-2021,Oklahoma City Thunder,C,28,28,782,162,360,0.45,56,152,0.368,106,208,0.51,0.528,18,22,0.818,29,159,188,94,25,26,29,48,398,Al Horford
2021-2022,Boston Celtics,C,69,69,2005,266,569,0.467,89,265,0.336,177,304,0.582,0.546,80,95,0.842,108,422,530,232,49,92,65,130,701,Al Horford
2022-2023,Boston Celtics,C,63,63,1922,228,479,0.476,145,325,0.446,83,154,0.539,0.627,15,21,0.714,73,317,390,189,30,61,37,121,616,Al Horford
2023-2024,Boston Celtics,C,65,33,1740,214,419,0.511,108,258,0.419,106,161,0.658,0.64,26,30,0.867,82,331,413,168,38,62,48,93,562,Al Horford
2024-2025,Boston Celtics,C,24,21,667,81,179,0.453,51,127,0.402,30,52,0.577,0.595,10,12,0.833,22,106,128,52,16,22,23,37,223,Al Horford
2019-2020,Los Angeles Lakers,SG,6,1,81,14,30,0.467,4,13,0.308,10,17,0.588,0.533,2,4,0.5,2,5,7,6,8,1,6,10,34,Talen Horton-Tucker
2020-2021,Los Angeles Lakers,SG,65,4,1304,224,489,0.458,37,131,0.282,187,358,0.522,0.496,100,129,0.775,25,144,169,181,63,21,105,127,585,Talen Horton-Tucker
2021-2022,Los Angeles Lakers,SG,60,19,1511,224,538,0.416,49,182,0.269,175,356,0.492,0.462,100,125,0.8,37,156,193,159,59,29,82,148,597,Talen Horton-Tucker
2022-2023,Utah Jazz,SG,65,20,1313,257,613,0.419,58,203,0.286,199,410,0.485,0.467,126,168,0.75,41,169,210,246,41,29,126,108,698,Talen Horton-Tucker
2023-2024,Utah Jazz,PG,51,11,1009,184,465,0.396,60,182,0.33,124,283,0.438,0.46,88,109,0.807,21,100,121,177,45,19,65,94,516,Talen Horton-Tucker
2024-2025,Chicago Bulls,SG,25,0,314,60,127,0.472,22,57,0.386,38,70,0.543,0.559,25,37,0.676,11,39,50,40,9,5,14,26,167,Talen Horton-Tucker
2016-2017,Washington Wizards,SG,1,0,1,0,0,,0,0,,0,0,,,0,0,,0,1,1,0,0,0,0,0,0,Danuel House Jr.
2017-2018,Phoenix Suns,SG,23,3,403,56,129,0.434,15,58,0.259,41,71,0.577,0.492,25,31,0.806,13,63,76,25,7,6,11,23,152,Danuel House Jr.
2018-2019,Houston Rockets,SF,39,13,979,118,252,0.468,74,178,0.416,44,74,0.595,0.615,56,71,0.789,25,115,140,40,21,11,35,80,366,Danuel House Jr.
2019-2020,Houston Rockets,SF,63,52,1913,230,539,0.427,129,355,0.363,101,184,0.549,0.546,73,90,0.811,57,210,267,85,67,34,54,132,662,Danuel House Jr.
2020-2021,Houston Rockets,SF,36,23,932,110,272,0.404,54,156,0.346,56,116,0.483,0.504,41,63,0.651,18,114,132,69,20,16,36,67,315,Danuel House Jr.
2021-2022,Total,SF,42,7,727,80,198,0.404,44,117,0.376,36,81,0.444,0.515,44,58,0.759,18,93,111,44,21,17,33,51,248,Danuel House Jr.
2021-2022,Houston Rockets,SF,16,1,233,25,74,0.338,10,34,0.294,15,40,0.375,0.405,17,19,0.895,4,39,43,19,5,5,18,16,77,Danuel House Jr.
2021-2022,New York Knicks,SF,1,0,3,0,1,0,0,1,0,0,0,,0,0,0,,0,0,0,0,0,0,0,0,0,Danuel House Jr.
2021-2022,Utah Jazz,SF,25,6,491,55,123,0.447,34,82,0.415,21,41,0.512,0.585,27,39,0.692,14,54,68,25,16,12,15,35,171,Danuel House Jr.
2022-2023,Philadelphia 76ers,SF,56,5,807,93,197,0.472,37,110,0.336,56,87,0.644,0.566,45,60,0.75,9,85,94,44,14,9,26,69,268,Danuel House Jr.
2023-2024,Philadelphia 76ers,SF,34,4,509,47,105,0.448,15,50,0.3,32,55,0.582,0.519,35,46,0.761,16,42,58,28,15,5,19,45,144,Danuel House Jr.
2022-2023,Orlando Magic,SF,51,4,812,66,182,0.363,46,136,0.338,20,46,0.435,0.489,15,18,0.833,34,65,99,30,12,7,18,63,193,Caleb Houstan
2023-2024,Orlando Magic,SF,59,13,815,80,206,0.388,72,193,0.373,8,13,0.615,0.563,21,26,0.808,28,56,84,29,15,4,16,61,253,Caleb Houstan
2024-2025,Orlando Magic,SF,20,0,115,8,29,0.276,6,24,0.25,2,5,0.4,0.379,2,2,1,2,7,9,3,0,2,1,6,24,Caleb Houstan
2023-2024,Orlando Magic,SF,18,0,67,10,30,0.333,7,25,0.28,3,5,0.6,0.45,2,4,0.5,1,6,7,6,2,2,3,4,29,Jett Howard
2024-2025,Orlando Magic,SF,30,0,305,42,114,0.368,27,84,0.321,15,30,0.5,0.487,6,7,0.857,11,23,34,13,5,6,12,27,117,Jett Howard
2022-2023,Houston Rockets,PG,5,0,28,2,9,0.222,2,8,0.25,0,1,0,0.333,3,3,1,0,0,0,3,0,0,1,1,9,Trevor Hudgins
2018-2019,Atlanta Hawks,SG,75,59,2048,275,657,0.419,136,353,0.385,139,304,0.457,0.522,41,56,0.732,60,185,245,214,65,25,109,155,727,Kevin Huerter
2019-2020,Atlanta Hawks,SG,56,48,1760,252,610,0.413,127,334,0.38,125,276,0.453,0.517,53,64,0.828,35,193,228,213,51,27,87,139,684,Kevin Huerter
2020-2021,Atlanta Hawks,SG,69,49,2126,316,731,0.432,140,386,0.363,176,345,0.51,0.528,50,64,0.781,38,193,231,241,82,18,79,165,822,Kevin Huerter
2021-2022,Atlanta Hawks,SF,74,60,2188,345,760,0.454,160,411,0.389,185,349,0.53,0.559,42,52,0.808,32,222,254,203,55,26,91,185,892,Kevin Huerter
2022-2023,Sacramento Kings,SG,75,75,2203,420,866,0.485,205,510,0.402,215,356,0.604,0.603,95,131,0.725,42,209,251,221,80,24,97,181,1140,Kevin Huerter
2023-2024,Sacramento Kings,SG,64,59,1562,248,560,0.443,123,341,0.361,125,219,0.571,0.553,36,47,0.766,38,186,224,166,45,23,53,135,655,Kevin Huerter
2024-2025,Sacramento Kings,SG,27,15,683,98,228,0.43,48,154,0.312,50,74,0.676,0.535,16,23,0.696,13,83,96,54,28,13,27,59,260,Kevin Huerter
2021-2022,Los Angeles Lakers,C,4,0,20,0,3,0,0,2,0,0,1,0,0,0,0,,1,3,4,1,1,1,1,1,0,Jay Huff
2022-2023,Washington Wizards,C,7,0,95,15,25,0.6,6,12,0.5,9,13,0.692,0.72,15,16,0.938,6,15,21,10,3,4,5,15,51,Jay Huff
2023-2024,Denver Nuggets,C,20,0,49,9,15,0.6,3,9,0.333,6,6,1,0.7,2,2,1,2,9,11,2,2,3,1,9,23,Jay Huff
2024-2025,Memphis Grizzlies,C,28,1,423,88,171,0.515,45,110,0.409,43,61,0.705,0.646,33,43,0.767,17,60,77,22,8,32,17,49,254,Jay Huff
2020-2021,Utah Jazz,SF,18,0,64,10,30,0.333,8,23,0.348,2,7,0.286,0.467,3,4,0.75,1,8,9,6,1,1,6,1,31,Elijah Hughes
2021-2022,Total,SG,36,4,434,47,144,0.326,25,95,0.263,22,49,0.449,0.413,7,9,0.778,6,52,58,22,14,8,17,39,126,Elijah Hughes
2021-2022,Utah Jazz,SF,14,1,112,15,36,0.417,10,28,0.357,5,8,0.625,0.556,3,3,1,2,15,17,6,4,1,7,7,43,Elijah Hughes
2021-2022,Portland Trail Blazers,SG,22,3,322,32,108,0.296,15,67,0.224,17,41,0.415,0.366,4,6,0.667,4,37,41,16,10,7,10,32,83,Elijah Hughes
2024-2025,New York Knicks,C,12,0,99,9,14,0.643,0,0,9,14,0.643,0.643,4,8,0.5,4,18,22,6,0,8,10,14,22,0,Ariel Hukporti
2021-2022,New York Knicks,SF,2,0,8,0,2,0,0,0,0,2,0,0,0,0,1,0,1,1,1,0,1,1,0,0,,Feron Hunt
2019-2020,Atlanta Hawks,SF,63,62,2018,280,683,0.41,108,304,0.355,172,379,0.454,0.489,110,144,0.764,44,242,286,112,44,18,103,182,778,De'Andre Hunter
2020-2021,Atlanta Hawks,SF,23,19,678,120,248,0.484,31,95,0.326,89,153,0.582,0.546,73,85,0.859,17,93,110,44,19,12,29,59,344,De'Andre Hunter
2021-2022,Atlanta Hawks,SF,53,52,1577,254,575,0.442,74,195,0.379,180,380,0.474,0.506,127,166,0.765,26,150,176,68,36,21,69,155,709,De'Andre Hunter
2022-2023,Atlanta Hawks,SF,67,67,2126,379,822,0.461,100,286,0.35,279,536,0.521,0.522,171,207,0.826,46,238,284,94,35,17,82,199,1029,De'Andre Hunter
2023-2024,Atlanta Hawks,SF,57,37,1681,304,663,0.459,117,304,0.385,187,359,0.521,0.547,166,196,0.847,31,191,222,87,40,16,83,146,891,De'Andre Hunter
2024-2025,Atlanta Hawks,SF,20,2,564,131,269,0.487,55,125,0.44,76,144,0.528,0.589,89,99,0.899,12,70,82,25,14,3,28,48,406,De'Andre Hunter
2015-2016,Boston Celtics,SG,36,0,315,36,98,0.367,19,63,0.302,17,35,0.486,0.464,6,7,0.857,2,35,37,13,14,4,11,29,97,R.J. Hunter
2016-2017,Chicago Bulls,SG,3,0,9,0,1,0,0,1,0,0,0,,0,0,0,,0,1,1,0,0,0,0,0,0,R.J. Hunter
2017-2018,Houston Rockets,SG,5,1,45,7,20,0.35,3,14,0.214,4,6,0.667,0.425,2,2,1,0,5,5,3,3,0,2,7,19,R.J. Hunter
2018-2019,Boston Celtics,SG,1,0,26,6,13,0.462,4,10,0.4,2,3,0.667,0.615,1,2,0.5,1,2,3,3,1,0,0,3,17,R.J. Hunter
2023-2024,Memphis Grizzlies,PF,8,0,113,12,34,0.353,5,20,0.25,7,14,0.5,0.426,3,3,1,9,7,16,4,3,3,2,8,32,Matthew Hurt
2018-2019,Chicago Bulls,SF,44,14,895,96,209,0.459,14,50,0.28,82,159,0.516,0.493,23,38,0.605,31,154,185,34,23,6,25,59,229,Chandler Hutchison
2019-2020,Chicago Bulls,SF,28,10,527,80,175,0.457,12,38,0.316,68,137,0.496,0.491,46,78,0.59,18,90,108,26,27,7,27,47,218,Chandler Hutchison
2020-2021,Total,SF,25,1,346,39,103,0.379,8,22,0.364,31,81,0.383,0.417,21,25,0.84,6,72,78,17,12,5,20,33,107,Chandler Hutchison
2020-2021,Chicago Bulls,SF,7,0,64,5,18,0.278,1,3,0.333,4,15,0.267,0.306,2,2,1,1,19,20,4,1,0,5,9,13,Chandler Hutchison
2020-2021,Washington Wizards,SF,18,1,282,34,85,0.4,7,19,0.368,27,66,0.409,0.441,19,23,0.826,5,53,58,13,11,5,15,24,94,Chandler Hutchison
2021-2022,Phoenix Suns,SF,6,0,22,1,2,0.5,0,0,,1,2,0.5,0.5,2,2,1,0,5,5,2,0,0,4,1,4,Chandler Hutchison
2021-2022,Denver Nuggets,SG,69,4,1310,230,571,0.403,131,358,0.366,99,213,0.465,0.518,107,125,0.856,14,174,188,191,41,20,86,153,698,Bones Hyland
2022-2023,Total,PG,56,1,1085,228,571,0.399,117,315,0.371,111,256,0.434,0.502,86,102,0.843,20,115,135,172,39,15,82,96,659,Bones Hyland
2022-2023,Denver Nuggets,PG,42,1,820,173,434,0.399,91,241,0.378,82,193,0.425,0.503,71,82,0.866,10,76,86,125,28,13,67,66,508,Bones Hyland
2022-2023,Los Angeles Clippers,PG,14,0,265,55,137,0.401,26,74,0.351,29,63,0.46,0.496,15,20,0.75,10,39,49,47,11,2,15,30,151,Bones Hyland
2023-2024,Los Angeles Clippers,PG,37,5,540,97,251,0.386,44,135,0.326,53,116,0.457,0.474,18,23,0.783,5,50,55,93,26,4,44,51,256,Bones Hyland
2024-2025,Los Angeles Clippers,PG,12,0,137,30,73,0.411,23,52,0.442,7,21,0.333,0.568,15,18,0.833,3,10,13,14,11,4,15,15,98,Bones Hyland
2024-2025,Phoenix Suns,PF,24,2,376,42,66,0.636,0,0,42,66,0.636,0.636,11,19,0.579,23,65,88,21,10,7,12,38,95,0,Oso Ighodaro
2014-2015,Utah Jazz,SF,79,32,1673,147,354,0.415,72,202,0.356,75,152,0.493,0.517,30,40,0.75,22,153,175,182,72,10,98,124,396,Joe Ingles
2015-2016,Utah Jazz,SF,81,2,1241,124,291,0.426,81,210,0.386,43,81,0.531,0.565,13,18,0.722,19,132,151,96,55,4,65,98,342,Joe Ingles
2016-2017,Utah Jazz,SF,82,26,1972,204,451,0.452,123,279,0.441,81,172,0.471,0.589,50,68,0.735,23,238,261,225,96,8,107,163,581,Joe Ingles
2017-2018,Utah Jazz,SF,82,81,2578,335,718,0.467,204,464,0.44,131,254,0.516,0.609,66,83,0.795,24,320,344,392,90,20,159,178,940,Joe Ingles
2018-2019,Utah Jazz,PF,82,82,2568,359,802,0.448,189,483,0.391,170,319,0.533,0.565,87,123,0.707,35,295,330,469,98,20,193,180,994,Joe Ingles
2019-2020,Utah Jazz,PF,72,45,2137,246,553,0.445,141,353,0.399,105,200,0.525,0.572,74,94,0.787,27,251,278,373,65,11,142,154,707,Joe Ingles
2020-2021,Utah Jazz,SF,67,30,1867,275,562,0.489,183,406,0.451,92,156,0.59,0.652,76,90,0.844,27,217,244,318,45,12,117,120,809,Joe Ingles
2021-2022,Utah Jazz,SF,45,15,1122,115,285,0.404,78,225,0.347,37,60,0.617,0.54,17,22,0.773,12,119,131,158,23,5,46,82,325,Joe Ingles
2022-2023,Milwaukee Bucks,SF,46,0,1044,108,248,0.435,83,203,0.409,25,45,0.556,0.603,18,21,0.857,13,115,128,150,33,6,55,74,317,Joe Ingles
2023-2024,Orlando Magic,SF,68,0,1169,99,227,0.436,70,161,0.435,29,66,0.439,0.59,28,34,0.824,18,124,142,203,43,5,67,88,296,Joe Ingles
2024-2025,Minnesota Timberwolves,SF,7,0,26,0,2,0,0,2,0,0,0,,0,0,0,,2,0,2,9,0,0,1,5,0,Joe Ingles
2016-2017,Los Angeles Lakers,SF,79,40,2279,276,686,0.402,55,187,0.294,221,499,0.443,0.442,133,214,0.621,60,256,316,166,50,36,116,158,740,Brandon Ingram
2017-2018,Los Angeles Lakers,SF,59,59,1975,358,761,0.47,41,105,0.39,317,656,0.483,0.497,192,282,0.681,57,257,314,230,45,43,149,163,949,Brandon Ingram
2018-2019,Los Angeles Lakers,SF,52,52,1760,362,729,0.497,31,94,0.33,331,635,0.521,0.518,195,289,0.675,41,226,267,154,28,31,129,149,950,Brandon Ingram
2019-2020,New Orleans Pelicans,PF,62,62,2104,507,1096,0.463,150,384,0.391,357,712,0.501,0.531,313,368,0.851,51,329,380,259,61,38,189,179,1477,Brandon Ingram
2020-2021,New Orleans Pelicans,SF,61,61,2093,513,1101,0.466,143,375,0.381,370,726,0.51,0.531,281,320,0.878,34,265,299,296,42,36,154,124,1450,Brandon Ingram
2021-2022,New Orleans Pelicans,SF,55,55,1869,453,983,0.461,74,226,0.327,379,757,0.501,0.498,266,322,0.826,35,285,320,307,34,26,151,119,1246,Brandon Ingram
2022-2023,New Orleans Pelicans,SF,45,45,1538,404,835,0.484,64,164,0.39,340,671,0.507,0.522,240,272,0.882,23,223,246,262,32,19,148,116,1112,Brandon Ingram
2023-2024,New Orleans Pelicans,SF,64,64,2103,500,1017,0.492,86,242,0.355,414,775,0.534,0.534,246,307,0.801,43,281,324,363,50,40,163,145,1332,Brandon Ingram
2024-2025,New Orleans Pelicans,SF,18,18,595,155,333,0.465,43,115,0.374,112,218,0.514,0.53,47,55,0.855,17,83,100,93,16,11,69,45,400,Brandon Ingram
2024-2025,San Antonio Spurs,SF,1,0,7,0,1,0,0,0,0,1,0,0,0,0,0,1,1,0,0,0,0,1,0,0,,Harrison Ingram
2011-2012,Cleveland Cavaliers,PG,51,51,1558,350,747,0.469,73,183,0.399,277,564,0.491,0.517,171,196,0.872,44,147,191,275,54,20,160,110,944,Kyrie Irving
2012-2013,Cleveland Cavaliers,PG,59,59,2048,484,1070,0.452,109,279,0.391,375,791,0.474,0.503,248,290,0.855,34,182,216,350,89,21,191,146,1325,Kyrie Irving
2013-2014,Cleveland Cavaliers,PG,71,71,2496,532,1237,0.43,123,344,0.358,409,893,0.458,0.48,291,338,0.861,52,207,259,433,108,23,190,163,1478,Kyrie Irving
2014-2015,Cleveland Cavaliers,PG,75,75,2730,578,1235,0.468,157,378,0.415,421,857,0.491,0.532,315,365,0.863,55,182,237,389,114,20,186,146,1628,Kyrie Irving
2015-2016,Cleveland Cavaliers,PG,53,53,1667,394,879,0.448,84,262,0.321,310,617,0.502,0.496,169,191,0.885,44,113,157,249,56,18,124,107,1041,Kyrie Irving
2016-2017,Cleveland Cavaliers,PG,72,72,2525,671,1420,0.473,177,441,0.401,494,979,0.505,0.535,297,328,0.905,52,178,230,418,83,24,180,157,1816,Kyrie Irving
2017-2018,Boston Celtics,PG,60,60,1931,534,1087,0.491,166,407,0.408,368,680,0.541,0.568,232,261,0.889,33,194,227,306,65,17,140,122,1466,Kyrie Irving
2018-2019,Boston Celtics,PG,67,67,2214,604,1241,0.487,174,434,0.401,430,807,0.533,0.557,214,245,0.873,71,264,335,464,103,34,172,167,1596,Kyrie Irving
2019-2020,Brooklyn Nets,PG,20,20,658,199,416,0.478,56,142,0.394,143,274,0.522,0.546,94,102,0.922,22,81,103,128,27,10,52,53,548,Kyrie Irving
2020-2021,Brooklyn Nets,PG,54,54,1886,549,1086,0.506,152,378,0.402,397,708,0.561,0.576,201,218,0.922,52,205,257,324,76,37,130,140,1451,Kyrie Irving
2021-2022,Brooklyn Nets,PG,29,29,1091,289,616,0.469,100,239,0.418,189,377,0.501,0.55,118,129,0.915,16,111,127,167,41,17,73,81,796,Kyrie Irving
2022-2023,Total,SG,60,60,2241,594,1203,0.494,188,496,0.379,406,707,0.574,0.572,247,273,0.905,59,245,304,331,66,45,128,165,1623,Kyrie Irving
2022-2023,Brooklyn Nets,PG,40,40,1478,398,819,0.486,130,348,0.374,268,471,0.569,0.565,158,179,0.883,38,166,204,211,41,33,91,109,1084,Kyrie Irving
2022-2023,Dallas Mavericks,SG,20,20,763,196,384,0.51,58,148,0.392,138,236,0.585,0.586,89,94,0.947,21,79,100,120,25,12,37,56,539,Kyrie Irving
2023-2024,Dallas Mavericks,SG,58,58,2030,562,1131,0.497,173,421,0.411,389,710,0.548,0.573,190,210,0.905,44,246,290,299,74,28,106,112,1487,Kyrie Irving
2024-2025,Dallas Mavericks,SG,28,28,992,246,510,0.482,88,197,0.447,158,313,0.505,0.569,87,97,0.897,30,98,128,143,31,8,60,61,667,Kyrie Irving
2017-2018,Orlando Magic,PF,27,10,536,55,145,0.379,16,46,0.348,39,99,0.394,0.434,19,25,0.76,16,83,99,18,33,30,27,48,145,Jonathan Isaac
2018-2019,Orlando Magic,PF,75,64,1996,262,611,0.429,86,266,0.323,176,345,0.51,0.499,110,135,0.815,99,312,411,80,59,98,75,143,720,Jonathan Isaac
2019-2020,Orlando Magic,PF,34,32,980,156,332,0.47,32,94,0.34,124,238,0.521,0.518,60,77,0.779,58,173,231,48,53,78,49,83,404,Jonathan Isaac
2022-2023,Orlando Magic,PF,11,0,124,22,53,0.415,6,15,0.4,16,38,0.421,0.472,5,9,0.556,15,29,44,6,14,4,4,5,55,Jonathan Isaac
2023-2024,Orlando Magic,PF,58,2,914,146,286,0.51,42,112,0.375,104,174,0.598,0.584,59,82,0.72,73,187,260,30,43,70,27,64,393,Jonathan Isaac
2024-2025,Orlando Magic,PF,27,0,448,57,140,0.407,19,72,0.264,38,68,0.559,0.475,23,34,0.676,43,79,122,8,23,35,12,39,156,Jonathan Isaac
2022-2023,Detroit Pistons,SG,74,73,2304,409,983,0.416,120,350,0.343,289,633,0.457,0.477,266,356,0.747,73,215,288,387,61,17,237,242,1204,Jaden Ivey
2023-2024,Detroit Pistons,SG,77,61,2217,417,973,0.429,124,369,0.336,293,604,0.485,0.492,227,303,0.749,86,178,264,296,57,41,190,204,1185,Jaden Ivey
2024-2025,Detroit Pistons,SG,28,28,850,175,393,0.445,56,145,0.386,119,248,0.48,0.517,83,113,0.735,39,81,120,114,27,11,81,67,489,Jaden Ivey
2017-2018,Orlando Magic,SF,62,12,1020,93,218,0.427,9,46,0.196,84,172,0.488,0.447,34,47,0.723,36,101,137,57,33,12,30,81,229,Wes Iwundu
2018-2019,Orlando Magic,SF,68,13,1233,113,274,0.412,29,79,0.367,84,195,0.431,0.465,84,103,0.816,37,147,184,73,28,22,44,123,339,Wes Iwundu
2019-2020,Orlando Magic,SF,52,21,953,97,233,0.416,28,82,0.341,69,151,0.457,0.476,78,97,0.804,24,107,131,60,25,13,26,80,300,Wes Iwundu
2020-2021,Total,SF,41,4,539,34,102,0.333,5,41,0.122,29,61,0.475,0.358,26,31,0.839,15,75,90,18,15,4,19,49,99,Wes Iwundu
2020-2021,Dallas Mavericks,SF,23,3,288,17,52,0.327,3,23,0.13,14,29,0.483,0.356,12,14,0.857,6,38,44,10,9,3,6,26,49,Wes Iwundu
2020-2021,New Orleans Pelicans,SF,18,1,251,17,50,0.34,2,18,0.111,15,32,0.469,0.36,14,17,0.824,9,37,46,8,6,1,13,23,50,Wes Iwundu
2021-2022,Atlanta Hawks,SF,3,1,82,8,18,0.444,3,5,0.6,5,13,0.385,0.528,3,4,0.75,3,10,13,0,1,0,1,8,22,Wes Iwundu
2023-2024,Milwaukee Bucks,SG,57,8,572,50,100,0.5,17,46,0.37,33,54,0.611,0.585,8,11,0.727,43,70,113,50,16,6,28,92,125,Andre Jackson Jr.
2024-2025,Milwaukee Bucks,SG,28,20,512,40,100,0.4,18,50,0.36,22,50,0.44,0.49,7,13,0.538,26,65,91,43,19,7,35,68,105,Andre Jackson Jr.
2018-2019,New Orleans Pelicans,PG,61,16,1169,194,447,0.434,53,169,0.314,141,278,0.507,0.493,54,73,0.74,25,109,134,69,25,2,48,92,495,Frank Jackson
2019-2020,New Orleans Pelicans,PG,59,2,797,134,331,0.405,47,144,0.326,87,187,0.465,0.476,56,75,0.747,22,61,83,61,17,4,49,77,371,Frank Jackson
2020-2021,Detroit Pistons,PG,40,6,738,134,293,0.457,61,150,0.407,73,143,0.51,0.561,61,75,0.813,15,71,86,36,15,1,34,53,390,Frank Jackson
2021-2022,Detroit Pistons,PG,53,7,1164,194,483,0.402,86,279,0.308,108,204,0.529,0.491,86,104,0.827,19,68,87,55,27,9,38,89,560,Frank Jackson
2022-2023,Utah Jazz,PG,1,0,5,0,3,0,0,1,0,0,2,0,0,0,0,,1,1,2,1,0,0,0,0,0,Frank Jackson
2023-2024,Memphis Grizzlies,PF,48,18,1233,241,563,0.428,102,286,0.357,139,277,0.502,0.519,115,153,0.752,53,143,196,59,28,24,65,64,699,GG Jackson II
2021-2022,Indiana Pacers,C,36,15,541,116,206,0.563,5,16,0.313,111,190,0.584,0.575,60,88,0.682,60,89,149,10,25,52,40,92,297,Isaiah Jackson
2022-2023,Indiana Pacers,C,63,12,1042,179,318,0.563,2,14,0.143,177,304,0.582,0.566,95,146,0.651,113,169,282,51,31,93,51,154,455,Isaiah Jackson
2023-2024,Indiana Pacers,C,59,3,771,155,233,0.665,0,4,0,155,229,0.677,0.665,73,102,0.716,94,144,238,50,34,61,39,137,383,Isaiah Jackson
2024-2025,Indiana Pacers,C,5,1,84,14,23,0.609,0,0,,14,23,0.609,0.609,7,14,0.5,11,17,28,5,3,8,5,14,35,Isaiah Jackson
2018-2019,Memphis Grizzlies,PF,58,56,1515,298,589,0.506,51,142,0.359,247,447,0.553,0.549,151,197,0.766,73,199,272,64,52,82,98,220,798,Jaren Jackson Jr.
2019-2020,Memphis Grizzlies,C,57,57,1622,353,753,0.469,145,368,0.394,208,385,0.54,0.565,139,186,0.747,55,207,262,78,40,92,99,232,990,Jaren Jackson Jr.
2020-2021,Memphis Grizzlies,C,11,4,258,53,125,0.424,17,60,0.283,36,65,0.554,0.492,35,42,0.833,17,45,62,12,12,18,15,42,158,Jaren Jackson Jr.
2021-2022,Memphis Grizzlies,PF,78,78,2126,430,1036,0.415,128,401,0.319,302,635,0.476,0.477,284,345,0.823,119,335,454,86,73,177,130,272,1272,Jaren Jackson Jr.
2022-2023,Memphis Grizzlies,C,63,63,1787,416,822,0.506,100,282,0.355,316,540,0.585,0.567,241,306,0.788,108,318,426,60,65,189,107,227,1173,Jaren Jackson Jr.
2023-2024,Memphis Grizzlies,C,66,66,2124,516,1162,0.444,117,366,0.32,399,796,0.501,0.494,337,417,0.808,85,280,365,154,80,106,160,235,1486,Jaren Jackson Jr.
2024-2025,Memphis Grizzlies,C,30,30,848,237,471,0.503,55,152,0.362,182,319,0.571,0.562,128,157,0.815,41,138,179,51,44,52,62,96,657,Jaren Jackson Jr.
2017-2018,Phoenix Suns,SF,77,35,1959,389,932,0.417,57,217,0.263,332,715,0.464,0.448,177,279,0.634,95,256,351,119,80,35,146,218,1012,Josh Jackson
2018-2019,Phoenix Suns,SG,79,29,1988,347,841,0.413,73,225,0.324,274,616,0.445,0.456,143,213,0.671,66,281,347,183,74,56,173,209,910,Josh Jackson
2019-2020,Memphis Grizzlies,SF,22,0,381,70,159,0.44,23,72,0.319,47,87,0.54,0.513,35,50,0.7,11,55,66,35,18,9,28,40,198,Josh Jackson
2020-2021,Detroit Pistons,SG,62,25,1560,296,707,0.419,77,257,0.3,219,450,0.487,0.473,159,218,0.729,57,197,254,143,53,47,142,178,828,Josh Jackson
2021-2022,Total,SF,51,3,830,120,300,0.4,33,130,0.254,87,170,0.512,0.455,55,77,0.714,21,120,141,54,26,22,47,88,328,Josh Jackson
2021-2022,Detroit Pistons,SF,39,3,707,103,251,0.41,30,113,0.265,73,138,0.529,0.47,40,56,0.714,17,106,123,49,21,18,38,71,276,Josh Jackson
2021-2022,Sacramento Kings,SF,12,0,123,17,49,0.347,3,17,0.176,14,32,0.438,0.378,15,21,0.714,4,14,18,5,5,4,9,17,52,Josh Jackson
2017-2018,Sacramento Kings,SF,68,41,1506,185,419,0.442,57,185,0.308,128,234,0.547,0.51,26,36,0.722,27,160,187,74,28,13,40,81,453,Justin Jackson
2018-2019,Total,SF,81,14,1614,217,485,0.447,87,245,0.355,130,240,0.542,0.537,62,79,0.785,44,168,212,96,32,14,29,99,583,Justin Jackson
2018-2019,Sacramento Kings,SF,52,3,1083,125,295,0.424,55,159,0.346,70,136,0.515,0.517,41,50,0.82,25,121,146,68,23,13,22,67,346,Justin Jackson
2018-2019,Dallas Mavericks,SF,29,11,531,92,190,0.484,32,86,0.372,60,104,0.577,0.568,21,29,0.724,19,47,66,28,9,1,7,32,237,Justin Jackson
2019-2020,Dallas Mavericks,PF,65,3,1045,135,341,0.396,48,163,0.294,87,178,0.489,0.466,42,50,0.84,27,127,154,52,15,10,14,69,360,Justin Jackson
2020-2021,Total,SF,34,3,577,89,221,0.403,36,117,0.308,53,104,0.51,0.484,31,37,0.838,16,61,77,52,15,2,32,32,245,Justin Jackson
2020-2021,Oklahoma City Thunder,SF,33,3,544,86,212,0.406,34,111,0.306,52,101,0.515,0.486,30,35,0.857,14,57,71,51,15,2,31,31,236,Justin Jackson
2020-2021,Milwaukee Bucks,SF,1,0,33,3,9,0.333,2,6,0.333,1,3,0.333,0.444,1,2,0.5,2,4,6,1,0,0,1,1,9,Justin Jackson
2021-2022,Total,SF,7,0,37,5,15,0.333,3,9,0.333,2,6,0.333,0.433,2,2,1,1,6,7,2,0,0,1,3,15,Justin Jackson
2021-2022,Boston Celtics,SF,1,0,2,0,1,0,0,0,,0,1,0,0,2,2,1,0,0,0,0,0,0,0,0,2,Justin Jackson
2021-2022,Phoenix Suns,SF,6,0,35,5,14,0.357,3,9,0.333,2,5,0.4,0.464,0,0,,1,6,7,2,0,0,1,3,13,Justin Jackson
2022-2023,Boston Celtics,SF,23,0,107,7,27,0.259,5,20,0.25,2,7,0.286,0.352,1,2,0.5,2,15,17,9,4,4,2,7,20,Justin Jackson
2023-2024,Minnesota Timberwolves,SF,2,0,1,0,0,,0,0,,0,0,,,0,0,,0,0,0,0,0,0,0,0,0,Justin Jackson
2022-2023,Washington Wizards,PG,9,0,135,19,42,0.452,1,12,0.083,18,30,0.6,0.464,17,22,0.773,2,6,8,15,4,1,4,10,56,Quenton Jackson
2023-2024,Indiana Pacers,PG,3,0,11,0,1,0,0,0,,0,1,0,0,2,2,1,0,4,4,2,1,0,0,1,2,Quenton Jackson
2024-2025,Indiana Pacers,PG,16,7,251,39,75,0.52,9,24,0.375,30,51,0.588,0.58,15,21,0.714,10,17,27,31,9,5,11,32,102,Quenton Jackson
2011-2012,Oklahoma City Thunder,PG,45,0,501,51,159,0.321,13,62,0.21,38,97,0.392,0.362,25,29,0.862,14,39,53,71,25,1,36,31,140,Reggie Jackson
2012-2013,Oklahoma City Thunder,PG,70,0,993,149,325,0.458,24,104,0.231,125,221,0.566,0.495,52,62,0.839,21,145,166,122,29,13,53,84,374,Reggie Jackson
2013-2014,Oklahoma City Thunder,PG,80,36,2277,403,916,0.44,83,245,0.339,320,671,0.477,0.485,158,177,0.893,43,270,313,331,85,9,168,142,1047,Reggie Jackson
2014-2015,Total,PG,77,40,2268,432,996,0.434,72,241,0.299,360,755,0.477,0.47,181,218,0.83,56,271,327,462,62,9,186,167,1117,Reggie Jackson
2014-2015,Oklahoma City Thunder,PG,50,13,1398,249,576,0.432,44,158,0.278,205,418,0.49,0.47,99,115,0.861,28,173,201,214,42,5,91,94,641,Reggie Jackson
2014-2015,Detroit Pistons,PG,27,27,870,183,420,0.436,28,83,0.337,155,337,0.46,0.469,82,103,0.796,28,98,126,248,20,4,95,73,476,Reggie Jackson
2015-2016,Detroit Pistons,PG,79,79,2424,540,1244,0.434,118,334,0.353,422,910,0.464,0.482,291,337,0.864,58,195,253,492,59,11,223,187,1489,Reggie Jackson
2016-2017,Detroit Pistons,PG,52,50,1424,284,677,0.419,66,184,0.359,218,493,0.442,0.468,118,136,0.868,21,93,114,270,35,5,114,129,752,Reggie Jackson
2017-2018,Detroit Pistons,PG,45,45,1201,246,577,0.426,52,169,0.308,194,408,0.475,0.471,112,134,0.836,29,96,125,238,27,4,99,87,656,Reggie Jackson
2018-2019,Detroit Pistons,PG,82,82,2289,441,1047,0.421,174,471,0.369,267,576,0.464,0.504,204,236,0.864,45,171,216,344,55,9,148,208,1260,Reggie Jackson
2019-2020,Total,PG,31,16,743,134,326,0.411,57,145,0.393,77,181,0.425,0.498,45,54,0.833,17,75,92,126,13,5,51,59,370,Reggie Jackson
2019-2020,Detroit Pistons,PG,14,10,381,76,198,0.384,31,82,0.378,45,116,0.388,0.462,26,33,0.788,11,30,41,72,8,1,23,21,209,Reggie Jackson
2019-2020,Los Angeles Clippers,PG,17,6,362,58,128,0.453,26,63,0.413,32,65,0.492,0.555,19,21,0.905,6,45,51,54,5,4,28,38,161,Reggie Jackson
2020-2021,Los Angeles Clippers,SG,67,43,1544,263,585,0.45,122,282,0.433,141,303,0.465,0.554,67,82,0.817,24,168,192,205,41,7,74,127,715,Reggie Jackson
2021-2022,Los Angeles Clippers,SG,75,75,2337,479,1222,0.392,167,512,0.326,312,710,0.439,0.46,138,163,0.847,39,232,271,359,55,15,173,159,1263,Reggie Jackson
2022-2023,Total,PG,68,40,1657,263,640,0.411,96,288,0.333,167,352,0.474,0.486,71,78,0.91,25,119,144,233,47,6,115,114,693,Reggie Jackson
2022-2023,Los Angeles Clippers,PG,52,38,1338,214,512,0.418,77,220,0.35,137,292,0.469,0.493,61,66,0.924,22,94,116,183,38,5,96,92,566,Reggie Jackson
2022-2023,Denver Nuggets,PG,16,2,319,49,128,0.383,19,68,0.279,30,60,0.5,0.457,10,12,0.833,3,25,28,50,9,1,19,22,127,Reggie Jackson
2023-2024,Denver Nuggets,PG,82,23,1817,326,756,0.431,102,284,0.359,224,472,0.475,0.499,79,98,0.806,33,122,155,308,44,13,106,149,833,Reggie Jackson
2024-2025,Philadelphia 76ers,PG,13,0,147,18,47,0.383,12,30,0.4,6,17,0.353,0.511,0,0,,2,11,13,24,7,3,7,10,48,Reggie Jackson
2023-2024,Golden State Warriors,PF,68,16,1130,233,332,0.702,0,1,0,233,331,0.704,0.702,74,132,0.561,135,206,341,82,29,76,49,108,540,Trayce Jackson-Davis
2024-2025,Golden State Warriors,C,29,22,528,105,168,0.625,0,1,0,105,167,0.629,0.625,27,46,0.587,56,100,156,61,10,22,24,37,237,Trayce Jackson-Davis
2024-2025,Los Angeles Lakers,SG,7,0,18,1,8,0.125,0,4,0,1,4,0.25,0.125,2,2,1,1,0,1,2,1,1,0,2,4,Bronny James
2019-2020,Sacramento Kings,SF,36,0,232,35,84,0.417,9,29,0.31,26,55,0.473,0.47,10,21,0.476,6,26,32,18,6,9,8,17,89,Justin James
2020-2021,Sacramento Kings,SF,36,0,310,52,111,0.468,14,38,0.368,38,73,0.521,0.532,21,36,0.583,9,21,30,22,8,3,15,23,139,Justin James
2003-2004,Cleveland Cavaliers,SG,79,79,3122,622,1492,0.417,63,217,0.29,559,1275,0.438,0.438,347,460,0.754,99,333,432,465,130,58,273,149,1654,LeBron James
2004-2005,Cleveland Cavaliers,SF,80,80,3388,795,1684,0.472,108,308,0.351,687,1376,0.499,0.504,477,636,0.75,111,477,588,577,177,52,262,146,2175,LeBron James
2005-2006,Cleveland Cavaliers,SF,79,79,3361,875,1823,0.48,127,379,0.335,748,1444,0.518,0.515,601,814,0.738,75,481,556,521,123,66,260,181,2478,LeBron James
2006-2007,Cleveland Cavaliers,SF,78,78,3190,772,1621,0.476,99,310,0.319,673,1311,0.513,0.507,489,701,0.698,83,443,526,470,125,55,250,171,2132,LeBron James
2007-2008,Cleveland Cavaliers,SF,75,74,3027,794,1642,0.484,113,359,0.315,681,1283,0.531,0.518,549,771,0.712,133,459,592,539,138,81,255,165,2250,LeBron James
2008-2009,Cleveland Cavaliers,SF,81,81,3054,789,1613,0.489,132,384,0.344,657,1229,0.535,0.53,594,762,0.78,106,507,613,587,137,93,241,139,2304,LeBron James
2009-2010,Cleveland Cavaliers,SF,76,76,2966,768,1528,0.503,129,387,0.333,639,1141,0.56,0.545,593,773,0.767,71,483,554,651,125,77,261,119,2258,LeBron James
2010-2011,Miami Heat,SF,79,79,3063,758,1485,0.51,92,279,0.33,666,1206,0.552,0.541,503,663,0.759,80,510,590,554,124,50,284,163,2111,LeBron James
2011-2012,Miami Heat,SF,62,62,2326,621,1169,0.531,54,149,0.362,567,1020,0.556,0.554,387,502,0.771,94,398,492,387,115,50,213,96,1683,LeBron James
2012-2013,Miami Heat,PF,76,76,2877,765,1354,0.565,103,254,0.406,662,1100,0.602,0.603,403,535,0.753,97,513,610,551,129,67,226,110,2036,LeBron James
2013-2014,Miami Heat,PF,77,77,2902,767,1353,0.567,116,306,0.379,651,1047,0.622,0.61,439,585,0.75,81,452,533,488,121,26,270,126,2089,LeBron James
2014-2015,Cleveland Cavaliers,SF,69,69,2493,624,1279,0.488,120,339,0.354,504,940,0.536,0.535,375,528,0.71,51,365,416,511,109,49,272,135,1743,LeBron James
2015-2016,Cleveland Cavaliers,SF,76,76,2709,737,1416,0.52,87,282,0.309,650,1134,0.573,0.551,359,491,0.731,111,454,565,514,104,49,249,143,1920,LeBron James
2016-2017,Cleveland Cavaliers,SF,74,74,2794,736,1344,0.548,124,342,0.363,612,1002,0.611,0.594,358,531,0.674,97,542,639,646,92,44,303,134,1954,LeBron James
2017-2018,Cleveland Cavaliers,PF,82,82,3026,857,1580,0.542,149,406,0.367,708,1174,0.603,0.59,388,531,0.731,97,612,709,747,116,71,347,136,2251,LeBron James
2018-2019,Los Angeles Lakers,SF,55,55,1937,558,1095,0.51,111,327,0.339,447,768,0.582,0.56,278,418,0.665,57,408,465,454,72,33,197,94,1505,LeBron James
2019-2020,Los Angeles Lakers,PG,67,67,2316,643,1303,0.493,148,425,0.348,495,878,0.564,0.55,264,381,0.693,66,459,525,684,78,36,261,118,1698,LeBron James
2020-2021,Los Angeles Lakers,PG,45,45,1504,422,823,0.513,104,285,0.365,318,538,0.591,0.576,178,255,0.698,29,317,346,350,48,25,168,70,1126,LeBron James
2021-2022,Los Angeles Lakers,C,56,56,2084,640,1221,0.524,161,448,0.359,479,773,0.62,0.59,254,336,0.756,63,396,459,349,73,59,196,121,1695,LeBron James
2022-2023,Los Angeles Lakers,PF,55,54,1954,609,1219,0.5,121,377,0.321,488,842,0.58,0.549,251,327,0.768,65,392,457,375,50,32,178,88,1590,LeBron James
2023-2024,Los Angeles Lakers,PF,71,71,2504,685,1269,0.54,149,363,0.41,536,906,0.592,0.599,303,404,0.75,61,457,518,589,89,38,245,78,1822,LeBron James
2024-2025,Los Angeles Lakers,SF,28,28,981,251,506,0.496,56,157,0.357,195,349,0.559,0.551,99,129,0.767,27,193,220,252,23,17,108,37,657,LeBron James
2023-2024,Miami Heat,SF,75,20,2113,341,697,0.489,65,202,0.322,276,495,0.558,0.536,142,175,0.811,82,203,285,195,77,20,110,167,889,Jaime Jaquez Jr.
2024-2025,Miami Heat,SF,24,3,524,77,182,0.423,14,50,0.28,63,132,0.477,0.462,46,61,0.754,30,83,113,54,26,3,39,41,214,Jaime Jaquez Jr.
2021-2022,Indiana Pacers,SG,1,0,1,0,0,,0,0,,0,0,,,0,0,,0,0,0,0,0,0,0,0,0,DeJon Jarreau
2023-2024,Memphis Grizzlies,SG,9,0,150,17,50,0.34,4,13,0.308,13,37,0.351,0.38,5,11,0.455,8,36,44,26,6,2,9,14,43,DeJon Jarreau
2019-2020,Sacramento Kings,SG,13,0,141,20,40,0.5,5,18,0.278,15,22,0.682,0.563,5,6,0.833,3,15,18,7,4,1,2,19,50,DaQuan Jeffries
2020-2021,Total,SG,31,5,493,50,120,0.417,20,67,0.299,30,53,0.566,0.5,7,8,0.875,19,52,71,22,15,10,14,48,127,DaQuan Jeffries
2020-2021,Sacramento Kings,SG,18,2,232,24,57,0.421,9,28,0.321,15,29,0.517,0.5,6,7,0.857,9,20,29,6,7,4,8,23,63,DaQuan Jeffries
2020-2021,Houston Rockets,SG,13,3,261,26,63,0.413,11,39,0.282,15,24,0.625,0.5,1,1,1,10,32,42,16,8,6,6,25,64,DaQuan Jeffries
2021-2022,Memphis Grizzlies,SG,3,0,9,1,2,0.5,0,1,0,1,1,1,0.5,0,0,,0,2,2,1,0,0,0,1,2,DaQuan Jeffries
2023-2024,New York Knicks,SG,17,0,46,6,17,0.353,2,10,0.2,4,7,0.571,0.412,0,2,0,0,5,5,5,0,1,3,2,14,DaQuan Jeffries
2024-2025,Charlotte Hornets,SG,6,0,117,19,36,0.528,8,16,0.5,11,20,0.55,0.639,3,4,0.75,5,12,17,4,4,4,4,11,49,DaQuan Jeffries
2023-2024,Total,C,25,14,573,75,136,0.551,0,0,75,136,0.551,0.551,21,25,0.84,64,70,134,27,12,28,34,69,171,0,Trey Jemison
2023-2024,Washington Wizards,C,2,0,1,0,0,,0,0,0,0,,,0,0,,0,1,1,0,0,0,1,0,0,0,Trey Jemison
2023-2024,Memphis Grizzlies,C,23,14,572,75,136,0.551,0,0,75,136,0.551,0.551,21,25,0.84,64,69,133,27,12,28,33,69,171,0,Trey Jemison
2024-2025,New Orleans Pelicans,C,16,0,166,15,32,0.469,0,0,15,32,0.469,0.469,8,21,0.381,22,22,44,10,7,6,10,27,38,0,Trey Jemison
2024-2025,Detroit Pistons,PG,2,0,5,0,2,0,0,2,0,0,0,0,0,0,0,0,0,0,0,0,0,1,0,0,,Daniss Jenkins
2012-2013,Atlanta Hawks,SG,61,2,902,131,294,0.446,53,138,0.384,78,156,0.5,0.536,59,70,0.843,17,77,94,56,12,10,40,37,374,John Jenkins
2013-2014,Atlanta Hawks,SG,13,0,158,16,42,0.381,4,18,0.222,12,24,0.5,0.429,4,4,1,3,19,22,11,1,1,11,11,40,John Jenkins
2014-2015,Atlanta Hawks,SG,24,3,297,49,99,0.495,21,52,0.404,28,47,0.596,0.601,16,19,0.842,2,37,39,13,10,0,8,15,135,John Jenkins
2015-2016,Total,SG,43,3,480,71,160,0.444,16,51,0.314,55,109,0.505,0.494,20,24,0.833,8,49,57,35,8,1,27,22,178,John Jenkins
2015-2016,Dallas Mavericks,SG,21,1,193,29,70,0.414,3,19,0.158,26,51,0.51,0.436,8,9,0.889,4,18,22,9,3,0,11,11,69,John Jenkins
2015-2016,Phoenix Suns,SG,22,2,287,42,90,0.467,13,32,0.406,29,58,0.5,0.539,12,15,0.8,4,31,35,26,5,1,16,11,109,John Jenkins
2016-2017,Phoenix Suns,SG,4,0,13,2,5,0.4,1,2,0.5,1,3,0.333,0.5,2,2,1,0,1,1,1,0,0,0,0,7,John Jenkins
2018-2019,Total,SG,26,0,333,42,105,0.4,22,58,0.379,20,47,0.426,0.505,15,18,0.833,6,31,37,22,0,2,9,10,121,John Jenkins
2018-2019,Washington Wizards,SG,4,0,14,2,2,1,2,2,1,0,0,,1.5,0,0,,0,1,1,1,0,0,0,0,6,John Jenkins
2018-2019,New York Knicks,SG,22,0,319,40,103,0.388,20,56,0.357,20,47,0.426,0.485,15,18,0.833,6,30,36,21,0,2,9,10,115,John Jenkins
2019-2020,Phoenix Suns,SG,31,0,328,38,113,0.336,14,50,0.28,24,63,0.381,0.398,12,16,0.75,7,39,46,44,15,3,18,29,102,Ty Jerome
2020-2021,Oklahoma City Thunder,SG,33,1,788,128,287,0.446,71,168,0.423,57,119,0.479,0.57,26,34,0.765,10,81,91,120,20,6,47,61,353,Ty Jerome
2021-2022,Oklahoma City Thunder,SG,48,4,801,124,328,0.378,54,186,0.29,70,142,0.493,0.46,38,47,0.809,19,59,78,109,30,5,37,73,340,Ty Jerome
2022-2023,Golden State Warriors,SG,45,2,816,118,242,0.488,35,90,0.389,83,152,0.546,0.56,38,41,0.927,7,71,78,135,23,5,30,64,309,Ty Jerome
2023-2024,Cleveland Cavaliers,SG,2,0,15,2,4,0.5,0,1,0,2,3,0.667,0.5,0,0,,1,0,1,3,0,0,1,2,4,Ty Jerome
2024-2025,Cleveland Cavaliers,SG,30,2,528,113,222,0.509,41,98,0.418,72,124,0.581,0.601,41,46,0.891,18,43,61,104,36,1,35,45,308,Ty Jerome
2020-2021,Philadelphia 76ers,SG,41,1,383,48,133,0.361,39,106,0.368,9,27,0.333,0.508,18,24,0.75,6,30,36,20,12,4,11,34,153,Isaiah Joe
2021-2022,Philadelphia 76ers,SG,55,1,609,62,177,0.35,45,135,0.333,17,42,0.405,0.477,29,31,0.935,6,50,56,35,14,3,19,47,198,Isaiah Joe
2022-2023,Oklahoma City Thunder,SG,73,10,1395,224,508,0.441,161,394,0.409,63,114,0.553,0.599,82,100,0.82,27,148,175,88,48,8,39,105,691,Isaiah Joe
2023-2024,Oklahoma City Thunder,SG,78,1,1445,222,485,0.458,147,353,0.416,75,132,0.568,0.609,45,52,0.865,32,148,180,99,46,22,47,87,636,Isaiah Joe
2024-2025,Oklahoma City Thunder,SG,27,10,561,78,201,0.388,56,157,0.357,22,44,0.5,0.527,12,16,0.75,13,58,71,41,19,6,13,43,224,Isaiah Joe
2024-2025,Milwaukee Bucks,SG,5,0,11,3,6,0.5,1,1,1,2,5,0.4,0.583,0,0,0,2,2,1,0,0,2,0,7,0,AJ Johnson
2018-2019,Indiana Pacers,PF,14,0,64,4,16,0.25,1,2,0.5,3,14,0.214,0.281,4,8,0.5,4,15,19,1,1,3,0,7,13,Alize Johnson
2019-2020,Indiana Pacers,PF,17,1,118,12,29,0.414,3,8,0.375,9,21,0.429,0.466,7,10,0.7,16,32,48,7,3,2,7,12,34,Alize Johnson
2020-2021,Brooklyn Nets,PF,18,0,189,40,68,0.588,1,6,0.167,39,62,0.629,0.596,13,13,1,27,63,90,14,5,5,9,16,94,Alize Johnson
2021-2022,Total,PF,23,0,167,17,39,0.436,0,4,0,17,35,0.486,0.436,7,12,0.583,28,33,61,9,5,0,12,18,41,Alize Johnson
2021-2022,Chicago Bulls,PF,16,0,121,12,23,0.522,0,2,0,12,21,0.571,0.522,4,7,0.571,16,20,36,8,3,0,8,15,28,Alize Johnson
2021-2022,Washington Wizards,PF,3,0,18,2,6,0.333,0,2,0,2,4,0.5,0.333,0,1,0,5,7,12,0,0,0,3,0,4,Alize Johnson
2021-2022,New Orleans Pelicans,PF,4,0,28,3,10,0.3,0,0,,3,10,0.3,0.3,3,4,0.75,7,6,13,1,2,0,1,3,9,Alize Johnson
2022-2023,San Antonio Spurs,PF,4,0,30,3,6,0.5,0,2,0,3,4,0.75,0.5,1,2,0.5,2,8,10,1,1,0,4,3,7,Alize Johnson
2019-2020,Phoenix Suns,PF,57,9,1255,176,405,0.435,106,272,0.39,70,133,0.526,0.565,46,57,0.807,49,138,187,69,36,20,32,88,504,Cameron Johnson
2020-2021,Phoenix Suns,PF,60,11,1437,203,483,0.42,117,335,0.349,86,148,0.581,0.541,50,59,0.847,33,166,199,86,37,16,40,85,573,Cameron Johnson
2021-2022,Phoenix Suns,PF,66,16,1730,279,607,0.46,166,391,0.425,113,216,0.523,0.596,98,114,0.86,42,231,273,99,57,16,47,113,822,Cameron Johnson
2022-2023,Total,PF,42,41,1199,223,474,0.47,103,255,0.404,120,219,0.548,0.579,101,120,0.842,34,151,185,78,50,14,37,83,650,Cameron Johnson
2022-2023,Phoenix Suns,PF,17,16,429,82,173,0.474,45,99,0.455,37,74,0.5,0.604,27,33,0.818,14,51,65,26,15,6,10,29,236,Cameron Johnson
2022-2023,Brooklyn Nets,PF,25,25,770,141,301,0.468,58,156,0.372,83,145,0.572,0.565,74,87,0.851,20,100,120,52,35,8,27,54,414,Cameron Johnson
2023-2024,Brooklyn Nets,PF,58,47,1599,276,619,0.446,138,353,0.391,138,266,0.519,0.557,86,109,0.789,55,196,251,138,49,15,57,105,776,Cameron Johnson
2024-2025,Brooklyn Nets,PF,29,29,953,184,374,0.492,94,219,0.429,90,155,0.581,0.618,103,116,0.888,21,106,127,90,24,14,43,54,565,Cameron Johnson
2021-2022,Toronto Raptors,SG,2,0,2,0,1,0,0,1,0,0,0,0,0,0,0,0,0,0,0,0,0,0,0,0,,David Johnson
2021-2022,Atlanta Hawks,PF,22,0,120,22,41,0.537,3,13,0.231,19,28,0.679,0.573,5,7,0.714,2,24,26,3,3,2,9,9,52,Jalen Johnson
2022-2023,Atlanta Hawks,SF,70,6,1042,158,322,0.491,30,104,0.288,128,218,0.587,0.537,49,78,0.628,51,231,282,83,38,34,41,113,395,Jalen Johnson
2023-2024,Atlanta Hawks,SF,56,52,1889,359,702,0.511,71,200,0.355,288,502,0.574,0.562,107,147,0.728,74,414,488,203,67,47,101,133,896,Jalen Johnson
2024-2025,Atlanta Hawks,SF,29,29,1062,226,447,0.506,40,122,0.328,186,325,0.572,0.55,81,106,0.764,52,247,299,160,42,30,91,55,573,Jalen Johnson
2009-2010,Chicago Bulls,PF,65,11,757,95,210,0.452,15,46,0.326,80,164,0.488,0.488,51,70,0.729,34,94,128,48,21,43,62,126,256,James Johnson
2010-2011,Total,SF,38,25,822,108,237,0.456,8,34,0.235,100,203,0.493,0.473,47,71,0.662,37,105,142,89,33,37,64,95,271,James Johnson
2010-2011,Chicago Bulls,SF,13,0,123,17,41,0.415,2,9,0.222,15,32,0.469,0.439,6,13,0.462,6,18,24,14,8,9,18,25,42,James Johnson
2010-2011,Toronto Raptors,SF,25,25,699,91,196,0.464,6,25,0.24,85,171,0.497,0.48,41,58,0.707,31,87,118,75,25,28,46,70,229,James Johnson
2011-2012,Toronto Raptors,SF,62,40,1561,233,518,0.45,19,60,0.317,214,458,0.467,0.468,81,115,0.704,74,218,292,122,71,84,101,177,566,James Johnson
2012-2013,Sacramento Kings,SF,54,11,878,117,283,0.413,2,21,0.095,115,262,0.439,0.417,40,67,0.597,49,96,145,58,41,50,68,99,276,James Johnson
2013-2014,Memphis Grizzlies,SF,52,4,956,143,308,0.464,22,87,0.253,121,221,0.548,0.5,76,90,0.844,60,106,166,111,42,57,66,102,384,James Johnson
2014-2015,Toronto Raptors,PF,70,17,1370,238,404,0.589,11,51,0.216,227,353,0.643,0.603,67,102,0.657,61,196,257,95,54,70,79,155,554,James Johnson
2015-2016,Toronto Raptors,PF,57,32,926,114,240,0.475,20,66,0.303,94,174,0.54,0.517,39,68,0.574,28,98,126,67,29,33,54,84,287,James Johnson
2016-2017,Miami Heat,PF,76,5,2085,368,769,0.479,87,256,0.34,281,513,0.548,0.535,152,215,0.707,66,310,376,276,76,86,171,197,975,James Johnson
2017-2018,Miami Heat,PF,73,41,1943,309,614,0.503,57,185,0.308,252,429,0.587,0.55,113,162,0.698,61,297,358,280,70,51,141,192,788,James Johnson
2018-2019,Miami Heat,PF,55,33,1164,164,379,0.433,50,149,0.336,114,230,0.496,0.499,50,70,0.714,22,154,176,135,35,27,74,114,428,James Johnson
2019-2020,Total,C,32,1,619,103,215,0.479,33,91,0.363,70,124,0.565,0.556,31,48,0.646,25,93,118,74,25,32,48,80,270,James Johnson
2019-2020,Miami Heat,PF,18,0,281,39,87,0.448,16,45,0.356,23,42,0.548,0.54,8,14,0.571,8,44,52,21,6,13,15,34,102,James Johnson
2019-2020,Minnesota Timberwolves,C,14,1,338,64,128,0.5,17,46,0.37,47,82,0.573,0.566,23,34,0.676,17,49,66,53,19,19,33,46,168,James Johnson
2020-2021,Total,PF,51,12,1043,146,327,0.446,31,120,0.258,115,207,0.556,0.494,45,76,0.592,32,145,177,98,42,42,55,120,368,James Johnson
2020-2021,Dallas Mavericks,PF,29,1,504,67,145,0.462,15,60,0.25,52,85,0.612,0.514,17,29,0.586,14,72,86,50,24,23,27,59,166,James Johnson
2020-2021,New Orleans Pelicans,PF,22,11,539,79,182,0.434,16,60,0.267,63,122,0.516,0.478,28,47,0.596,18,73,91,48,18,19,28,61,202,James Johnson
2021-2022,Brooklyn Nets,PF,62,10,1191,144,307,0.469,23,85,0.271,121,222,0.545,0.507,29,55,0.527,51,164,215,130,30,34,48,162,340,James Johnson
2022-2023,Indiana Pacers,PF,18,1,162,22,49,0.449,3,15,0.2,19,34,0.559,0.48,4,8,0.5,4,26,30,15,7,6,8,32,51,James Johnson
2023-2024,Indiana Pacers,PF,9,0,47,3,10,0.3,0,2,0,3,8,0.375,0.3,2,2,1,1,3,4,8,5,1,5,9,8,James Johnson
2024-2025,Indiana Pacers,PF,5,0,22,4,7,0.571,0,1,0,4,6,0.667,0.571,0,1,0,0,4,4,3,0,2,4,3,8,James Johnson
2019-2020,San Antonio Spurs,SF,17,1,301,53,89,0.596,13,22,0.591,40,67,0.597,0.669,35,44,0.795,10,47,57,15,14,2,13,28,154,Keldon Johnson
2020-2021,San Antonio Spurs,SF,69,67,1968,338,705,0.479,60,181,0.331,278,524,0.531,0.522,145,196,0.74,93,319,412,121,40,24,78,142,881,Keldon Johnson
2021-2022,San Antonio Spurs,SF,75,74,2392,471,1011,0.466,159,399,0.398,312,612,0.51,0.545,177,234,0.756,80,377,457,158,58,14,92,148,1278,Keldon Johnson
2022-2023,San Antonio Spurs,SF,63,63,2063,503,1113,0.452,134,407,0.329,369,706,0.523,0.512,245,327,0.749,56,262,318,183,46,11,134,125,1385,Keldon Johnson
2023-2024,San Antonio Spurs,SF,69,27,2038,391,862,0.454,127,367,0.346,264,495,0.533,0.527,175,221,0.792,95,282,377,195,51,20,100,149,1084,Keldon Johnson
2024-2025,San Antonio Spurs,SF,28,0,700,125,279,0.448,29,103,0.282,96,176,0.545,0.5,55,71,0.775,32,108,140,46,22,6,23,45,334,Keldon Johnson
2021-2022,Total,SG,37,12,697,96,272,0.353,34,100,0.34,62,172,0.36,0.415,41,51,0.804,24,57,81,76,28,12,46,69,267,Keon Johnson
2021-2022,Los Angeles Clippers,SG,15,0,135,17,51,0.333,3,11,0.273,14,40,0.35,0.363,16,21,0.762,6,15,21,13,7,2,7,21,53,Keon Johnson
2021-2022,Portland Trail Blazers,SG,22,12,562,79,221,0.357,31,89,0.348,48,132,0.364,0.428,25,30,0.833,18,42,60,63,21,10,39,48,214,Keon Johnson
2022-2023,Portland Trail Blazers,SG,40,0,416,67,178,0.376,28,81,0.346,39,97,0.402,0.455,27,41,0.659,11,33,44,59,19,6,43,43,189,Keon Johnson
2023-2024,Brooklyn Nets,SG,5,0,61,8,21,0.381,4,10,0.4,4,11,0.364,0.476,11,12,0.917,3,4,7,3,3,1,5,5,31,Keon Johnson
2024-2025,Brooklyn Nets,SG,29,10,552,76,213,0.357,37,128,0.289,39,85,0.459,0.444,13,18,0.722,17,74,91,34,20,10,32,72,202,Keon Johnson
2024-2025,Miami Heat,SF,3,0,14,1,2,0.5,0,1,0,1,1,1,0.5,0,0,0,3,3,0,0,0,0,1,2,0,Keshad Johnson
2023-2024,Oklahoma City Thunder,SF,9,0,66,5,16,0.313,1,3,0.333,4,13,0.308,0.344,0,0,4,6,10,4,1,0,4,5,11,0,Keyontae Johnson
2015-2016,Detroit Pistons,SF,73,6,1687,225,600,0.375,63,205,0.307,162,395,0.41,0.428,80,102,0.784,58,248,306,118,55,12,114,178,593,Stanley Johnson
2016-2017,Detroit Pistons,SF,77,1,1371,129,365,0.353,45,154,0.292,84,211,0.398,0.415,36,53,0.679,36,153,189,105,56,24,71,121,339,Stanley Johnson
2017-2018,Detroit Pistons,SF,69,50,1894,210,560,0.375,67,234,0.286,143,326,0.439,0.435,112,145,0.772,33,219,252,112,95,14,77,169,599,Stanley Johnson
2018-2019,Total,SF,66,7,1208,171,440,0.389,62,215,0.288,109,225,0.484,0.459,50,64,0.781,34,183,217,88,60,14,81,114,454,Stanley Johnson
2018-2019,Detroit Pistons,SF,48,7,961,133,349,0.381,51,181,0.282,82,168,0.488,0.454,41,51,0.804,25,150,175,60,48,13,55,92,358,Stanley Johnson
2018-2019,New Orleans Pelicans,SF,18,0,247,38,91,0.418,11,34,0.324,27,57,0.474,0.478,9,13,0.692,9,33,42,28,12,1,26,22,96,Stanley Johnson
2019-2020,Toronto Raptors,PF,25,0,150,22,59,0.373,7,24,0.292,15,35,0.429,0.432,9,16,0.563,7,30,37,20,6,4,15,16,60,Stanley Johnson
2020-2021,Toronto Raptors,PF,61,13,1006,89,233,0.382,45,137,0.328,44,96,0.458,0.479,44,55,0.8,29,124,153,89,52,18,54,116,267,Stanley Johnson
2021-2022,Los Angeles Lakers,PF,48,27,1094,117,251,0.466,33,105,0.314,84,146,0.575,0.532,53,74,0.716,34,121,155,80,43,14,35,109,320,Stanley Johnson
2022-2023,San Antonio Spurs,SF,30,0,469,65,122,0.533,18,40,0.45,47,82,0.573,0.607,26,39,0.667,22,73,95,67,16,6,33,48,174,Stanley Johnson
2015-2016,Denver Nuggets,C,80,55,1733,307,600,0.512,28,84,0.333,279,516,0.541,0.535,154,190,0.811,181,379,560,189,79,50,104,208,796,Nikola Jokić
2016-2017,Denver Nuggets,C,73,59,2038,494,854,0.578,45,139,0.324,449,715,0.628,0.605,188,228,0.825,212,506,718,359,61,55,171,214,1221,Nikola Jokić
2017-2018,Denver Nuggets,C,75,73,2443,504,1010,0.499,111,280,0.396,393,730,0.538,0.554,266,313,0.85,195,608,803,458,90,61,210,212,1385,Nikola Jokić
2018-2019,Denver Nuggets,C,80,80,2504,616,1206,0.511,83,270,0.307,533,936,0.569,0.545,289,352,0.821,228,637,865,580,108,55,248,228,1604,Nikola Jokić
2019-2020,Denver Nuggets,C,73,73,2336,565,1071,0.528,80,255,0.314,485,816,0.594,0.565,246,301,0.817,166,545,711,512,85,44,226,222,1456,Nikola Jokić
2020-2021,Denver Nuggets,C,72,72,2488,732,1293,0.566,92,237,0.388,640,1056,0.606,0.602,342,394,0.868,205,575,780,599,95,48,222,192,1898,Nikola Jokić
2021-2022,Denver Nuggets,C,74,74,2476,764,1311,0.583,97,288,0.337,667,1023,0.652,0.62,379,468,0.81,206,813,1019,584,109,63,281,191,2004,Nikola Jokić
2022-2023,Denver Nuggets,C,69,69,2323,646,1022,0.632,57,149,0.383,589,873,0.675,0.66,341,415,0.822,167,650,817,678,87,47,247,174,1690,Nikola Jokić
2023-2024,Denver Nuggets,C,79,79,2737,822,1411,0.583,83,231,0.359,739,1180,0.626,0.612,358,438,0.817,223,753,976,708,108,68,237,194,2085,Nikola Jokić
2024-2025,Denver Nuggets,C,26,26,965,305,536,0.569,57,117,0.487,248,419,0.592,0.622,127,160,0.794,89,240,329,248,45,16,91,53,794,Nikola Jokić
2021-2022,Total,PG,5,0,23,1,9,0.111,0,1,0,1,8,0.125,0.111,2,2,1,1,2,3,5,1,0,3,0,4,Carlik Jones
2021-2022,Dallas Mavericks,PG,3,0,19,0,7,0,0,1,0,0,6,0,0,2,2,1,1,2,3,5,1,0,3,0,2,Carlik Jones
2021-2022,Denver Nuggets,PG,2,0,4,1,2,0.5,0,0,,1,2,0.5,0.5,0,0,,0,0,0,0,0,0,0,0,2,Carlik Jones
2022-2023,Chicago Bulls,PG,7,0,56,6,15,0.4,3,6,0.5,3,9,0.333,0.5,5,8,0.625,1,4,5,6,2,0,2,2,20,Carlik Jones
2023-2024,Sacramento Kings,SG,30,0,192,28,71,0.394,2,22,0.091,26,49,0.531,0.408,6,11,0.545,17,23,40,20,7,5,10,29,64,Colby Jones
2024-2025,Sacramento Kings,SG,20,0,117,10,24,0.417,4,9,0.444,6,15,0.4,0.5,0,0,,6,14,20,5,5,5,7,13,24,Colby Jones
2016-2017,Golden State Warriors,C,10,0,85,8,16,0.5,0,0,,8,16,0.5,0.5,3,10,0.3,9,14,23,0,1,4,6,15,19,Damian Jones
2017-2018,Golden State Warriors,C,15,0,89,11,22,0.5,0,0,,11,22,0.5,0.5,3,5,0.6,5,9,14,2,1,3,4,14,25,Damian Jones
2018-2019,Golden State Warriors,C,24,22,410,53,74,0.716,0,0,,53,74,0.716,0.716,24,37,0.649,31,44,75,28,12,25,16,63,130,Damian Jones
2019-2020,Atlanta Hawks,C,55,27,887,121,178,0.68,2,9,0.222,119,169,0.704,0.685,62,84,0.738,74,132,206,35,26,40,28,149,306,Damian Jones
2020-2021,Total,C,39,10,547,70,103,0.68,1,5,0.2,69,98,0.704,0.684,42,58,0.724,36,85,121,29,11,29,26,77,183,Damian Jones
2020-2021,Phoenix Suns,C,14,0,94,8,16,0.5,0,1,0,8,15,0.533,0.5,6,11,0.545,7,11,18,4,1,5,6,19,22,Damian Jones
2020-2021,Los Angeles Lakers,C,8,6,112,16,17,0.941,0,0,,16,17,0.941,0.941,11,12,0.917,8,18,26,1,1,7,5,22,43,Damian Jones
2020-2021,Sacramento Kings,C,17,4,341,46,70,0.657,1,4,0.25,45,66,0.682,0.664,25,35,0.714,21,56,77,24,9,17,15,36,118,Damian Jones
2021-2022,Sacramento Kings,C,56,15,1017,175,266,0.658,10,29,0.345,165,237,0.696,0.677,94,131,0.718,75,171,246,69,26,47,59,130,454,Damian Jones
2022-2023,Total,C,41,1,477,55,86,0.64,10,17,0.588,45,69,0.652,0.698,22,29,0.759,42,80,122,15,8,21,23,55,142,Damian Jones
2022-2023,Los Angeles Lakers,C,22,1,176,20,37,0.541,0,3,0,20,34,0.588,0.541,15,20,0.75,18,37,55,4,3,12,9,17,55,Damian Jones
2022-2023,Utah Jazz,C,19,0,301,35,49,0.714,10,14,0.714,25,35,0.714,0.816,7,9,0.778,24,43,67,11,5,9,14,38,87,Damian Jones
2023-2024,Cleveland Cavaliers,C,39,0,270,43,72,0.597,3,14,0.214,40,58,0.69,0.618,18,21,0.857,20,42,62,15,7,13,13,27,107,Damian Jones
2016-2017,Phoenix Suns,SF,32,8,545,68,121,0.562,3,11,0.273,65,110,0.591,0.574,29,41,0.707,39,40,79,12,14,13,13,63,168,Derrick Jones Jr.
2017-2018,Total,SF,20,8,245,21,53,0.396,3,18,0.167,18,35,0.514,0.425,16,24,0.667,21,17,38,9,4,13,7,24,61,Derrick Jones Jr.
2017-2018,Phoenix Suns,SF,6,0,33,2,4,0.5,0,2,0,2,2,1,0.5,5,6,0.833,2,2,4,3,1,4,1,2,9,Derrick Jones Jr.
2017-2018,Miami Heat,SF,14,8,212,19,49,0.388,3,16,0.188,16,33,0.485,0.418,11,18,0.611,19,15,34,6,3,9,6,22,52,Derrick Jones Jr.
2018-2019,Miami Heat,SF,60,14,1153,160,324,0.494,28,91,0.308,132,233,0.567,0.537,74,122,0.607,96,144,240,37,46,42,43,123,422,Derrick Jones Jr.
2019-2020,Miami Heat,SF,59,16,1375,184,349,0.527,37,132,0.28,147,217,0.677,0.58,95,123,0.772,66,167,233,62,58,38,30,130,500,Derrick Jones Jr.
2020-2021,Portland Trail Blazers,SF,58,43,1318,147,304,0.484,43,136,0.316,104,168,0.619,0.554,59,91,0.648,77,128,205,47,37,54,32,127,396,Derrick Jones Jr.
2021-2022,Chicago Bulls,PF,51,8,899,105,195,0.538,20,61,0.328,85,134,0.634,0.59,56,70,0.8,60,109,169,30,25,33,30,105,286,Derrick Jones Jr.
2022-2023,Chicago Bulls,PF,64,0,893,115,230,0.5,27,80,0.338,88,150,0.587,0.559,62,84,0.738,60,93,153,34,29,37,25,86,319,Derrick Jones Jr.
2023-2024,Dallas Mavericks,SF,76,66,1783,239,495,0.483,82,239,0.343,157,256,0.613,0.566,97,136,0.713,82,168,250,75,53,51,65,121,657,Derrick Jones Jr.
2024-2025,Los Angeles Clippers,SF,29,29,714,114,227,0.502,32,82,0.39,82,145,0.566,0.573,30,34,0.882,34,63,97,27,38,10,29,60,290,Derrick Jones Jr.
2024-2025,Oklahoma City Thunder,SF,23,0,183,19,56,0.339,7,33,0.212,12,23,0.522,0.402,6,10,0.6,16,26,42,15,4,1,8,20,51,Dillon Jones
2021-2022,New Orleans Pelicans,PF,78,69,2335,274,576,0.476,57,169,0.337,217,407,0.533,0.525,137,163,0.84,98,198,296,167,130,60,100,238,742,Herbert Jones
2022-2023,New Orleans Pelicans,PF,66,66,1951,235,501,0.469,56,167,0.335,179,334,0.536,0.525,123,161,0.764,97,172,269,162,103,42,88,208,649,Herbert Jones
2023-2024,New Orleans Pelicans,SF,76,76,2321,293,588,0.498,114,273,0.418,179,315,0.568,0.595,137,158,0.867,74,198,272,199,105,62,93,224,837,Herbert Jones
2024-2025,New Orleans Pelicans,SF,14,14,455,55,131,0.42,15,55,0.273,40,76,0.526,0.477,23,30,0.767,20,39,59,43,28,7,27,45,148,Herbert Jones
2024-2025,Sacramento Kings,PF,20,0,172,32,48,0.667,1,4,0.25,31,44,0.705,0.677,11,20,0.55,10,21,31,4,2,8,11,22,76,Isaac Jones
2018-2019,Los Angeles Lakers,SF,6,2,143,12,33,0.364,2,10,0.2,10,23,0.435,0.394,1,2,0.5,16,33,49,13,7,5,5,10,27,Jemerrio Jones
2021-2022,Los Angeles Lakers,SF,2,0,15,2,3,0.667,0,0,,2,3,0.667,0.667,0,0,,2,1,3,0,1,0,0,2,4,Jemerrio Jones
2021-2022,Charlotte Hornets,C,21,0,63,9,14,0.643,1,2,0.5,8,12,0.667,0.679,3,8,0.375,3,8,11,4,1,2,6,8,22,Kai Jones
2022-2023,Charlotte Hornets,C,46,0,550,67,120,0.558,4,19,0.211,63,101,0.624,0.575,19,26,0.731,37,86,123,15,17,30,31,65,157,Kai Jones
2024-2025,Los Angeles Clippers,C,20,0,154,15,20,0.75,0,0,,15,20,0.75,0.75,9,12,0.75,12,22,34,8,6,9,8,19,39,Kai Jones
2020-2021,Total,SG,32,1,334,52,123,0.423,24,66,0.364,28,57,0.491,0.52,40,64,0.625,7,48,55,42,7,1,29,24,168,Mason Jones
2020-2021,Houston Rockets,SG,26,1,307,47,114,0.412,23,64,0.359,24,50,0.48,0.513,35,57,0.614,4,47,51,39,6,1,28,22,152,Mason Jones
2020-2021,Philadelphia 76ers,SG,6,0,27,5,9,0.556,1,2,0.5,4,7,0.571,0.611,5,7,0.714,3,1,4,3,1,0,1,2,16,Mason Jones
2021-2022,Los Angeles Lakers,SG,4,0,51,7,15,0.467,1,4,0.25,6,11,0.545,0.5,12,15,0.8,1,9,10,4,2,0,1,8,27,Mason Jones
2023-2024,Sacramento Kings,SG,5,0,28,2,8,0.25,2,7,0.286,0,1,0,0.375,1,2,0.5,1,4,5,5,1,0,2,3,7,Mason Jones
2024-2025,Sacramento Kings,SG,3,0,13,0,2,0,0,2,0,0,0,,0,0,0,,1,3,4,7,0,0,0,1,0,Mason Jones
2024-2025,Denver Nuggets,SF,4,0,9,0,2,0,0,2,0,0,0,0,0,0,0,3,3,0,2,0,1,1,0,0,,Spencer Jones
2020-2021,San Antonio Spurs,PG,37,1,269,37,78,0.474,3,5,0.6,34,73,0.466,0.494,17,19,0.895,8,13,21,39,8,0,13,13,94,Tre Jones
2021-2022,San Antonio Spurs,PG,69,11,1148,166,339,0.49,10,51,0.196,156,288,0.542,0.504,71,91,0.78,29,126,155,233,42,7,46,78,413,Tre Jones
2022-2023,San Antonio Spurs,PG,68,65,1984,341,743,0.459,45,158,0.285,296,585,0.506,0.489,148,172,0.86,56,189,245,448,89,9,110,98,875,Tre Jones
2023-2024,San Antonio Spurs,PG,77,48,2138,303,600,0.505,64,191,0.335,239,409,0.584,0.558,101,118,0.856,58,231,289,478,78,9,116,92,771,Tre Jones
2024-2025,San Antonio Spurs,PG,13,0,219,16,40,0.4,3,14,0.214,13,26,0.5,0.438,13,17,0.765,6,19,25,53,10,4,9,17,48,Tre Jones
2015-2016,Minnesota Timberwolves,PG,37,0,573,56,156,0.359,16,53,0.302,40,103,0.388,0.41,28,39,0.718,7,40,47,108,31,3,33,33,156,Tyus Jones
2016-2017,Minnesota Timberwolves,PG,60,0,774,75,181,0.414,26,73,0.356,49,108,0.454,0.486,33,43,0.767,10,57,67,156,48,5,38,50,209,Tyus Jones
2017-2018,Minnesota Timberwolves,PG,82,11,1467,150,328,0.457,45,129,0.349,105,199,0.528,0.526,71,81,0.877,16,116,132,232,95,6,59,110,416,Tyus Jones
2018-2019,Minnesota Timberwolves,PG,68,23,1560,185,446,0.415,40,126,0.317,145,320,0.453,0.46,58,69,0.841,23,111,134,327,81,5,47,78,468,Tyus Jones
2019-2020,Memphis Grizzlies,PG,65,6,1232,197,429,0.459,47,124,0.379,150,305,0.492,0.514,43,58,0.741,9,94,103,285,59,6,55,44,484,Tyus Jones
2020-2021,Memphis Grizzlies,PG,70,9,1222,178,413,0.431,45,140,0.321,133,273,0.487,0.485,41,45,0.911,21,119,140,259,64,6,48,31,442,Tyus Jones
2021-2022,Memphis Grizzlies,PG,73,23,1549,249,552,0.451,80,205,0.39,169,347,0.487,0.524,54,66,0.818,17,159,176,324,66,2,46,32,632,Tyus Jones
2022-2023,Memphis Grizzlies,PG,80,22,1940,311,710,0.438,121,326,0.371,190,384,0.495,0.523,80,100,0.8,28,172,200,417,83,6,74,32,823,Tyus Jones
2023-2024,Washington Wizards,PG,66,66,1933,326,666,0.489,106,256,0.414,220,410,0.537,0.569,32,40,0.8,20,159,179,485,71,18,66,48,790,Tyus Jones
2024-2025,Phoenix Suns,PG,30,30,941,143,285,0.502,69,157,0.439,74,128,0.578,0.623,19,22,0.864,17,58,75,193,29,5,35,31,374,Tyus Jones
2008-2009,Los Angeles Clippers,C,53,13,771,93,147,0.633,0,0,,93,147,0.633,0.633,42,109,0.385,72,165,237,11,11,59,41,96,228,DeAndre Jordan
2009-2010,Los Angeles Clippers,C,70,12,1137,144,238,0.605,0,2,0,144,236,0.61,0.605,48,128,0.375,122,230,352,21,16,62,75,152,336,DeAndre Jordan
2010-2011,Los Angeles Clippers,C,80,66,2047,234,341,0.686,0,1,0,234,340,0.688,0.686,98,217,0.452,207,368,575,42,41,142,101,255,566,DeAndre Jordan
2011-2012,Los Angeles Clippers,C,66,66,1798,206,326,0.632,0,1,0,206,325,0.634,0.632,74,141,0.525,202,344,546,17,30,134,74,189,486,DeAndre Jordan
2012-2013,Los Angeles Clippers,C,82,82,2010,314,488,0.643,0,0,,314,488,0.643,0.643,96,249,0.386,210,384,594,28,48,112,100,192,724,DeAndre Jordan
2013-2014,Los Angeles Clippers,C,82,82,2870,348,515,0.676,0,0,,348,515,0.676,0.676,160,374,0.428,331,783,1114,74,80,203,123,264,856,DeAndre Jordan
2014-2015,Los Angeles Clippers,C,82,82,2820,379,534,0.71,1,4,0.25,378,530,0.713,0.711,187,471,0.397,397,829,1226,61,81,183,109,245,946,DeAndre Jordan
2015-2016,Los Angeles Clippers,C,77,77,2598,357,508,0.703,0,1,0,357,507,0.704,0.703,266,619,0.43,267,792,1059,90,51,177,107,207,980,DeAndre Jordan
2016-2017,Los Angeles Clippers,C,81,81,2570,412,577,0.714,0,2,0,412,575,0.717,0.714,205,425,0.482,298,816,1114,96,51,134,115,212,1029,DeAndre Jordan
2017-2018,Los Angeles Clippers,C,77,77,2424,373,578,0.645,0,0,,373,578,0.645,0.645,181,312,0.58,329,842,1171,117,39,71,137,203,927,DeAndre Jordan
2018-2019,Total,C,69,69,2047,286,446,0.641,0,0,,286,446,0.641,0.641,186,264,0.705,225,677,902,156,42,73,153,167,758,DeAndre Jordan
2018-2019,Dallas Mavericks,C,50,50,1554,208,323,0.644,0,0,,208,323,0.644,0.644,135,198,0.682,161,525,686,99,33,53,111,125,551,DeAndre Jordan
2018-2019,New York Knicks,C,19,19,493,78,123,0.634,0,0,,78,123,0.634,0.634,51,66,0.773,64,152,216,57,9,20,42,42,207,DeAndre Jordan
2019-2020,Brooklyn Nets,C,56,6,1234,191,287,0.666,0,0,,191,287,0.666,0.666,83,122,0.68,141,420,561,105,18,52,74,114,465,DeAndre Jordan
2020-2021,Brooklyn Nets,C,57,43,1246,190,249,0.763,0,1,0,190,248,0.766,0.763,46,92,0.5,117,310,427,93,17,65,85,116,426,DeAndre Jordan
2021-2022,Total,C,48,20,622,92,143,0.643,0,0,,92,143,0.643,0.643,22,40,0.55,83,181,264,21,12,35,37,71,206,DeAndre Jordan
2021-2022,Los Angeles Lakers,C,32,19,408,60,89,0.674,0,0,,60,89,0.674,0.674,12,26,0.462,51,121,172,13,10,26,21,50,132,DeAndre Jordan
2021-2022,Philadelphia 76ers,C,16,1,214,32,54,0.593,0,0,,32,54,0.593,0.593,10,14,0.714,32,60,92,8,2,9,16,21,74,DeAndre Jordan
2022-2023,Denver Nuggets,C,39,8,586,88,115,0.765,1,1,1,87,114,0.763,0.77,22,48,0.458,52,150,202,34,12,23,48,71,199,DeAndre Jordan
2023-2024,Denver Nuggets,C,36,2,396,58,93,0.624,0,0,,58,93,0.624,0.624,26,53,0.491,54,103,157,26,6,16,23,56,142,DeAndre Jordan
2024-2025,Denver Nuggets,C,17,0,179,23,37,0.622,0,0,,23,37,0.622,0.622,2,9,0.222,18,51,69,15,5,8,12,22,48,DeAndre Jordan
2011-2012,San Antonio Spurs,PG,29,1,266,22,70,0.314,3,15,0.2,19,55,0.345,0.336,11,17,0.647,5,20,25,34,7,3,12,16,58,Cory Joseph
2012-2013,San Antonio Spurs,PG,28,9,388,51,110,0.464,6,21,0.286,45,89,0.506,0.491,18,21,0.857,12,40,52,53,15,4,21,25,126,Cory Joseph
2013-2014,San Antonio Spurs,SG,68,19,936,126,265,0.475,12,38,0.316,114,227,0.502,0.498,79,96,0.823,32,75,107,114,35,14,43,84,343,Cory Joseph
2014-2015,San Antonio Spurs,PG,79,14,1444,207,411,0.504,16,44,0.364,191,367,0.52,0.523,105,143,0.734,44,148,192,188,46,17,67,105,535,Cory Joseph
2015-2016,Toronto Raptors,SG,80,4,2046,257,585,0.439,30,110,0.273,227,475,0.478,0.465,133,174,0.764,39,171,210,250,63,20,102,131,677,Cory Joseph
2016-2017,Toronto Raptors,PG,80,22,2003,299,661,0.452,48,135,0.356,251,526,0.477,0.489,94,122,0.77,51,184,235,265,66,13,108,140,740,Cory Joseph
2017-2018,Indiana Pacers,PG,82,17,2210,256,604,0.424,67,190,0.353,189,414,0.457,0.479,70,94,0.745,39,224,263,260,80,18,87,141,649,Cory Joseph
2018-2019,Indiana Pacers,PG,82,9,2063,226,548,0.412,55,171,0.322,171,377,0.454,0.463,30,43,0.698,39,240,279,321,94,22,80,131,537,Cory Joseph
2019-2020,Sacramento Kings,PG,72,26,1759,171,412,0.415,56,159,0.352,115,253,0.455,0.483,60,70,0.857,44,144,188,251,53,21,80,133,458,Cory Joseph
2020-2021,Total,PG,63,13,1446,200,426,0.469,45,132,0.341,155,294,0.527,0.522,72,88,0.818,35,124,159,213,61,18,79,139,517,Cory Joseph
2020-2021,Sacramento Kings,PG,44,2,944,111,250,0.444,31,94,0.33,80,156,0.513,0.506,36,47,0.766,25,74,99,108,39,9,44,98,289,Cory Joseph
2020-2021,Detroit Pistons,PG,19,11,502,89,176,0.506,14,38,0.368,75,138,0.543,0.545,36,41,0.878,10,50,60,105,22,9,35,41,228,Cory Joseph
2021-2022,Detroit Pistons,PG,65,39,1600,178,400,0.445,65,157,0.414,113,243,0.465,0.526,100,113,0.885,29,145,174,237,42,17,85,147,521,Cory Joseph
2022-2023,Detroit Pistons,PG,62,2,1227,150,351,0.427,70,180,0.389,80,171,0.468,0.527,57,72,0.792,21,85,106,217,34,9,56,88,427,Cory Joseph
2023-2024,Golden State Warriors,PG,26,0,296,23,64,0.359,13,42,0.31,10,22,0.455,0.461,4,7,0.571,6,24,30,42,4,3,12,25,63,Cory Joseph
2024-2025,Orlando Magic,PG,18,0,102,10,30,0.333,7,20,0.35,3,10,0.3,0.45,0,0,,4,13,17,12,6,2,4,7,27,Cory Joseph
2022-2023,Miami Heat,PF,15,8,204,28,69,0.406,8,35,0.229,20,34,0.588,0.464,18,19,0.947,9,22,31,10,7,2,10,19,82,Nikola Jović
2023-2024,Miami Heat,PF,46,38,896,127,281,0.452,65,163,0.399,62,118,0.525,0.568,33,47,0.702,25,167,192,90,25,14,42,82,352,Nikola Jović
2024-2025,Miami Heat,PF,19,9,373,53,118,0.449,23,61,0.377,30,57,0.526,0.547,30,38,0.789,8,58,66,28,18,2,13,28,159,Nikola Jović
2022-2023,Utah Jazz,SG,18,0,232,35,104,0.337,15,63,0.238,20,41,0.488,0.409,2,4,0.5,8,31,39,8,4,3,3,13,87,Johnny Juzang
2023-2024,Utah Jazz,SG,20,5,372,51,110,0.464,32,77,0.416,19,33,0.576,0.609,10,14,0.714,7,29,36,23,4,2,13,29,144,Johnny Juzang
2024-2025,Utah Jazz,SG,25,0,418,57,139,0.41,40,101,0.396,17,38,0.447,0.554,14,17,0.824,13,43,56,24,10,4,13,45,168,Johnny Juzang
2019-2020,Los Angeles Clippers,C,12,0,64,14,32,0.438,9,20,0.45,5,12,0.417,0.578,5,5,1,1,10,11,2,2,2,2,9,42,Mfiondu Kabengele
2020-2021,Total,PF,39,0,280,33,89,0.371,13,50,0.26,20,39,0.513,0.444,16,20,0.8,12,48,60,17,8,13,15,36,95,Mfiondu Kabengele
2020-2021,Los Angeles Clippers,PF,23,0,94,9,32,0.281,4,18,0.222,5,14,0.357,0.344,5,6,0.833,1,13,14,5,2,3,6,18,27,Mfiondu Kabengele
2020-2021,Cleveland Cavaliers,PF,16,0,186,24,57,0.421,9,32,0.281,15,25,0.6,0.5,11,14,0.786,11,35,46,12,6,10,9,18,68,Mfiondu Kabengele
2022-2023,Boston Celtics,PF,4,0,36,2,7,0.286,0,3,0,2,4,0.5,0.286,2,2,1,5,5,10,0,2,0,1,3,6,Mfiondu Kabengele
2015-2016,Charlotte Hornets,C,81,3,1708,215,525,0.41,68,202,0.337,147,323,0.455,0.474,108,148,0.73,69,266,335,98,38,43,58,126,606,Frank Kaminsky
2016-2017,Charlotte Hornets,C,75,16,1954,320,802,0.399,116,354,0.328,204,448,0.455,0.471,118,156,0.756,57,279,336,162,46,34,76,139,874,Frank Kaminsky
2017-2018,Charlotte Hornets,PF,79,4,1835,307,716,0.429,104,274,0.38,203,442,0.459,0.501,155,194,0.799,46,242,288,129,36,19,66,95,873,Frank Kaminsky
2018-2019,Charlotte Hornets,C,47,0,755,138,298,0.463,50,139,0.36,88,159,0.553,0.547,79,107,0.738,39,124,163,63,12,12,41,68,405,Frank Kaminsky
2019-2020,Phoenix Suns,C,39,13,777,138,307,0.45,41,124,0.331,97,183,0.53,0.516,61,90,0.678,35,141,176,75,14,10,37,75,378,Frank Kaminsky
2020-2021,Phoenix Suns,C,47,13,715,121,257,0.471,31,85,0.365,90,172,0.523,0.531,37,60,0.617,36,152,188,79,14,17,22,70,310,Frank Kaminsky
2021-2022,Phoenix Suns,C,9,0,181,36,66,0.545,5,15,0.333,31,51,0.608,0.583,18,20,0.9,11,30,41,13,8,7,5,14,95,Frank Kaminsky
2022-2023,Total,C,36,0,235,31,63,0.492,13,33,0.394,18,30,0.6,0.595,14,16,0.875,7,45,52,32,6,4,9,22,89,Frank Kaminsky
2022-2023,Atlanta Hawks,C,26,0,176,25,44,0.568,11,23,0.478,14,21,0.667,0.693,10,12,0.833,3,33,36,21,5,1,9,21,71,Frank Kaminsky
2022-2023,Houston Rockets,C,10,0,59,6,19,0.316,2,10,0.2,4,9,0.444,0.368,4,4,1,4,12,16,11,1,3,0,1,18,Frank Kaminsky
2024-2025,Memphis Grizzlies,PG,14,0,41,4,15,0.267,2,11,0.182,2,4,0.5,0.333,4,6,0.667,0,2,2,8,1,0,4,4,14,Yuki Kawamura
2022-2023,New York Knicks,SG,3,0,8,1,4,0.25,1,4,0.25,0,0,0.375,0,0,0,2,2,0,0,0,0,0,3,0,,Trevor Keels
2017-2018,Detroit Pistons,SG,73,9,1463,206,465,0.443,81,195,0.415,125,270,0.463,0.53,65,76,0.855,21,155,176,124,44,13,69,86,558,Luke Kennard
2018-2019,Detroit Pistons,SG,63,10,1437,228,520,0.438,106,269,0.394,122,251,0.486,0.54,51,61,0.836,12,171,183,114,26,10,57,92,613,Luke Kennard
2019-2020,Detroit Pistons,SG,28,25,922,151,342,0.442,73,183,0.399,78,159,0.491,0.548,67,75,0.893,9,89,98,115,12,6,43,65,442,Luke Kennard
2020-2021,Los Angeles Clippers,SG,63,17,1232,197,414,0.476,100,224,0.446,97,190,0.511,0.597,26,31,0.839,15,146,161,104,23,9,48,91,520,Luke Kennard
2021-2022,Los Angeles Clippers,SG,70,13,1919,287,639,0.449,190,423,0.449,97,216,0.449,0.598,69,77,0.896,20,209,229,146,42,6,60,101,833,Luke Kennard
2022-2023,Total,SG,59,14,1315,188,382,0.492,133,269,0.494,55,113,0.487,0.666,37,39,0.949,15,143,158,91,32,5,46,82,546,Luke Kennard
2022-2023,Los Angeles Clippers,SG,35,11,725,98,211,0.464,59,132,0.447,39,79,0.494,0.604,19,20,0.95,6,77,83,37,19,4,30,47,274,Luke Kennard
2022-2023,Memphis Grizzlies,SG,24,3,590,90,171,0.526,74,137,0.54,16,34,0.471,0.743,18,19,0.947,9,66,75,54,13,1,16,35,272,Luke Kennard
2023-2024,Memphis Grizzlies,SG,39,22,999,141,315,0.448,107,238,0.45,34,77,0.442,0.617,40,45,0.889,11,102,113,136,20,2,54,39,429,Luke Kennard
2024-2025,Memphis Grizzlies,SG,20,0,397,47,111,0.423,36,81,0.444,11,30,0.367,0.586,19,23,0.826,8,38,46,58,12,2,16,15,149,Luke Kennard
2022-2023,Utah Jazz,C,74,40,1703,298,414,0.72,1,3,0.333,297,411,0.723,0.721,82,159,0.516,231,389,620,69,26,173,58,169,679,Walker Kessler
2023-2024,Utah Jazz,C,64,22,1493,229,350,0.654,4,19,0.211,225,331,0.68,0.66,56,93,0.602,165,316,481,60,30,154,66,132,518,Walker Kessler
2024-2025,Utah Jazz,C,23,23,677,101,144,0.701,2,3,0.667,99,141,0.702,0.708,33,62,0.532,92,159,251,37,12,66,31,48,237,Walker Kessler
2021-2022,Total,SF,11,0,197,33,72,0.458,6,21,0.286,27,51,0.529,0.5,7,13,0.538,13,37,50,11,10,11,11,26,79,Braxton Key
2021-2022,Philadelphia 76ers,SF,2,0,6,1,2,0.5,0,1,0,1,1,1,0.5,0,0,,1,1,2,1,1,0,2,1,2,Braxton Key
2021-2022,Detroit Pistons,SF,9,0,191,32,70,0.457,6,20,0.3,26,50,0.52,0.5,7,13,0.538,12,36,48,10,9,11,9,25,77,Braxton Key
2022-2023,Detroit Pistons,SF,3,0,9,1,1,1,0,0,,1,1,1,1,2,2,1,0,1,1,0,0,0,0,0,4,Braxton Key
2023-2024,Denver Nuggets,SF,20,0,60,7,17,0.412,2,5,0.4,5,12,0.417,0.471,6,8,0.75,3,15,18,9,2,1,1,5,22,Braxton Key
2018-2019,Phoenix Suns,SF,1,0,6,0,0,,0,0,,0,0,,,0,0,,0,1,1,0,0,0,0,0,0,George King
2021-2022,Dallas Mavericks,SF,4,0,19,0,5,0,0,4,0,0,1,0,0,1,2,0.5,0,5,5,0,0,0,1,4,1,George King
2019-2020,Detroit Pistons,SF,10,0,62,8,21,0.381,4,11,0.364,4,10,0.4,0.476,0,3,0,1,9,10,5,2,0,2,10,20,Louis King
2020-2021,Sacramento Kings,SF,6,1,85,17,34,0.5,4,11,0.364,13,23,0.565,0.559,6,6,1,5,13,18,9,7,3,4,9,44,Louis King
2021-2022,Sacramento Kings,SF,10,0,104,15,47,0.319,8,27,0.296,7,20,0.35,0.404,7,10,0.7,0,12,12,9,2,1,0,14,45,Louis King
2022-2023,Philadelphia 76ers,PF,1,0,29,8,13,0.615,4,8,0.5,4,5,0.8,0.769,0,1,0,2,2,4,2,1,0,2,4,20,Louis King
2021-2022,Washington Wizards,SF,77,36,1801,234,514,0.455,112,320,0.35,122,194,0.629,0.564,54,62,0.871,53,156,209,85,35,22,50,93,634,Corey Kispert
2022-2023,Washington Wizards,SF,74,45,2093,291,585,0.497,163,384,0.424,128,201,0.637,0.637,75,88,0.852,33,174,207,87,32,9,55,97,820,Corey Kispert
2023-2024,Washington Wizards,SF,80,22,2067,386,794,0.486,184,480,0.383,202,314,0.643,0.602,114,157,0.726,30,195,225,156,41,16,98,141,1070,Corey Kispert
2024-2025,Washington Wizards,SF,23,0,626,94,218,0.431,45,134,0.336,49,84,0.583,0.534,24,28,0.857,8,68,76,36,12,5,26,40,257,Corey Kispert
2017-2018,Dallas Mavericks,PF,72,35,1206,151,309,0.489,40,128,0.313,111,181,0.613,0.553,44,59,0.746,71,163,234,51,26,47,30,114,386,Maxi Kleber
2018-2019,Dallas Mavericks,PF,71,18,1502,175,386,0.453,77,218,0.353,98,168,0.583,0.553,58,74,0.784,90,239,329,70,36,78,54,143,485,Maxi Kleber
2019-2020,Dallas Mavericks,PF,74,21,1890,237,514,0.461,119,319,0.373,118,195,0.605,0.577,79,93,0.849,112,276,388,88,25,83,58,176,672,Maxi Kleber
2020-2021,Dallas Mavericks,PF,50,40,1341,116,275,0.422,87,212,0.41,29,63,0.46,0.58,34,37,0.919,47,213,260,68,24,35,30,105,353,Maxi Kleber
2021-2022,Dallas Mavericks,PF,59,21,1450,141,354,0.398,83,255,0.325,58,99,0.586,0.516,46,65,0.708,70,280,350,68,30,58,47,137,411,Maxi Kleber
2022-2023,Dallas Mavericks,PF,37,5,930,77,169,0.456,39,112,0.348,38,57,0.667,0.571,27,38,0.711,30,105,135,52,12,30,27,85,220,Maxi Kleber
2023-2024,Dallas Mavericks,C,43,7,871,63,146,0.432,32,92,0.348,31,54,0.574,0.541,33,47,0.702,30,113,143,68,17,30,28,79,191,Maxi Kleber
2024-2025,Dallas Mavericks,PF,19,2,332,17,42,0.405,5,16,0.313,12,26,0.462,0.464,9,12,0.75,10,46,56,12,5,7,13,37,48,Maxi Kleber
2024-2025,Los Angeles Lakers,SF,30,12,670,111,237,0.468,52,142,0.366,59,95,0.621,0.578,24,32,0.75,20,87,107,33,13,2,17,41,298,Dalton Knecht
2020-2021,Atlanta Hawks,PF,33,0,279,37,100,0.37,6,33,0.182,31,67,0.463,0.4,44,55,0.8,27,45,72,8,9,10,15,22,124,Nathan Knight
2021-2022,Minnesota Timberwolves,PF,37,2,267,45,88,0.511,4,13,0.308,41,75,0.547,0.534,44,60,0.733,32,53,85,22,7,8,18,42,138,Nathan Knight
2022-2023,Minnesota Timberwolves,C,38,0,291,46,81,0.568,8,22,0.364,38,59,0.644,0.617,39,57,0.684,22,34,56,13,10,6,21,41,139,Nathan Knight
2018-2019,New York Knicks,PF,75,57,2158,338,914,0.37,125,364,0.343,213,550,0.387,0.438,162,226,0.717,61,274,335,82,43,24,114,175,963,Kevin Knox
2019-2020,New York Knicks,SF,65,4,1166,144,401,0.359,65,199,0.327,79,202,0.391,0.44,66,101,0.653,28,156,184,61,23,28,45,106,419,Kevin Knox
2020-2021,New York Knicks,SF,42,0,464,56,143,0.392,35,89,0.393,21,54,0.389,0.514,16,20,0.8,10,51,61,19,12,6,17,37,163,Kevin Knox
2021-2022,Total,SF,30,0,222,31,85,0.365,15,54,0.278,16,31,0.516,0.453,16,22,0.727,14,30,44,10,4,2,7,19,93,Kevin Knox
2021-2022,New York Knicks,SF,13,0,111,15,40,0.375,10,28,0.357,5,12,0.417,0.5,7,10,0.7,8,14,22,3,2,1,5,5,47,Kevin Knox
2021-2022,Atlanta Hawks,SF,17,0,111,16,45,0.356,5,26,0.192,11,19,0.579,0.411,9,12,0.75,6,16,22,7,2,1,2,14,46,Kevin Knox
2022-2023,Total,SF,63,5,952,152,332,0.458,65,186,0.349,87,146,0.596,0.556,46,60,0.767,34,143,177,33,24,12,50,95,415,Kevin Knox
2022-2023,Detroit Pistons,SF,42,1,593,84,179,0.469,43,116,0.371,41,63,0.651,0.589,26,33,0.788,20,88,108,15,14,12,32,74,237,Kevin Knox
2022-2023,Portland Trail Blazers,PF,21,4,359,68,153,0.444,22,70,0.314,46,83,0.554,0.516,20,27,0.741,14,55,69,18,10,0,18,21,178,Kevin Knox
2023-2024,Detroit Pistons,SF,31,11,560,86,186,0.462,31,94,0.33,55,92,0.598,0.546,20,22,0.909,18,57,75,23,13,7,22,50,223,Kevin Knox
2024-2025,New York Knicks,PG,18,0,113,16,39,0.41,10,23,0.435,6,16,0.375,0.538,4,4,1,2,10,12,11,6,1,7,10,46,Tyler Kolek
2022-2023,Toronto Raptors,C,58,19,802,72,150,0.48,1,12,0.083,71,138,0.514,0.483,37,59,0.627,84,87,171,31,21,57,20,128,182,Christian Koloko
2024-2025,Los Angeles Lakers,C,19,0,178,15,25,0.6,0,2,0,15,23,0.652,0.6,3,4,0.75,17,27,44,4,5,8,6,23,33,Christian Koloko
2019-2020,Memphis Grizzlies,SG,19,0,181,24,37,0.649,5,10,0.5,19,27,0.704,0.716,1,2,0.5,18,29,47,22,7,3,7,7,54,John Konchar
2020-2021,Memphis Grizzlies,SG,43,0,575,69,138,0.5,21,56,0.375,48,82,0.585,0.576,25,30,0.833,35,93,128,47,30,9,18,40,184,John Konchar
2021-2022,Memphis Grizzlies,SG,72,7,1292,135,262,0.515,52,126,0.413,83,136,0.61,0.615,27,49,0.551,87,242,329,109,45,22,29,90,349,John Konchar
2022-2023,Memphis Grizzlies,SF,72,23,1494,138,320,0.431,60,177,0.339,78,143,0.545,0.525,28,36,0.778,64,246,310,100,77,25,37,112,364,John Konchar
2023-2024,Memphis Grizzlies,SF,55,23,1173,88,208,0.423,38,120,0.317,50,88,0.568,0.514,21,25,0.84,72,185,257,110,51,51,46,76,235,John Konchar
2024-2025,Memphis Grizzlies,SG,17,0,203,16,33,0.485,12,28,0.429,4,5,0.8,0.667,3,4,0.75,14,34,48,19,9,7,8,14,47,John Konchar
2017-2018,Philadelphia 76ers,SG,14,0,80,8,28,0.286,5,17,0.294,3,11,0.273,0.375,2,4,0.5,2,9,11,4,2,1,2,12,23,Furkan Korkmaz
2018-2019,Philadelphia 76ers,SG,48,7,679,98,245,0.4,47,144,0.326,51,101,0.505,0.496,36,44,0.818,16,91,107,52,29,2,25,62,279,Furkan Korkmaz
2019-2020,Philadelphia 76ers,SG,72,12,1559,242,563,0.43,143,356,0.402,99,207,0.478,0.557,77,102,0.755,18,150,168,79,41,16,59,98,704,Furkan Korkmaz
2020-2021,Philadelphia 76ers,SG,55,11,1062,170,424,0.401,101,269,0.375,69,155,0.445,0.52,60,82,0.732,17,96,113,82,49,9,46,64,501,Furkan Korkmaz
2021-2022,Philadelphia 76ers,SG,67,19,1414,182,470,0.387,77,266,0.289,105,204,0.515,0.469,68,84,0.81,22,153,175,127,33,9,48,58,509,Furkan Korkmaz
2022-2023,Philadelphia 76ers,SG,37,0,353,48,111,0.432,18,46,0.391,30,65,0.462,0.514,26,36,0.722,6,36,42,22,10,3,24,18,140,Furkan Korkmaz
2023-2024,Philadelphia 76ers,SG,35,0,300,30,76,0.395,14,40,0.35,16,36,0.444,0.487,14,20,0.7,4,26,30,25,14,3,10,17,88,Furkan Korkmaz
2017-2018,New York Knicks,C,20,1,326,49,125,0.392,28,79,0.354,21,46,0.457,0.504,8,11,0.727,11,53,64,26,6,16,12,28,134,Luke Kornet
2018-2019,New York Knicks,C,46,18,784,107,283,0.378,70,193,0.363,37,90,0.411,0.502,38,46,0.826,28,107,135,54,27,42,25,41,322,Luke Kornet
2019-2020,Chicago Bulls,C,36,14,559,82,187,0.439,31,108,0.287,51,79,0.646,0.521,20,28,0.714,22,62,84,32,11,26,14,54,215,Luke Kornet
2020-2021,Total,C,31,2,348,44,101,0.436,15,59,0.254,29,42,0.69,0.51,3,6,0.5,14,53,67,24,4,32,7,20,106,Luke Kornet
2020-2021,Chicago Bulls,C,13,0,94,9,27,0.333,6,23,0.261,3,4,0.75,0.444,2,4,0.5,1,14,15,4,2,7,1,1,26,Luke Kornet
2020-2021,Boston Celtics,C,18,2,254,35,74,0.473,9,36,0.25,26,38,0.684,0.534,1,2,0.5,13,39,52,20,2,25,6,19,80,Luke Kornet
2021-2022,Total,C,15,0,103,13,27,0.481,0,5,0,13,22,0.591,0.481,4,6,0.667,13,16,29,9,3,3,0,9,30,Luke Kornet
2021-2022,Cleveland Cavaliers,C,2,0,15,1,5,0.2,0,1,0,1,4,0.25,0.2,2,3,0.667,2,1,3,1,0,1,0,1,4,Luke Kornet
2021-2022,Milwaukee Bucks,C,1,0,3,0,1,0,0,0,,0,1,0,0,0,0,,1,0,1,0,0,0,0,1,0,Luke Kornet
2021-2022,Boston Celtics,C,12,0,85,12,21,0.571,0,4,0,12,17,0.706,0.571,2,3,0.667,10,15,25,8,3,2,0,7,26,Luke Kornet
2022-2023,Boston Celtics,C,69,0,804,113,170,0.665,3,13,0.231,110,157,0.701,0.674,32,39,0.821,86,111,197,53,11,46,25,81,261,Luke Kornet
2023-2024,Boston Celtics,C,63,7,983,142,203,0.7,1,1,1,141,202,0.698,0.702,49,54,0.907,118,143,261,67,23,61,21,77,334,Luke Kornet
2024-2025,Boston Celtics,C,25,3,425,44,72,0.611,0,0,,44,72,0.611,0.611,28,37,0.757,55,68,123,38,12,25,10,29,116,Luke Kornet
2021-2022,Oklahoma City Thunder,SG,30,8,690,68,167,0.407,32,98,0.327,36,69,0.522,0.503,19,22,0.864,18,83,101,57,19,8,29,65,187,Vit Krejci
2022-2023,Atlanta Hawks,PG,29,0,165,15,37,0.405,5,21,0.238,10,16,0.625,0.473,1,2,0.5,6,20,26,17,5,1,5,17,36,Vit Krejci
2023-2024,Atlanta Hawks,PG,22,14,541,51,104,0.49,28,68,0.412,23,36,0.639,0.625,5,6,0.833,11,41,52,50,13,6,20,48,135,Vit Krejci
2024-2025,Atlanta Hawks,PG,17,1,212,16,47,0.34,6,27,0.222,10,20,0.5,0.404,7,11,0.636,7,22,29,28,8,5,14,27,45,Vit Krejci
2021-2022,Golden State Warriors,SF,70,12,1185,236,460,0.513,50,149,0.336,186,311,0.598,0.567,130,190,0.684,54,180,234,64,31,22,74,146,652,Jonathan Kuminga
2022-2023,Golden State Warriors,PF,67,16,1394,261,497,0.525,54,146,0.37,207,351,0.59,0.579,90,138,0.652,70,161,231,125,41,31,95,157,666,Jonathan Kuminga
2023-2024,Golden State Warriors,PF,74,46,1949,456,862,0.529,53,165,0.321,403,697,0.578,0.56,223,299,0.746,92,263,355,163,55,36,122,169,1188,Jonathan Kuminga
2024-2025,Golden State Warriors,PF,28,10,725,166,371,0.447,33,103,0.32,133,268,0.496,0.492,86,136,0.632,37,96,133,58,26,17,44,52,451,Jonathan Kuminga
2017-2018,Los Angeles Lakers,PF,77,37,2401,468,1039,0.45,159,434,0.366,309,605,0.511,0.527,147,208,0.707,88,395,483,141,49,34,140,160,1242,Kyle Kuzma
2018-2019,Los Angeles Lakers,PF,70,68,2314,496,1087,0.456,128,422,0.303,368,665,0.553,0.515,188,250,0.752,60,322,382,178,41,26,133,170,1308,Kyle Kuzma
2019-2020,Los Angeles Lakers,PF,61,9,1526,291,668,0.436,86,272,0.316,205,396,0.518,0.5,114,155,0.735,52,221,273,80,28,26,91,126,782,Kyle Kuzma
2020-2021,Los Angeles Lakers,SF,68,32,1954,335,757,0.443,137,380,0.361,198,377,0.525,0.533,67,97,0.691,108,309,417,127,35,41,113,121,874,Kyle Kuzma
2021-2022,Washington Wizards,PF,66,66,2204,423,936,0.452,128,375,0.341,295,561,0.526,0.52,156,219,0.712,70,491,561,233,42,57,169,128,1130,Kyle Kuzma
2022-2023,Washington Wizards,PF,64,64,2239,512,1142,0.448,160,481,0.333,352,661,0.533,0.518,173,237,0.73,55,408,463,239,36,29,190,145,1357,Kyle Kuzma
2023-2024,Washington Wizards,PF,70,70,2281,608,1313,0.463,151,450,0.336,457,863,0.53,0.521,186,240,0.775,62,402,464,296,37,49,192,153,1553,Kyle Kuzma
2024-2025,Washington Wizards,PF,12,12,330,76,181,0.42,16,58,0.276,60,123,0.488,0.464,22,32,0.688,8,59,67,23,5,3,29,23,190,Kyle Kuzma
2022-2023,Memphis Grizzlies,PF,35,0,414,37,95,0.389,24,71,0.338,13,24,0.542,0.516,7,9,0.778,19,44,63,21,12,4,18,49,105,Jake LaRavia
2023-2024,Memphis Grizzlies,PF,35,6,806,118,303,0.389,53,156,0.34,65,147,0.442,0.477,90,109,0.826,51,77,128,58,29,12,45,69,379,Jake LaRavia
2024-2025,Memphis Grizzlies,PF,32,0,715,95,193,0.492,32,72,0.444,63,121,0.521,0.575,48,68,0.706,48,99,147,104,29,18,53,71,270,Jake LaRavia
2014-2015,Minnesota Timberwolves,PG,77,40,1902,286,677,0.422,57,167,0.341,229,510,0.449,0.465,149,177,0.842,27,187,214,276,54,10,193,158,778,Zach LaVine
2015-2016,Minnesota Timberwolves,SG,82,33,2294,433,959,0.452,123,316,0.389,310,643,0.482,0.516,161,203,0.793,27,201,228,251,69,17,155,193,1150,Zach LaVine
2016-2017,Minnesota Timberwolves,SG,47,47,1749,326,710,0.459,120,310,0.387,206,400,0.515,0.544,117,140,0.836,19,141,160,139,41,10,85,104,889,Zach LaVine
2017-2018,Chicago Bulls,SG,24,24,656,136,355,0.383,42,123,0.341,94,232,0.405,0.442,87,107,0.813,9,85,94,72,24,4,43,55,401,Zach LaVine
2018-2019,Chicago Bulls,SG,63,62,2171,530,1135,0.467,120,321,0.374,410,814,0.504,0.52,312,375,0.832,40,254,294,283,60,26,215,140,1492,Zach LaVine
2019-2020,Chicago Bulls,SF,60,60,2085,539,1199,0.45,184,484,0.38,355,715,0.497,0.526,268,334,0.802,41,248,289,254,88,28,206,131,1530,Zach LaVine
2020-2021,Chicago Bulls,SG,58,58,2034,569,1123,0.507,200,477,0.419,369,646,0.571,0.596,253,298,0.849,36,253,289,282,46,27,203,138,1591,Zach LaVine
2021-2022,Chicago Bulls,SG,67,67,2328,565,1186,0.476,185,475,0.389,380,711,0.534,0.554,320,375,0.853,22,286,308,303,41,23,171,120,1635,Zach LaVine
2022-2023,Chicago Bulls,SG,77,77,2768,673,1388,0.485,204,544,0.375,469,844,0.556,0.558,363,428,0.848,42,303,345,327,69,18,194,159,1913,Zach LaVine
2023-2024,Chicago Bulls,SG,25,23,872,170,376,0.452,59,169,0.349,111,207,0.536,0.531,88,103,0.854,8,121,129,98,21,8,52,57,487,Zach LaVine
2024-2025,Chicago Bulls,SF,27,27,899,215,429,0.501,92,204,0.451,123,225,0.547,0.608,79,96,0.823,6,116,122,114,23,7,80,47,601,Zach LaVine
2020-2021,Houston Rockets,SF,24,3,415,46,118,0.39,23,71,0.324,23,47,0.489,0.487,18,21,0.857,27,43,70,23,6,5,19,34,133,Anthony Lamb
2021-2022,San Antonio Spurs,SF,2,0,8,0,2,0,0,2,0,0,0,,0,0,0,,0,1,1,2,0,0,0,0,0,Anthony Lamb
2022-2023,Golden State Warriors,SF,62,4,1195,148,314,0.471,73,199,0.367,75,115,0.652,0.588,46,60,0.767,56,159,215,96,28,20,54,134,415,Anthony Lamb
2021-2022,San Antonio Spurs,C,54,1,589,101,204,0.495,29,89,0.326,72,115,0.626,0.566,34,41,0.829,63,75,138,45,10,14,31,53,265,Jock Landale
2022-2023,Phoenix Suns,C,69,4,979,178,337,0.528,21,84,0.25,157,253,0.621,0.559,79,105,0.752,119,161,280,68,16,30,59,126,456,Jock Landale
2023-2024,Houston Rockets,C,56,3,763,106,206,0.515,10,40,0.25,96,166,0.578,0.539,52,65,0.8,88,84,172,65,20,33,31,74,274,Jock Landale
2024-2025,Houston Rockets,C,18,0,175,21,50,0.42,3,7,0.429,18,43,0.419,0.45,10,19,0.526,21,27,48,14,3,7,10,15,55,Jock Landale
2019-2020,Boston Celtics,SG,32,2,370,28,80,0.35,5,27,0.185,23,53,0.434,0.381,18,25,0.72,15,26,41,13,8,8,11,33,79,Romeo Langford
2020-2021,Boston Celtics,SG,18,4,283,21,59,0.356,5,18,0.278,16,41,0.39,0.398,9,12,0.75,12,23,35,13,6,5,10,24,56,Romeo Langford
2021-2022,Total,SG,48,5,771,83,191,0.435,29,85,0.341,54,106,0.509,0.51,23,42,0.548,30,78,108,21,22,16,16,47,218,Romeo Langford
2021-2022,Boston Celtics,SG,44,5,728,79,184,0.429,29,83,0.349,50,101,0.495,0.508,20,34,0.588,30,74,104,19,21,16,16,46,207,Romeo Langford
2021-2022,San Antonio Spurs,SG,4,0,43,4,7,0.571,0,2,0,4,5,0.8,0.571,3,8,0.375,0,4,4,2,1,0,0,1,11,Romeo Langford
2022-2023,San Antonio Spurs,SG,43,21,844,121,259,0.467,16,61,0.262,105,198,0.53,0.498,39,56,0.696,57,57,114,50,24,13,30,67,297,Romeo Langford
2024-2025,Miami Heat,SG,17,0,286,35,70,0.5,11,32,0.344,24,38,0.632,0.579,16,25,0.64,10,23,33,25,10,0,10,39,97,Pelle Larsson
2022-2023,Total,SG,15,0,108,22,44,0.5,10,25,0.4,12,19,0.632,0.614,2,8,0.25,6,15,21,2,2,0,3,11,56,A.J. Lawson
2022-2023,Minnesota Timberwolves,SG,1,0,2,1,1,1,0,0,,1,1,1,1,0,0,,0,1,1,0,0,0,0,1,2,A.J. Lawson
2022-2023,Dallas Mavericks,SG,14,0,106,21,43,0.488,10,25,0.4,11,18,0.611,0.605,2,8,0.25,6,14,20,2,2,0,3,10,54,A.J. Lawson
2023-2024,Dallas Mavericks,SG,42,0,311,54,121,0.446,13,50,0.26,41,71,0.577,0.5,15,23,0.652,14,36,50,20,10,3,14,22,136,A.J. Lawson
2024-2025,Toronto Raptors,SG,2,0,10,3,4,0.75,2,2,1,1,2,0.5,1,1,2,0.5,0,2,2,0,0,0,0,0,9,A.J. Lawson
2016-2017,Portland Trail Blazers,SF,35,1,249,26,89,0.292,13,51,0.255,13,38,0.342,0.365,13,17,0.765,6,18,24,11,9,3,11,22,78,Jake Layman
2017-2018,Portland Trail Blazers,SF,35,1,160,14,47,0.298,4,20,0.2,10,27,0.37,0.34,2,3,0.667,4,12,16,11,6,4,5,13,34,Jake Layman
2018-2019,Portland Trail Blazers,SF,71,33,1327,216,424,0.509,59,181,0.326,157,243,0.646,0.579,50,71,0.704,56,161,217,53,31,30,46,116,541,Jake Layman
2019-2020,Minnesota Timberwolves,SF,23,2,505,81,179,0.453,24,72,0.333,57,107,0.533,0.52,24,32,0.75,17,40,57,15,17,10,24,47,210,Jake Layman
2020-2021,Minnesota Timberwolves,SF,45,11,627,91,184,0.495,23,78,0.295,68,106,0.642,0.557,26,37,0.703,13,54,67,28,29,19,26,44,231,Jake Layman
2021-2022,Minnesota Timberwolves,SF,34,1,231,30,73,0.411,8,35,0.229,22,38,0.579,0.466,13,18,0.722,6,30,36,9,7,5,10,12,81,Jake Layman
2016-2017,Brooklyn Nets,SF,57,26,1237,171,380,0.45,59,184,0.321,112,196,0.571,0.528,67,93,0.72,23,165,188,110,49,8,59,91,468,Caris LeVert
2017-2018,Brooklyn Nets,SF,71,10,1864,320,735,0.435,85,245,0.347,235,490,0.48,0.493,133,187,0.711,53,207,260,299,82,22,153,159,858,Caris LeVert
2018-2019,Brooklyn Nets,SF,40,25,1063,207,483,0.429,48,154,0.312,159,329,0.483,0.478,85,123,0.691,35,116,151,156,42,14,69,77,547,Caris LeVert
2019-2020,Brooklyn Nets,SG,45,31,1330,311,732,0.425,80,220,0.364,231,512,0.451,0.48,140,197,0.711,49,140,189,199,53,10,118,81,842,Caris LeVert
2020-2021,Total,SG,47,39,1486,359,814,0.441,84,258,0.326,275,556,0.495,0.493,146,180,0.811,33,181,214,245,66,30,102,105,948,Caris LeVert
2020-2021,Brooklyn Nets,SG,12,4,334,87,200,0.435,22,63,0.349,65,137,0.474,0.49,26,34,0.765,10,42,52,72,13,6,26,20,222,Caris LeVert
2020-2021,Indiana Pacers,SG,35,35,1152,272,614,0.443,62,195,0.318,210,419,0.501,0.493,120,146,0.822,23,139,162,173,53,24,76,85,726,Caris LeVert
2021-2022,Total,SG,58,49,1781,379,854,0.444,82,256,0.32,297,598,0.497,0.492,146,193,0.756,43,171,214,248,51,23,108,131,986,Caris LeVert
2021-2022,Indiana Pacers,SG,39,39,1214,278,622,0.447,61,189,0.323,217,433,0.501,0.496,111,146,0.76,30,120,150,173,35,18,75,91,728,Caris LeVert
2021-2022,Cleveland Cavaliers,SG,19,10,567,101,232,0.435,21,67,0.313,80,165,0.485,0.481,35,47,0.745,13,51,64,75,16,5,33,40,258,Caris LeVert
2022-2023,Cleveland Cavaliers,SG,74,30,2237,320,742,0.431,127,324,0.392,193,418,0.462,0.517,130,180,0.722,53,229,282,287,72,24,116,170,897,Caris LeVert
2023-2024,Cleveland Cavaliers,SG,68,10,1958,345,820,0.421,108,332,0.325,237,488,0.486,0.487,154,201,0.766,39,241,280,346,76,34,117,121,952,Caris LeVert
2024-2025,Cleveland Cavaliers,SF,25,0,599,105,202,0.52,46,97,0.474,59,105,0.562,0.634,45,65,0.692,13,57,70,99,23,12,33,34,301,Caris LeVert
2019-2020,Phoenix Suns,SG,5,0,32,4,10,0.4,0,4,0,4,6,0.667,0.4,2,2,1,0,2,2,2,0,0,2,3,10,Jalen Lecque
2020-2021,Indiana Pacers,PG,4,0,12,1,9,0.111,0,1,0,1,8,0.125,0.111,3,3,1,2,3,5,2,0,0,0,0,5,Jalen Lecque
2017-2018,Atlanta Hawks,SG,15,11,404,62,152,0.408,15,60,0.25,47,92,0.511,0.457,22,29,0.759,11,60,71,29,19,1,14,25,161,Damion Lee
2018-2019,Golden State Warriors,SG,32,0,375,56,127,0.441,27,68,0.397,29,59,0.492,0.547,19,22,0.864,8,56,64,13,13,0,11,28,158,Damion Lee
2019-2020,Golden State Warriors,SG,49,36,1423,213,511,0.417,85,239,0.356,128,272,0.471,0.5,110,126,0.873,32,207,239,133,50,6,67,116,621,Damion Lee
2020-2021,Golden State Warriors,SG,57,1,1079,128,274,0.467,77,194,0.397,51,80,0.638,0.608,40,44,0.909,22,158,180,73,38,8,30,89,373,Damion Lee
2021-2022,Golden State Warriors,SG,63,5,1256,169,383,0.441,63,187,0.337,106,196,0.541,0.523,66,75,0.88,27,176,203,63,39,6,38,95,467,Damion Lee
2022-2023,Phoenix Suns,SG,74,5,1506,200,452,0.442,110,247,0.445,90,205,0.439,0.564,94,104,0.904,39,186,225,99,30,7,78,118,604,Damion Lee
2024-2025,Phoenix Suns,SG,6,0,45,5,20,0.25,1,11,0.091,4,9,0.444,0.275,6,6,1,0,5,5,5,2,0,3,2,17,Damion Lee
2020-2021,Detroit Pistons,PG,48,7,781,99,210,0.471,8,23,0.348,91,187,0.487,0.49,61,89,0.685,20,77,97,174,32,13,55,76,267,Saben Lee
2021-2022,Detroit Pistons,PG,37,0,604,69,177,0.39,14,60,0.233,55,117,0.47,0.429,56,71,0.789,18,69,87,107,36,12,36,44,208,Saben Lee
2022-2023,Total,PG,25,1,373,49,121,0.405,11,30,0.367,38,91,0.418,0.45,42,57,0.737,13,32,45,67,19,1,24,32,151,Saben Lee
2022-2023,Philadelphia 76ers,PG,2,0,10,3,4,0.75,0,1,0,3,3,1,0.75,0,0,,0,0,0,2,1,0,3,1,6,Saben Lee
2022-2023,Phoenix Suns,PG,23,1,363,46,117,0.393,11,29,0.379,35,88,0.398,0.44,42,57,0.737,13,32,45,65,18,1,21,31,145,Saben Lee
2023-2024,Phoenix Suns,PG,24,0,185,20,55,0.364,2,16,0.125,18,39,0.462,0.382,29,39,0.744,9,22,31,30,7,3,8,13,71,Saben Lee
2013-2014,Phoenix Suns,C,42,3,362,33,78,0.423,0,0,,33,78,0.423,0.423,20,31,0.645,39,60,99,4,4,18,26,68,86,Alex Len
2014-2015,Phoenix Suns,C,69,44,1518,179,353,0.507,1,3,0.333,178,350,0.509,0.508,73,104,0.702,142,312,454,32,34,105,74,213,432,Alex Len
2015-2016,Phoenix Suns,C,78,46,1821,264,624,0.423,1,7,0.143,263,617,0.426,0.424,174,239,0.728,178,416,594,97,38,62,145,230,703,Alex Len
2016-2017,Phoenix Suns,C,77,34,1560,230,463,0.497,3,12,0.25,227,451,0.503,0.5,150,208,0.721,156,354,510,44,38,98,102,242,613,Alex Len
2017-2018,Phoenix Suns,C,69,13,1395,214,378,0.566,1,3,0.333,213,375,0.568,0.567,158,231,0.684,175,343,518,82,27,61,78,158,587,Alex Len
2018-2019,Atlanta Hawks,C,77,31,1544,320,648,0.494,74,204,0.363,246,444,0.554,0.551,140,216,0.648,158,266,424,86,27,69,97,200,854,Alex Len
2019-2020,Total,C,55,12,970,177,319,0.555,16,59,0.271,161,260,0.619,0.58,68,105,0.648,100,221,321,50,23,48,55,127,438,Alex Len
2019-2020,Atlanta Hawks,C,40,9,745,142,260,0.546,14,56,0.25,128,204,0.627,0.573,51,81,0.63,69,161,230,42,20,33,39,93,349,Alex Len
2019-2020,Sacramento Kings,C,15,3,225,35,59,0.593,2,3,0.667,33,56,0.589,0.61,17,24,0.708,31,60,91,8,3,15,16,34,89,Alex Len
2020-2021,Total,C,64,42,979,171,278,0.615,8,25,0.32,163,253,0.644,0.629,73,116,0.629,78,182,260,49,20,64,55,127,423,Alex Len
2020-2021,Toronto Raptors,C,7,2,76,5,10,0.5,3,6,0.5,2,4,0.5,0.65,3,6,0.5,0,11,11,3,1,6,8,10,16,Alex Len
2020-2021,Washington Wizards,C,57,40,903,166,268,0.619,5,19,0.263,161,249,0.647,0.629,70,110,0.636,78,171,249,46,19,58,47,117,407,Alex Len
2021-2022,Sacramento Kings,C,39,10,620,94,176,0.534,6,21,0.286,88,155,0.568,0.551,41,63,0.651,52,109,161,45,13,25,43,100,235,Alex Len
2022-2023,Sacramento Kings,C,26,2,161,16,30,0.533,0,2,0,16,28,0.571,0.533,11,16,0.688,24,36,60,12,4,11,16,28,43,Alex Len
2023-2024,Sacramento Kings,C,48,0,444,50,81,0.617,0,3,0,50,78,0.641,0.617,20,34,0.588,46,82,128,50,11,33,27,66,120,Alex Len
2024-2025,Sacramento Kings,C,23,3,165,14,25,0.56,0,4,0,14,21,0.667,0.56,5,9,0.556,11,30,41,21,3,14,7,20,33,Alex Len
2011-2012,San Antonio Spurs,SF,64,39,1534,199,404,0.493,41,109,0.376,158,295,0.536,0.543,68,88,0.773,104,223,327,70,85,24,44,88,507,Kawhi Leonard
2012-2013,San Antonio Spurs,SF,58,57,1810,260,526,0.494,65,174,0.374,195,352,0.554,0.556,104,126,0.825,63,283,346,93,97,32,62,99,689,Kawhi Leonard
2013-2014,San Antonio Spurs,SF,66,65,1923,337,645,0.522,69,182,0.379,268,463,0.579,0.576,101,126,0.802,76,336,412,133,114,50,80,127,844,Kawhi Leonard
2014-2015,San Antonio Spurs,SF,64,64,2033,394,822,0.479,67,192,0.349,327,630,0.519,0.52,202,252,0.802,85,376,461,161,148,48,97,128,1057,Kawhi Leonard
2015-2016,San Antonio Spurs,SF,72,72,2380,551,1090,0.506,129,291,0.443,422,799,0.528,0.565,292,334,0.874,95,398,493,186,128,71,105,133,1523,Kawhi Leonard
2016-2017,San Antonio Spurs,SF,74,74,2474,636,1312,0.485,147,387,0.38,489,925,0.529,0.541,469,533,0.88,80,350,430,260,133,55,154,122,1888,Kawhi Leonard
2017-2018,San Antonio Spurs,SF,9,9,210,52,111,0.468,11,35,0.314,41,76,0.539,0.518,31,38,0.816,6,36,42,21,18,9,16,9,146,Kawhi Leonard
2018-2019,Toronto Raptors,SF,60,60,2040,560,1129,0.496,112,302,0.371,448,827,0.542,0.546,364,426,0.854,78,361,439,199,106,24,121,87,1596,Kawhi Leonard
2019-2020,Los Angeles Clippers,SF,57,57,1848,532,1133,0.47,123,325,0.378,409,808,0.506,0.524,356,402,0.886,54,348,402,280,103,33,149,113,1543,Kawhi Leonard
2020-2021,Los Angeles Clippers,SF,52,52,1773,465,908,0.512,101,254,0.398,364,654,0.557,0.568,261,295,0.885,55,282,337,269,81,21,105,82,1292,Kawhi Leonard
2022-2023,Los Angeles Clippers,SF,52,50,1748,446,871,0.512,104,250,0.416,342,621,0.551,0.572,243,279,0.871,57,281,338,204,72,28,88,84,1239,Kawhi Leonard
2023-2024,Los Angeles Clippers,SF,68,68,2330,610,1162,0.525,140,336,0.417,470,826,0.569,0.585,253,286,0.885,84,332,416,244,111,59,119,97,1613,Kawhi Leonard
2012-2013,Portland Trail Blazers,C,69,9,1206,151,277,0.545,3,7,0.429,148,270,0.548,0.551,72,89,0.809,80,175,255,33,11,38,49,168,377,Meyers Leonard
2013-2014,Portland Trail Blazers,C,40,0,355,41,91,0.451,0,6,0,41,85,0.482,0.451,16,21,0.762,26,85,111,18,7,5,15,76,98,Meyers Leonard
2014-2015,Portland Trail Blazers,C,55,7,847,125,245,0.51,47,112,0.42,78,133,0.586,0.606,30,32,0.938,46,204,250,32,10,14,39,113,327,Meyers Leonard
2015-2016,Portland Trail Blazers,PF,61,10,1333,195,435,0.448,86,228,0.377,109,207,0.527,0.547,35,46,0.761,51,263,314,92,8,18,77,183,511,Meyers Leonard
2016-2017,Portland Trail Blazers,PF,74,12,1222,146,378,0.386,74,213,0.347,72,165,0.436,0.484,35,40,0.875,27,210,237,71,13,28,35,172,401,Meyers Leonard
2017-2018,Portland Trail Blazers,C,33,2,254,46,78,0.59,11,26,0.423,35,52,0.673,0.66,9,11,0.818,12,58,70,17,7,0,10,36,112,Meyers Leonard
2018-2019,Portland Trail Blazers,C,61,2,878,132,242,0.545,50,111,0.45,82,131,0.626,0.649,43,51,0.843,49,184,233,75,13,9,43,105,357,Meyers Leonard
2019-2020,Miami Heat,C,51,49,1034,119,234,0.509,53,128,0.414,66,106,0.623,0.622,18,28,0.643,30,230,260,55,14,15,39,107,309,Meyers Leonard
2020-2021,Miami Heat,C,3,2,29,3,7,0.429,3,7,0.429,0,0,,0.643,1,2,0.5,0,7,7,2,0,0,2,5,10,Meyers Leonard
2022-2023,Milwaukee Bucks,C,9,2,114,14,29,0.483,7,18,0.389,7,11,0.636,0.603,8,9,0.889,12,22,34,1,2,0,6,16,43,Meyers Leonard
2024-2025,Oklahoma City Thunder,SF,6,0,21,0,2,0,0,1,0,0,1,0,0,2,4,0.5,1,2,3,1,0,0,1,4,2,Malevy Leons
2020-2021,New Orleans Pelicans,PG,54,0,904,130,337,0.386,40,120,0.333,90,217,0.415,0.445,43,51,0.843,12,59,71,124,38,10,34,88,343,Kira Lewis Jr.
2021-2022,New Orleans Pelicans,PG,24,0,341,59,146,0.404,13,58,0.224,46,88,0.523,0.449,10,12,0.833,9,30,39,49,11,1,26,17,141,Kira Lewis Jr.
2022-2023,New Orleans Pelicans,PG,25,0,235,40,88,0.455,15,34,0.441,25,54,0.463,0.54,19,22,0.864,5,28,33,23,10,2,10,24,114,Kira Lewis Jr.
2023-2024,Total,PG,28,0,265,34,92,0.37,4,33,0.121,30,59,0.508,0.391,17,20,0.85,9,17,26,37,9,2,14,13,89,Kira Lewis Jr.
2023-2024,New Orleans Pelicans,PG,15,0,144,16,52,0.308,2,20,0.1,14,32,0.438,0.327,10,11,0.909,4,10,14,18,5,1,8,8,44,Kira Lewis Jr.
2023-2024,Toronto Raptors,PG,1,0,2,0,0,,0,0,,0,0,,,0,0,,0,0,0,0,0,0,0,1,0,Kira Lewis Jr.
2023-2024,Utah Jazz,PG,12,0,119,18,40,0.45,2,13,0.154,16,27,0.593,0.475,7,9,0.778,5,7,12,19,4,1,6,4,45,Kira Lewis Jr.
2023-2024,Los Angeles Lakers,SF,34,0,103,4,21,0.19,1,9,0.111,3,12,0.25,0.214,2,3,0.667,2,2,4,6,2,1,10,5,11,Maxwell Lewis
2024-2025,Los Angeles Lakers,SF,7,0,29,2,6,0.333,0,0,,2,6,0.333,0.333,0,0,,2,0,2,2,1,0,2,1,4,Maxwell Lewis
2023-2024,New Orleans Pelicans,PF,8,0,23,1,6,0.167,0,5,0,1,1,1,0.167,2,2,1,0,5,5,1,2,2,2,2,4,E.J. Liddell
2024-2025,Chicago Bulls,PF,6,0,31,5,8,0.625,3,6,0.5,2,2,1,0.813,2,2,1,1,4,5,3,1,1,2,8,15,E.J. Liddell
2012-2013,Portland Trail Blazers,PG,82,82,3167,553,1288,0.429,185,503,0.368,368,785,0.469,0.501,271,321,0.844,42,215,257,531,74,19,243,172,1562,Damian Lillard
2013-2014,Portland Trail Blazers,PG,82,82,2937,553,1304,0.424,218,554,0.394,335,750,0.447,0.508,371,426,0.871,35,253,288,457,64,22,193,197,1695,Damian Lillard
2014-2015,Portland Trail Blazers,PG,82,82,2925,590,1360,0.434,196,572,0.343,394,788,0.5,0.506,344,398,0.864,49,329,378,507,97,21,222,164,1720,Damian Lillard
2015-2016,Portland Trail Blazers,PG,75,75,2676,618,1474,0.419,229,610,0.375,389,864,0.45,0.497,414,464,0.892,45,257,302,512,65,28,242,165,1879,Damian Lillard
2016-2017,Portland Trail Blazers,PG,75,75,2694,661,1488,0.444,214,579,0.37,447,909,0.492,0.516,488,545,0.895,46,322,368,440,68,20,197,152,2024,Damian Lillard
2017-2018,Portland Trail Blazers,PG,73,73,2670,621,1415,0.439,227,629,0.361,394,786,0.501,0.519,493,538,0.916,62,263,325,481,77,27,206,117,1962,Damian Lillard
2018-2019,Portland Trail Blazers,PG,80,80,2838,681,1533,0.444,237,643,0.369,444,890,0.499,0.522,468,513,0.912,68,303,371,551,88,34,212,148,2067,Damian Lillard
2019-2020,Portland Trail Blazers,PG,66,66,2474,624,1349,0.463,270,674,0.401,354,675,0.524,0.563,460,518,0.888,33,251,284,530,70,22,194,114,1978,Damian Lillard
2020-2021,Portland Trail Blazers,PG,67,67,2398,602,1334,0.451,275,704,0.391,327,630,0.519,0.554,449,484,0.928,32,251,283,505,62,17,203,102,1928,Damian Lillard
2021-2022,Portland Trail Blazers,PG,29,29,1056,222,552,0.402,92,284,0.324,130,268,0.485,0.486,159,181,0.878,13,107,120,212,17,11,83,37,695,Damian Lillard
2022-2023,Portland Trail Blazers,PG,58,58,2107,556,1202,0.463,244,658,0.371,312,544,0.574,0.564,510,558,0.914,44,233,277,425,50,18,191,109,1866,Damian Lillard
2023-2024,Milwaukee Bucks,PG,73,73,2579,541,1277,0.424,220,622,0.354,321,655,0.49,0.51,473,514,0.92,36,284,320,508,72,18,193,134,1775,Damian Lillard
2024-2025,Milwaukee Bucks,PG,22,22,800,174,387,0.45,76,205,0.371,98,182,0.538,0.548,142,155,0.916,12,87,99,166,23,4,66,42,566,Damian Lillard
2019-2020,Portland Trail Blazers,PF,48,5,573,65,151,0.43,14,59,0.237,51,92,0.554,0.477,28,44,0.636,31,77,108,22,13,14,15,72,172,Nassir Little
2020-2021,Portland Trail Blazers,PF,48,2,640,78,167,0.467,28,80,0.35,50,87,0.575,0.551,36,45,0.8,32,96,128,23,5,13,18,51,220,Nassir Little
2021-2022,Portland Trail Blazers,SF,42,23,1088,145,315,0.46,51,154,0.331,94,161,0.584,0.541,69,94,0.734,58,178,236,54,25,36,40,82,410,Nassir Little
2022-2023,Portland Trail Blazers,SF,54,4,976,134,303,0.442,58,158,0.367,76,145,0.524,0.538,33,46,0.717,27,114,141,50,20,20,36,66,359,Nassir Little
2023-2024,Phoenix Suns,SF,45,2,458,57,124,0.46,21,70,0.3,36,54,0.667,0.544,17,20,0.85,14,61,75,21,10,10,14,39,152,Nassir Little
2023-2024,Dallas Mavericks,C,55,42,1294,221,296,0.747,0,2,0,221,294,0.752,0.747,41,81,0.506,135,243,378,60,36,77,50,144,483,Dereck Lively II
2024-2025,Dallas Mavericks,C,25,18,603,90,129,0.698,0,0,,90,129,0.698,0.698,37,60,0.617,77,117,194,62,16,40,32,72,217,Dereck Lively II
2021-2022,Detroit Pistons,SF,19,5,383,41,90,0.456,27,64,0.422,14,26,0.538,0.606,12,14,0.857,15,42,57,21,13,7,15,37,121,Isaiah Livers
2022-2023,Detroit Pistons,PF,52,22,1199,120,288,0.417,74,203,0.365,46,85,0.541,0.545,32,39,0.821,28,115,143,41,28,28,30,103,346,Isaiah Livers
2023-2024,Detroit Pistons,PF,23,6,469,40,116,0.345,22,77,0.286,18,39,0.462,0.44,12,18,0.667,15,33,48,25,13,5,16,43,114,Isaiah Livers
2023-2024,Milwaukee Bucks,SF,21,0,90,11,22,0.5,1,5,0.2,10,17,0.588,0.523,3,4,0.75,3,18,21,5,2,0,5,15,26,Chris Livingston
2024-2025,Milwaukee Bucks,SF,3,0,6,1,2,0.5,0,0,,1,2,0.5,0.5,0,0,,1,1,2,1,1,0,1,0,2,Chris Livingston
2022-2023,Memphis Grizzlies,PF,24,1,176,49,93,0.527,6,17,0.353,43,76,0.566,0.559,16,27,0.593,19,32,51,20,5,2,12,28,120,Kenneth Lofton Jr.
2023-2024,Total,PF,21,0,199,36,78,0.462,7,24,0.292,29,54,0.537,0.506,17,26,0.654,12,26,38,33,6,5,14,24,96,Kenneth Lofton Jr.
2023-2024,Memphis Grizzlies,PF,15,0,99,14,37,0.378,3,10,0.3,11,27,0.407,0.419,8,15,0.533,2,13,15,14,3,3,6,15,39,Kenneth Lofton Jr.
2023-2024,Philadelphia 76ers,PF,2,0,9,1,6,0.167,0,2,0,1,4,0.25,0.167,0,0,,0,3,3,0,0,0,2,0,2,Kenneth Lofton Jr.
2023-2024,Utah Jazz,PF,4,0,91,21,35,0.6,4,12,0.333,17,23,0.739,0.657,9,11,0.818,10,10,20,19,3,2,6,9,55,Kenneth Lofton Jr.
2015-2016,Golden State Warriors,PF,5,0,21,4,7,0.571,1,2,0.5,3,5,0.6,0.643,0,0,,4,6,10,0,0,0,1,2,9,Kevon Looney
2016-2017,Golden State Warriors,C,53,4,447,56,107,0.523,2,9,0.222,54,98,0.551,0.533,21,34,0.618,44,80,124,29,15,17,17,64,135,Kevon Looney
2017-2018,Golden State Warriors,C,66,4,910,112,193,0.58,1,5,0.2,111,188,0.59,0.583,42,77,0.545,83,132,215,42,34,56,31,106,267,Kevon Looney
2018-2019,Golden State Warriors,C,80,24,1481,217,347,0.625,1,10,0.1,216,337,0.641,0.627,65,105,0.619,194,223,417,123,46,53,51,211,500,Kevon Looney
2019-2020,Golden State Warriors,C,20,4,262,29,79,0.367,1,14,0.071,28,65,0.431,0.373,9,12,0.75,28,38,66,20,12,6,12,34,68,Kevon Looney
2020-2021,Golden State Warriors,C,61,34,1161,108,197,0.548,4,17,0.235,104,180,0.578,0.558,31,48,0.646,117,205,322,119,21,22,37,136,251,Kevon Looney
2021-2022,Golden State Warriors,C,82,80,1732,208,364,0.571,0,1,0,208,363,0.573,0.571,75,125,0.6,208,388,596,165,50,52,67,215,491,Kevon Looney
2022-2023,Golden State Warriors,C,82,70,1958,242,384,0.63,0,1,0,242,383,0.632,0.63,94,155,0.606,274,486,760,207,52,50,45,225,578,Kevon Looney
2023-2024,Golden State Warriors,C,74,36,1195,139,233,0.597,0,1,0,139,232,0.599,0.597,56,83,0.675,143,276,419,133,28,29,50,155,334,Kevon Looney
2024-2025,Golden State Warriors,C,28,5,442,59,112,0.527,0,0,,59,112,0.527,0.527,18,41,0.439,87,107,194,47,20,6,17,64,136,Kevon Looney
2008-2009,New Jersey Nets,C,82,75,2501,448,844,0.531,0,2,0,448,842,0.532,0.531,172,217,0.793,225,440,665,86,44,151,147,257,1068,Brook Lopez
2009-2010,New Jersey Nets,C,82,82,3027,563,1129,0.499,0,2,0,563,1127,0.5,0.499,416,509,0.817,270,439,709,187,55,139,204,251,1542,Brook Lopez
2010-2011,New Jersey Nets,C,82,82,2889,644,1309,0.492,0,1,0,644,1308,0.492,0.492,385,489,0.787,197,291,488,129,47,120,176,240,1673,Brook Lopez
2011-2012,New Jersey Nets,C,5,5,136,38,77,0.494,0,0,,38,77,0.494,0.494,20,32,0.625,8,10,18,6,1,4,6,8,96,Brook Lopez
2012-2013,Brooklyn Nets,C,74,74,2253,570,1094,0.521,0,1,0,570,1093,0.522,0.521,297,392,0.758,208,304,512,70,33,154,131,152,1437,Brook Lopez
2013-2014,Brooklyn Nets,C,17,17,533,129,229,0.563,0,1,0,129,228,0.566,0.563,94,115,0.817,39,63,102,16,9,30,28,52,352,Brook Lopez
2014-2015,Brooklyn Nets,C,72,44,2100,506,987,0.513,1,10,0.1,505,977,0.517,0.513,223,274,0.814,214,321,535,50,43,126,104,206,1236,Brook Lopez
2015-2016,Brooklyn Nets,C,73,73,2457,591,1157,0.511,2,14,0.143,589,1143,0.515,0.512,317,403,0.787,204,369,573,147,58,124,175,215,1501,Brook Lopez
2016-2017,Brooklyn Nets,C,75,75,2222,555,1172,0.474,134,387,0.346,421,785,0.536,0.531,295,364,0.81,121,282,403,176,38,124,184,192,1539,Brook Lopez
2017-2018,Los Angeles Lakers,C,74,72,1735,369,793,0.465,112,325,0.345,257,468,0.549,0.536,111,158,0.703,74,220,294,126,30,98,98,195,961,Brook Lopez
2018-2019,Milwaukee Bucks,C,81,81,2322,355,786,0.452,187,512,0.365,168,274,0.613,0.571,112,133,0.842,33,363,396,98,51,179,82,189,1009,Brook Lopez
2019-2020,Milwaukee Bucks,C,68,67,1817,292,671,0.435,102,325,0.314,190,346,0.549,0.511,127,152,0.836,58,254,312,99,46,163,70,163,813,Brook Lopez
2020-2021,Milwaukee Bucks,C,70,70,1902,322,640,0.503,95,281,0.338,227,359,0.632,0.577,120,142,0.845,104,243,347,50,40,103,64,149,859,Brook Lopez
2021-2022,Milwaukee Bucks,C,13,11,298,61,131,0.466,19,53,0.358,42,78,0.538,0.538,20,23,0.87,19,34,53,6,8,15,12,34,161,Brook Lopez
2022-2023,Milwaukee Bucks,C,78,78,2373,477,899,0.531,136,364,0.374,341,535,0.637,0.606,149,190,0.784,157,363,520,99,37,193,107,203,1239,Brook Lopez
2023-2024,Milwaukee Bucks,C,79,79,2411,366,755,0.485,148,404,0.366,218,351,0.621,0.583,110,134,0.821,117,292,409,127,43,189,79,191,990,Brook Lopez
2024-2025,Milwaukee Bucks,C,29,29,942,131,267,0.491,56,145,0.386,75,122,0.615,0.596,28,38,0.737,35,104,139,44,28,57,32,66,346,Brook Lopez
2008-2009,Phoenix Suns,C,60,7,614,71,137,0.518,0,1,0,71,136,0.522,0.518,47,68,0.691,52,66,118,8,11,41,28,97,189,Robin Lopez
2009-2010,Phoenix Suns,C,51,31,986,171,291,0.588,0,0,,171,291,0.588,0.588,88,125,0.704,104,144,248,7,10,53,41,117,430,Robin Lopez
2010-2011,Phoenix Suns,C,67,56,991,179,357,0.501,0,0,,179,357,0.501,0.501,74,100,0.74,82,134,216,8,18,45,48,143,432,Robin Lopez
2011-2012,Phoenix Suns,C,64,0,895,124,269,0.461,0,0,,124,269,0.461,0.461,100,140,0.714,90,119,209,20,18,60,43,128,348,Robin Lopez
2012-2013,New Orleans Pelicans,C,82,82,2136,384,719,0.534,0,0,,384,719,0.534,0.534,161,207,0.778,226,236,462,64,32,128,110,167,929,Robin Lopez
2013-2014,Portland Trail Blazers,C,82,82,2603,355,644,0.551,0,1,0,355,643,0.552,0.551,198,242,0.818,326,374,700,73,25,139,84,196,908,Robin Lopez
2014-2015,Portland Trail Blazers,C,59,59,1638,234,437,0.535,0,1,0,234,436,0.537,0.535,98,127,0.772,190,204,394,55,16,84,73,122,566,Robin Lopez
2015-2016,New York Knicks,C,82,82,2219,357,662,0.539,0,1,0,357,661,0.54,0.539,128,161,0.795,268,334,602,114,16,129,133,182,842,Robin Lopez
2016-2017,Chicago Bulls,C,81,81,2271,382,775,0.493,0,2,0,382,773,0.494,0.493,75,104,0.721,244,276,520,80,18,117,91,151,839,Robin Lopez
2017-2018,Chicago Bulls,C,64,64,1690,342,645,0.53,4,14,0.286,338,631,0.536,0.533,68,90,0.756,134,156,290,124,14,53,107,109,756,Robin Lopez
2018-2019,Chicago Bulls,C,74,36,1606,304,535,0.568,7,31,0.226,297,504,0.589,0.575,89,123,0.724,140,146,286,89,11,78,96,124,704,Robin Lopez
2019-2020,Milwaukee Bucks,C,66,5,958,147,299,0.492,35,105,0.333,112,194,0.577,0.55,28,53,0.528,56,105,161,45,10,45,63,96,357,Robin Lopez
2020-2021,Washington Wizards,C,71,9,1354,269,425,0.633,5,18,0.278,264,407,0.649,0.639,99,137,0.723,141,131,272,55,15,44,75,109,642,Robin Lopez
2021-2022,Orlando Magic,C,36,9,612,110,199,0.553,2,6,0.333,108,193,0.56,0.558,32,54,0.593,68,58,126,54,2,18,44,67,254,Robin Lopez
2022-2023,Cleveland Cavaliers,C,37,2,299,48,75,0.64,2,4,0.5,46,71,0.648,0.653,14,18,0.778,23,28,51,19,2,8,25,43,112,Robin Lopez
2023-2024,Milwaukee Bucks,C,16,2,65,7,19,0.368,2,8,0.25,5,11,0.455,0.421,2,2,1,3,2,5,4,1,3,2,7,18,Robin Lopez
2020-2021,New Orleans Pelicans,SF,3,0,56,3,13,0.231,2,8,0.25,1,5,0.2,0.308,0,0,,1,2,3,3,2,0,3,5,8,Didi Louzada
2021-2022,Total,SF,9,1,129,12,33,0.364,9,23,0.391,3,10,0.3,0.5,2,2,1,5,12,17,5,2,2,5,13,35,Didi Louzada
2021-2022,New Orleans Pelicans,SF,2,0,7,0,3,0,0,3,0,0,0,,0,0,0,,2,0,2,1,0,0,0,0,0,Didi Louzada
2021-2022,Portland Trail Blazers,SG,7,1,122,12,30,0.4,9,20,0.45,3,10,0.3,0.55,2,2,1,3,12,15,4,2,2,5,13,35,Didi Louzada
2008-2009,Minnesota Timberwolves,C,81,37,2048,316,688,0.459,2,19,0.105,314,669,0.469,0.461,265,336,0.789,274,460,734,84,35,50,118,205,899,Kevin Love
2009-2010,Minnesota Timberwolves,PF,60,22,1714,291,646,0.45,35,106,0.33,256,540,0.474,0.478,225,276,0.815,227,431,658,136,43,23,117,136,842,Kevin Love
2010-2011,Minnesota Timberwolves,PF,73,73,2611,482,1026,0.47,88,211,0.417,394,815,0.483,0.513,424,499,0.85,330,782,1112,184,45,28,155,148,1476,Kevin Love
2011-2012,Minnesota Timberwolves,PF,55,55,2145,474,1059,0.448,105,282,0.372,369,777,0.475,0.497,379,460,0.824,226,508,734,111,47,28,128,152,1432,Kevin Love
2012-2013,Minnesota Timberwolves,PF,18,18,618,105,298,0.352,20,92,0.217,85,206,0.413,0.386,100,142,0.704,64,188,252,42,13,9,39,34,330,Kevin Love
2013-2014,Minnesota Timberwolves,PF,77,77,2797,650,1421,0.457,190,505,0.376,460,916,0.502,0.524,520,633,0.821,224,739,963,341,59,35,196,136,2010,Kevin Love
2014-2015,Cleveland Cavaliers,PF,75,75,2532,413,952,0.434,144,392,0.367,269,560,0.48,0.509,258,321,0.804,142,589,731,168,51,39,122,140,1228,Kevin Love
2015-2016,Cleveland Cavaliers,PF,77,77,2424,409,977,0.419,158,439,0.36,251,538,0.467,0.499,258,314,0.822,149,613,762,186,58,41,142,159,1234,Kevin Love
2016-2017,Cleveland Cavaliers,PF,60,60,1885,370,867,0.427,145,389,0.373,225,478,0.471,0.51,257,295,0.871,148,518,666,116,53,21,122,125,1142,Kevin Love
2017-2018,Cleveland Cavaliers,C,59,59,1651,334,729,0.458,137,330,0.415,197,399,0.494,0.552,234,266,0.88,101,445,546,103,43,24,90,120,1039,Kevin Love
2018-2019,Cleveland Cavaliers,PF,22,21,598,109,283,0.385,53,147,0.361,56,136,0.412,0.479,103,114,0.904,33,206,239,48,6,5,42,54,374,Kevin Love
2019-2020,Cleveland Cavaliers,PF,56,56,1780,327,727,0.45,146,390,0.374,181,337,0.537,0.55,187,219,0.854,54,493,547,178,33,19,140,90,987,Kevin Love
2020-2021,Cleveland Cavaliers,PF,25,25,622,103,252,0.409,57,156,0.365,46,96,0.479,0.522,42,51,0.824,17,169,186,63,16,2,38,26,305,Kevin Love
2021-2022,Cleveland Cavaliers,C,74,4,1665,327,761,0.43,187,477,0.392,140,284,0.493,0.553,166,198,0.838,87,449,536,160,26,18,98,101,1007,Kevin Love
2022-2023,Total,PF,62,20,1240,165,424,0.389,99,296,0.334,66,128,0.516,0.506,80,91,0.879,59,340,399,116,16,12,70,97,509,Kevin Love
2022-2023,Cleveland Cavaliers,PF,41,3,821,111,285,0.389,69,195,0.354,42,90,0.467,0.511,56,63,0.889,42,238,280,76,7,7,47,65,347,Kevin Love
2022-2023,Miami Heat,PF,21,17,419,54,139,0.388,30,101,0.297,24,38,0.632,0.496,24,28,0.857,17,102,119,40,9,5,23,32,162,Kevin Love
2023-2024,Miami Heat,PF,55,5,924,158,359,0.44,84,244,0.344,74,115,0.643,0.557,85,108,0.787,59,279,338,115,18,10,48,97,485,Kevin Love
2024-2025,Miami Heat,PF,15,4,169,31,84,0.369,18,49,0.367,13,35,0.371,0.476,10,15,0.667,14,52,66,18,13,2,12,13,90,Kevin Love
2006-2007,Memphis Grizzlies,PG,10,0,175,14,38,0.368,3,8,0.375,11,30,0.367,0.408,25,28,0.893,12,19,31,32,14,1,12,20,56,Kyle Lowry
2007-2008,Memphis Grizzlies,PG,82,9,2089,256,592,0.432,36,140,0.257,220,452,0.487,0.463,243,348,0.698,41,209,250,296,92,22,127,185,791,Kyle Lowry
2008-2009,Total,PG,77,21,1679,189,434,0.435,25,98,0.255,164,336,0.488,0.464,181,226,0.801,26,163,189,275,69,17,117,146,584,Kyle Lowry
2008-2009,Memphis Grizzlies,PG,49,21,1071,112,272,0.412,17,69,0.246,95,203,0.468,0.443,129,161,0.801,13,98,111,178,48,8,79,89,370,Kyle Lowry
2008-2009,Houston Rockets,PG,28,0,608,77,162,0.475,8,29,0.276,69,133,0.519,0.5,52,65,0.8,13,65,78,97,21,9,38,57,214,Kyle Lowry
2009-2010,Houston Rockets,PG,68,0,1651,184,464,0.397,37,136,0.272,147,328,0.448,0.436,215,260,0.827,91,156,247,305,60,9,116,173,620,Kyle Lowry
2010-2011,Houston Rockets,PG,75,71,2563,345,809,0.426,129,343,0.376,216,466,0.464,0.506,192,251,0.765,89,220,309,500,102,23,158,207,1011,Kyle Lowry
2011-2012,Houston Rockets,PG,47,38,1510,210,513,0.409,79,211,0.374,131,302,0.434,0.486,171,198,0.864,37,176,213,310,73,14,130,133,670,Kyle Lowry
2012-2013,Toronto Raptors,PG,68,52,2020,250,623,0.401,101,279,0.362,149,344,0.433,0.482,190,239,0.795,56,265,321,435,94,24,157,218,791,Kyle Lowry
2013-2014,Toronto Raptors,PG,79,79,2862,457,1080,0.423,190,500,0.38,267,580,0.46,0.511,313,385,0.813,88,281,369,586,121,15,194,267,1417,Kyle Lowry
2014-2015,Toronto Raptors,PG,70,70,2414,430,1043,0.412,132,391,0.338,298,652,0.457,0.476,252,312,0.808,54,274,328,473,109,13,173,212,1244,Kyle Lowry
2015-2016,Toronto Raptors,PG,77,77,2851,512,1198,0.427,212,547,0.388,300,651,0.461,0.516,398,491,0.811,55,310,365,494,158,34,225,211,1634,Kyle Lowry
2016-2017,Toronto Raptors,PG,60,60,2244,426,918,0.464,193,468,0.412,233,450,0.518,0.569,299,365,0.819,48,238,286,417,88,19,173,170,1344,Kyle Lowry
2017-2018,Toronto Raptors,PG,78,78,2510,403,944,0.427,238,596,0.399,165,348,0.474,0.553,223,261,0.854,66,368,434,537,85,19,183,192,1267,Kyle Lowry
2018-2019,Toronto Raptors,PG,65,65,2213,304,739,0.411,157,453,0.347,147,286,0.514,0.518,161,194,0.83,41,271,312,564,91,31,182,166,926,Kyle Lowry
2019-2020,Toronto Raptors,PG,58,58,2098,334,803,0.416,164,466,0.352,170,337,0.504,0.518,294,343,0.857,32,260,292,433,82,26,178,190,1126,Kyle Lowry
2020-2021,Toronto Raptors,PG,46,46,1601,260,596,0.436,131,331,0.396,129,265,0.487,0.546,140,160,0.875,35,212,247,338,45,14,126,143,791,Kyle Lowry
2021-2022,Miami Heat,PG,63,63,2133,276,627,0.44,144,382,0.377,132,245,0.539,0.555,148,174,0.851,33,249,282,474,67,17,168,177,844,Kyle Lowry
2022-2023,Miami Heat,PG,55,44,1718,196,485,0.404,107,310,0.345,89,175,0.509,0.514,116,135,0.859,43,182,225,281,57,21,103,143,615,Kyle Lowry
2023-2024,Total,PG,60,55,1690,163,377,0.432,98,250,0.392,65,127,0.512,0.562,63,75,0.84,34,160,194,253,59,21,85,146,487,Kyle Lowry
2023-2024,Miami Heat,PG,37,35,1037,103,242,0.426,62,161,0.385,41,81,0.506,0.554,35,42,0.833,25,104,129,147,39,15,53,94,303,Kyle Lowry
2023-2024,Philadelphia 76ers,PG,23,20,653,60,135,0.444,36,89,0.404,24,46,0.522,0.578,28,33,0.848,9,56,65,106,20,6,32,52,184,Kyle Lowry
2024-2025,Philadelphia 76ers,PG,21,10,427,29,79,0.367,21,59,0.356,8,20,0.4,0.5,18,23,0.783,7,33,40,58,19,7,14,42,97,Kyle Lowry
2023-2024,Atlanta Hawks,SF,9,0,52,4,17,0.235,3,13,0.231,1,4,0.25,0.324,3,4,0.75,1,6,7,0,0,0,1,6,14,Seth Lundy
2016-2017,Philadelphia 76ers,SF,69,19,1190,145,361,0.402,50,161,0.311,95,200,0.475,0.471,105,123,0.854,25,124,149,75,32,10,73,154,445,Timothé Luwawu-Cabarrot
2017-2018,Philadelphia 76ers,SF,52,7,807,100,267,0.375,53,158,0.335,47,109,0.431,0.474,46,58,0.793,14,58,72,54,12,5,38,97,299,Timothé Luwawu-Cabarrot
2018-2019,Total,SF,50,7,669,82,218,0.376,36,116,0.31,46,102,0.451,0.459,31,41,0.756,11,86,97,26,19,8,21,73,231,Timothé Luwawu-Cabarrot
2018-2019,Oklahoma City Thunder,SF,21,1,123,13,43,0.302,5,22,0.227,8,21,0.381,0.36,4,6,0.667,4,14,18,4,4,1,5,14,35,Timothé Luwawu-Cabarrot
2018-2019,Chicago Bulls,SF,29,6,546,69,175,0.394,31,94,0.33,38,81,0.469,0.483,27,35,0.771,7,72,79,22,15,7,16,59,196,Timothé Luwawu-Cabarrot
2019-2020,Brooklyn Nets,SF,47,2,853,117,269,0.435,62,160,0.388,55,109,0.505,0.55,69,81,0.852,29,98,127,29,18,7,37,106,365,Timothé Luwawu-Cabarrot
2020-2021,Brooklyn Nets,SF,58,7,1050,130,356,0.365,75,239,0.314,55,117,0.47,0.471,35,43,0.814,28,101,129,69,33,6,43,99,370,Timothé Luwawu-Cabarrot
2021-2022,Atlanta Hawks,SF,52,18,685,74,186,0.398,44,122,0.361,30,64,0.469,0.516,35,41,0.854,17,65,82,40,18,6,20,76,227,Timothé Luwawu-Cabarrot
2015-2016,Utah Jazz,PF,80,33,1382,191,436,0.438,49,128,0.383,142,308,0.461,0.494,57,82,0.695,59,240,299,59,26,18,65,114,488,Trey Lyles
2016-2017,Utah Jazz,PF,71,4,1158,159,439,0.362,65,204,0.319,94,235,0.4,0.436,57,79,0.722,48,187,235,69,26,20,64,97,440,Trey Lyles
2017-2018,Denver Nuggets,PF,73,2,1391,270,550,0.491,83,218,0.381,187,332,0.563,0.566,101,143,0.706,55,292,347,91,30,34,61,111,724,Trey Lyles
2018-2019,Denver Nuggets,PF,64,2,1120,207,495,0.418,51,200,0.255,156,295,0.529,0.47,81,116,0.698,44,202,246,87,30,23,68,93,546,Trey Lyles
2019-2020,San Antonio Spurs,PF,63,53,1271,153,343,0.446,65,168,0.387,88,175,0.503,0.541,33,45,0.733,71,290,361,69,28,28,39,98,404,Trey Lyles
2020-2021,San Antonio Spurs,PF,23,9,358,43,90,0.478,14,40,0.35,29,50,0.58,0.556,15,23,0.652,9,77,86,14,6,1,6,13,115,Trey Lyles
2021-2022,Total,PF,75,23,1537,262,562,0.466,67,209,0.321,195,353,0.552,0.526,195,243,0.802,89,290,379,88,29,32,73,123,786,Trey Lyles
2021-2022,Detroit Pistons,PF,51,3,990,175,384,0.456,44,146,0.301,131,238,0.55,0.513,138,176,0.784,60,184,244,58,22,26,54,91,532,Trey Lyles
2021-2022,Sacramento Kings,PF,24,20,547,87,178,0.489,23,63,0.365,64,115,0.557,0.553,57,67,0.851,29,106,135,30,7,6,19,32,254,Trey Lyles
2022-2023,Sacramento Kings,PF,74,0,1247,187,408,0.458,87,240,0.363,100,168,0.595,0.565,101,124,0.815,68,232,300,66,27,31,64,97,562,Trey Lyles
2023-2024,Sacramento Kings,PF,58,0,1158,143,321,0.445,84,219,0.384,59,102,0.578,0.576,49,70,0.7,61,196,257,72,17,19,38,86,419,Trey Lyles
2024-2025,Sacramento Kings,PF,21,2,415,42,110,0.382,29,79,0.367,13,31,0.419,0.514,16,22,0.727,18,67,85,18,11,11,11,28,129,Trey Lyles
2020-2021,Oklahoma City Thunder,PG,65,49,1778,226,614,0.368,105,313,0.335,121,301,0.402,0.454,101,135,0.748,25,186,211,227,56,11,141,126,658,Théo Maledon
2021-2022,Oklahoma City Thunder,PG,51,7,908,119,317,0.375,44,150,0.293,75,167,0.449,0.445,79,100,0.79,20,111,131,111,31,11,65,67,361,Théo Maledon
2022-2023,Charlotte Hornets,PG,44,7,854,102,254,0.402,28,95,0.295,74,159,0.465,0.457,63,74,0.851,14,109,123,152,37,12,59,61,295,Théo Maledon
2023-2024,Total,PG,17,1,213,20,70,0.286,5,30,0.167,15,40,0.375,0.321,14,15,0.933,4,20,24,28,7,0,18,21,59,Théo Maledon
2023-2024,Charlotte Hornets,PG,13,1,200,19,66,0.288,5,30,0.167,14,36,0.389,0.326,11,12,0.917,4,19,23,28,7,0,15,18,54,Théo Maledon
2023-2024,Phoenix Suns,PG,4,0,13,1,4,0.25,0,0,,1,4,0.25,0.25,3,3,1,0,1,1,0,0,0,3,3,5,Théo Maledon
2021-2022,Milwaukee Bucks,PF,41,3,407,57,115,0.496,22,52,0.423,35,63,0.556,0.591,18,22,0.818,35,47,82,22,9,9,15,28,154,Sandro Mamukelashvili
2022-2023,Total,C,43,7,660,97,230,0.422,30,99,0.303,67,131,0.511,0.487,39,57,0.684,70,115,185,62,14,12,35,52,263,Sandro Mamukelashvili
2022-2023,Milwaukee Bucks,C,24,0,217,19,58,0.328,7,32,0.219,12,26,0.462,0.388,12,18,0.667,18,38,56,16,4,5,9,19,57,Sandro Mamukelashvili
2022-2023,San Antonio Spurs,C,19,7,443,78,172,0.453,23,67,0.343,55,105,0.524,0.52,27,39,0.692,52,77,129,46,10,7,26,33,206,Sandro Mamukelashvili
2023-2024,San Antonio Spurs,C,46,5,451,73,155,0.471,19,64,0.297,54,91,0.593,0.532,25,34,0.735,45,102,147,49,7,12,19,35,190,Sandro Mamukelashvili
2024-2025,San Antonio Spurs,PF,20,0,185,30,56,0.536,17,39,0.436,13,17,0.765,0.688,11,15,0.733,12,43,55,7,3,5,9,12,88,Sandro Mamukelashvili
2020-2021,Orlando Magic,PG,10,0,88,3,13,0.231,1,2,0.5,2,11,0.182,0.269,4,5,0.8,1,13,14,4,0,2,3,10,11,Karim Mané
2019-2020,Los Angeles Clippers,SF,41,6,362,37,79,0.468,7,20,0.35,30,59,0.508,0.513,18,27,0.667,10,45,55,53,11,5,18,46,99,Terance Mann
2020-2021,Los Angeles Clippers,SG,67,10,1263,178,350,0.509,38,91,0.418,140,259,0.541,0.563,78,94,0.83,56,186,242,104,29,13,40,126,472,Terance Mann
2021-2022,Los Angeles Clippers,SF,81,33,2317,334,690,0.484,76,208,0.365,258,482,0.535,0.539,128,164,0.78,104,321,425,209,55,21,84,178,872,Terance Mann
2022-2023,Los Angeles Clippers,SG,81,36,1872,272,524,0.519,77,198,0.389,195,326,0.598,0.593,92,118,0.78,77,199,276,184,42,22,80,149,713,Terance Mann
2023-2024,Los Angeles Clippers,SG,75,71,1873,254,493,0.515,71,204,0.348,183,289,0.633,0.587,79,95,0.832,87,167,254,119,43,15,48,145,658,Terance Mann
2024-2025,Los Angeles Clippers,SG,23,11,484,56,128,0.438,16,47,0.34,40,81,0.494,0.5,16,24,0.667,24,47,71,40,22,5,13,47,144,Terance Mann
2021-2022,Oklahoma City Thunder,PG,60,26,1367,231,588,0.393,98,272,0.36,133,316,0.421,0.476,65,82,0.793,25,146,171,91,47,12,71,102,625,Tre Mann
2022-2023,Oklahoma City Thunder,PG,67,5,1183,197,501,0.393,81,257,0.315,116,244,0.475,0.474,42,55,0.764,27,128,155,120,40,11,62,99,517,Tre Mann
2023-2024,Total,PG,41,28,987,145,316,0.459,47,126,0.373,98,190,0.516,0.533,45,59,0.763,20,129,149,165,51,3,65,48,382,Tre Mann
2023-2024,Oklahoma City Thunder,PG,13,0,119,20,40,0.5,8,19,0.421,12,21,0.571,0.6,1,1,1,4,20,24,20,3,0,9,3,49,Tre Mann
2023-2024,Charlotte Hornets,PG,28,28,868,125,276,0.453,39,107,0.364,86,169,0.509,0.524,44,58,0.759,16,109,125,145,48,3,56,45,333,Tre Mann
2024-2025,Charlotte Hornets,PG,13,0,319,70,161,0.435,24,60,0.4,46,101,0.455,0.509,19,21,0.905,12,26,38,39,7,4,25,24,183,Tre Mann
2020-2021,Golden State Warriors,PG,30,1,364,39,114,0.342,22,60,0.367,17,54,0.315,0.439,23,28,0.821,6,40,46,70,16,1,31,29,123,Nico Mannion
2015-2016,San Antonio Spurs,C,54,4,508,105,174,0.603,0,0,,105,174,0.603,0.603,87,114,0.763,73,121,194,21,12,23,29,54,297,Boban Marjanović
2016-2017,Detroit Pistons,C,35,0,293,72,132,0.545,0,0,,72,132,0.545,0.545,47,58,0.81,46,84,130,9,6,12,10,25,191,Boban Marjanović
2017-2018,Total,C,39,1,337,79,148,0.534,0,0,,79,148,0.534,0.534,77,97,0.794,48,96,144,22,10,11,36,51,235,Boban Marjanović
2017-2018,Detroit Pistons,C,19,1,171,41,79,0.519,0,0,,41,79,0.519,0.519,36,45,0.8,15,42,57,14,4,6,22,28,118,Boban Marjanović
2017-2018,Los Angeles Clippers,C,20,0,166,38,69,0.551,0,0,,38,69,0.551,0.551,41,52,0.788,33,54,87,8,6,5,14,23,117,Boban Marjanović
2018-2019,Total,C,58,12,681,160,260,0.615,4,10,0.4,156,250,0.624,0.623,98,131,0.748,87,178,265,54,16,27,59,90,422,Boban Marjanović
2018-2019,Los Angeles Clippers,C,36,9,376,85,140,0.607,0,2,0,85,138,0.616,0.607,72,95,0.758,55,97,152,22,11,17,37,57,242,Boban Marjanović
2018-2019,Philadelphia 76ers,C,22,3,305,75,120,0.625,4,8,0.5,71,112,0.634,0.642,26,36,0.722,32,81,113,32,5,10,22,33,180,Boban Marjanović
2019-2020,Dallas Mavericks,C,44,5,422,121,211,0.573,4,17,0.235,117,194,0.603,0.583,43,57,0.754,66,131,197,20,8,10,30,56,289,Boban Marjanović
2020-2021,Dallas Mavericks,C,33,3,271,62,122,0.508,1,8,0.125,61,114,0.535,0.512,31,38,0.816,47,81,128,10,2,6,12,29,156,Boban Marjanović
2021-2022,Dallas Mavericks,C,23,0,128,42,70,0.6,1,4,0.25,41,66,0.621,0.607,13,22,0.591,8,31,39,3,0,3,15,24,98,Boban Marjanović
2022-2023,Houston Rockets,C,31,0,171,41,60,0.683,0,1,0,41,59,0.695,0.683,20,27,0.741,20,40,60,9,5,2,14,10,102,Boban Marjanović
2023-2024,Houston Rockets,C,14,0,71,18,34,0.529,0,2,0,18,32,0.563,0.529,9,14,0.643,7,25,32,6,1,2,5,5,45,Boban Marjanović
2017-2018,Chicago Bulls,PF,68,68,2020,374,862,0.434,145,401,0.362,229,461,0.497,0.518,140,166,0.843,79,429,508,79,39,40,83,103,1033,Lauri Markkanen
2018-2019,Chicago Bulls,PF,52,51,1682,342,795,0.43,120,332,0.361,222,463,0.479,0.506,170,195,0.872,74,396,470,75,37,33,85,122,974,Lauri Markkanen
2019-2020,Chicago Bulls,PF,50,50,1492,251,591,0.425,109,317,0.344,142,274,0.518,0.517,126,153,0.824,60,253,313,74,42,23,81,96,737,Lauri Markkanen
2020-2021,Chicago Bulls,PF,51,26,1317,250,521,0.48,119,296,0.402,131,225,0.582,0.594,76,92,0.826,35,233,268,45,26,15,52,75,695,Lauri Markkanen
2021-2022,Cleveland Cavaliers,SF,61,61,1878,313,703,0.445,136,380,0.358,177,323,0.548,0.542,138,159,0.868,59,286,345,81,45,30,54,130,900,Lauri Markkanen
2022-2023,Utah Jazz,PF,66,66,2273,571,1145,0.499,200,511,0.391,371,634,0.585,0.586,349,399,0.875,130,440,570,123,42,38,127,137,1691,Lauri Markkanen
2023-2024,Utah Jazz,PF,55,55,1820,427,890,0.48,175,439,0.399,252,451,0.559,0.578,249,277,0.899,122,327,449,110,50,26,77,100,1278,Lauri Markkanen
2024-2025,Utah Jazz,PF,24,24,765,145,326,0.445,68,178,0.382,77,148,0.52,0.549,112,127,0.882,44,114,158,48,18,5,34,40,470,Lauri Markkanen
2020-2021,New Orleans Pelicans,SF,32,10,700,82,209,0.392,29,83,0.349,53,126,0.421,0.462,53,75,0.707,15,133,148,88,26,10,38,58,246,Naji Marshall
2021-2022,New Orleans Pelicans,SF,55,4,735,109,269,0.405,21,105,0.2,88,164,0.537,0.444,74,93,0.796,38,104,142,62,33,8,46,69,313,Naji Marshall
2022-2023,New Orleans Pelicans,SF,77,21,1792,247,571,0.433,66,218,0.303,181,353,0.513,0.49,138,175,0.789,48,231,279,189,54,14,97,113,698,Naji Marshall
2023-2024,New Orleans Pelicans,SF,66,1,1257,170,367,0.463,58,150,0.387,112,217,0.516,0.542,68,86,0.791,53,187,240,128,49,12,65,91,466,Naji Marshall
2024-2025,Dallas Mavericks,SF,26,8,604,113,214,0.528,20,63,0.317,93,151,0.616,0.575,37,42,0.881,24,61,85,57,22,2,35,36,283,Naji Marshall
2019-2020,Charlotte Hornets,SF,18,1,317,37,84,0.44,20,37,0.541,17,47,0.362,0.56,17,21,0.81,10,28,38,23,12,7,15,32,111,Caleb Martin
2020-2021,Charlotte Hornets,SF,53,3,818,96,256,0.375,31,125,0.248,65,131,0.496,0.436,41,64,0.641,31,110,141,67,37,12,33,62,264,Caleb Martin
2021-2022,Miami Heat,SF,60,12,1372,208,410,0.507,64,155,0.413,144,255,0.565,0.585,71,93,0.763,70,160,230,64,58,30,52,104,551,Caleb Martin
2022-2023,Miami Heat,SF,71,49,2077,254,548,0.464,84,236,0.356,170,312,0.545,0.54,91,113,0.805,88,256,344,117,71,31,78,145,683,Caleb Martin
2023-2024,Miami Heat,SF,64,23,1756,241,559,0.431,81,232,0.349,160,327,0.489,0.504,77,99,0.778,74,207,281,143,47,29,77,126,640,Caleb Martin
2024-2025,Philadelphia 76ers,SF,23,16,676,75,177,0.424,25,68,0.368,50,109,0.459,0.494,42,64,0.656,34,69,103,50,22,10,38,43,217,Caleb Martin
2019-2020,Charlotte Hornets,SF,48,3,903,89,207,0.43,18,77,0.234,71,130,0.546,0.473,42,65,0.646,38,120,158,95,39,9,44,78,238,Cody Martin
2020-2021,Charlotte Hornets,SF,52,10,849,83,188,0.441,16,58,0.276,67,130,0.515,0.484,25,43,0.581,52,109,161,86,37,12,40,52,207,Cody Martin
2021-2022,Charlotte Hornets,SF,71,11,1866,204,423,0.482,61,159,0.384,143,264,0.542,0.554,75,107,0.701,82,203,285,179,88,32,61,116,544,Cody Martin
2022-2023,Charlotte Hornets,SF,7,0,134,14,36,0.389,3,14,0.214,11,22,0.5,0.431,4,7,0.571,8,16,24,11,4,1,2,13,35,Cody Martin
2023-2024,Charlotte Hornets,SF,28,22,753,82,215,0.381,27,86,0.314,55,129,0.426,0.444,20,33,0.606,19,90,109,104,32,18,44,48,211,Cody Martin
2024-2025,Charlotte Hornets,SF,30,7,779,97,221,0.439,34,109,0.312,63,112,0.563,0.516,26,37,0.703,33,107,140,68,35,21,34,60,254,Cody Martin
2024-2025,Brooklyn Nets,SF,3,0,5,1,2,0.5,1,1,1,0,1,0,0.75,0,0,0,0,0,0,0,0,0,1,3,0,Jaylen Martin
2019-2020,Minnesota Timberwolves,SF,31,4,495,71,181,0.392,25,96,0.26,46,85,0.541,0.461,30,31,0.968,12,84,96,23,7,9,20,51,197,Kelan Martin
2020-2021,Indiana Pacers,SF,35,0,322,62,138,0.449,24,60,0.4,38,78,0.487,0.536,9,10,0.9,18,60,78,17,10,10,16,35,157,Kelan Martin
2021-2022,Total,SF,30,1,450,70,171,0.409,22,75,0.293,48,96,0.5,0.474,9,13,0.692,17,38,55,21,13,9,14,36,171,Kelan Martin
2021-2022,Indiana Pacers,SF,27,1,444,70,168,0.417,22,74,0.297,48,94,0.511,0.482,9,13,0.692,16,37,53,21,13,9,14,36,171,Kelan Martin
2021-2022,Boston Celtics,SF,3,0,6,0,3,0,0,1,0,0,2,0,0,0,0,,1,1,2,0,0,0,0,0,0,Kelan Martin
2020-2021,Houston Rockets,SF,45,8,1068,162,318,0.509,35,96,0.365,127,222,0.572,0.564,60,84,0.714,73,169,242,48,30,41,38,89,419,KJ Martin
2021-2022,Houston Rockets,SF,79,2,1656,279,523,0.533,60,168,0.357,219,355,0.617,0.591,78,123,0.634,80,217,297,101,34,40,60,113,696,KJ Martin
2022-2023,Houston Rockets,SF,82,49,2292,410,720,0.569,68,216,0.315,342,504,0.679,0.617,151,222,0.68,126,326,452,123,41,30,91,147,1039,KJ Martin
2023-2024,Total,SF,60,2,746,97,181,0.536,8,28,0.286,89,153,0.582,0.558,22,41,0.537,41,90,131,51,22,12,32,100,224,KJ Martin
2023-2024,Los Angeles Clippers,SF,2,0,31,4,10,0.4,1,5,0.2,3,5,0.6,0.45,1,2,0.5,1,2,3,1,2,1,2,3,10,KJ Martin
2023-2024,Philadelphia 76ers,SF,58,2,715,93,171,0.544,7,23,0.304,86,148,0.581,0.564,21,39,0.538,40,88,128,50,20,11,30,97,214,KJ Martin
2024-2025,Philadelphia 76ers,PF,24,7,480,61,99,0.616,8,21,0.381,53,78,0.679,0.657,24,29,0.828,21,51,72,19,11,16,12,62,154,KJ Martin
2022-2023,Atlanta Hawks,SG,16,0,66,9,23,0.391,1,7,0.143,8,16,0.5,0.413,2,2,1,5,7,12,2,1,0,2,2,21,Tyrese Martin
2024-2025,Brooklyn Nets,SG,15,2,246,41,89,0.461,25,62,0.403,16,27,0.593,0.601,7,9,0.778,13,34,47,19,7,2,12,17,114,Tyrese Martin
2019-2020,Washington Wizards,SG,18,0,227,24,56,0.429,19,46,0.413,5,10,0.5,0.598,31,34,0.912,6,18,24,10,8,1,8,32,98,Garrison Mathews
2020-2021,Washington Wizards,SG,64,24,1038,97,237,0.409,76,198,0.384,21,39,0.538,0.57,84,95,0.884,16,71,87,26,29,7,10,106,354,Garrison Mathews
2021-2022,Houston Rockets,SG,65,33,1712,184,461,0.399,139,386,0.36,45,75,0.6,0.55,143,180,0.794,32,158,190,64,57,24,41,168,650,Garrison Mathews
2022-2023,Total,SG,54,0,686,73,201,0.363,63,180,0.35,10,21,0.476,0.52,48,53,0.906,11,62,73,26,24,5,19,62,257,Garrison Mathews
2022-2023,Houston Rockets,SG,45,0,602,60,170,0.353,53,155,0.342,7,15,0.467,0.509,41,45,0.911,10,52,62,23,23,4,18,56,214,Garrison Mathews
2022-2023,Atlanta Hawks,SG,9,0,84,13,31,0.419,10,25,0.4,3,6,0.5,0.581,7,8,0.875,1,10,11,3,1,1,1,6,43,Garrison Mathews
2023-2024,Atlanta Hawks,SG,66,5,992,103,226,0.456,85,193,0.44,18,33,0.545,0.644,34,42,0.81,17,75,92,37,20,8,19,115,325,Garrison Mathews
2024-2025,Atlanta Hawks,SG,22,1,394,53,117,0.453,47,101,0.465,6,16,0.375,0.654,32,38,0.842,5,22,27,28,16,5,13,37,185,Garrison Mathews
2020-2021,Philadelphia 76ers,SG,8,2,123,19,48,0.396,8,26,0.308,11,22,0.5,0.479,2,6,0.333,1,6,7,13,1,3,1,7,48,Dakota Mathias
2021-2022,Memphis Grizzlies,SG,6,0,16,2,6,0.333,2,6,0.333,0,0,,0.5,0,0,,0,2,2,1,1,0,0,1,6,Dakota Mathias
2022-2023,Indiana Pacers,SG,78,17,2222,413,951,0.434,100,310,0.323,313,641,0.488,0.487,376,454,0.828,87,231,318,116,48,13,152,162,1302,Bennedict Mathurin
2023-2024,Indiana Pacers,SF,59,19,1538,296,663,0.446,80,214,0.374,216,449,0.481,0.507,184,224,0.821,60,174,234,119,35,14,97,117,856,Bennedict Mathurin
2024-2025,Indiana Pacers,SG,32,27,1057,179,395,0.453,46,128,0.359,133,267,0.498,0.511,129,153,0.843,41,157,198,60,22,12,64,86,533,Bennedict Mathurin
2024-2025,New Orleans Pelicans,PF,5,0,39,2,5,0.4,0,0,2,5,0.4,0.4,0,0,6,4,10,0,3,3,4,4,4,0,,Karlo Matković
2009-2010,Utah Jazz,SG,82,48,2025,273,565,0.483,63,165,0.382,210,400,0.525,0.539,160,193,0.829,50,141,191,124,64,15,93,152,769,Wesley Matthews
2010-2011,Portland Trail Blazers,SG,82,69,2758,440,979,0.449,154,378,0.407,286,601,0.476,0.528,266,315,0.844,48,210,258,164,102,9,138,195,1300,Wesley Matthews
2011-2012,Portland Trail Blazers,SG,66,53,2228,314,763,0.412,129,337,0.383,185,426,0.434,0.496,147,171,0.86,56,168,224,113,96,15,73,148,904,Wesley Matthews
2012-2013,Portland Trail Blazers,SG,69,69,2403,352,808,0.436,169,425,0.398,183,383,0.478,0.54,149,187,0.797,35,156,191,174,90,18,109,172,1022,Wesley Matthews
2013-2014,Portland Trail Blazers,SG,82,82,2780,445,1009,0.441,201,511,0.393,244,498,0.49,0.541,252,301,0.837,51,238,289,197,76,14,110,176,1343,Wesley Matthews
2014-2015,Portland Trail Blazers,SG,60,60,2024,337,752,0.448,173,445,0.389,164,307,0.534,0.563,109,145,0.752,38,184,222,139,77,10,81,132,956,Wesley Matthews
2015-2016,Dallas Mavericks,SF,78,78,2644,331,854,0.388,189,525,0.36,142,329,0.432,0.498,126,146,0.863,27,211,238,151,78,17,78,179,977,Wesley Matthews
2016-2017,Dallas Mavericks,SG,73,73,2495,333,847,0.393,174,479,0.363,159,368,0.432,0.496,146,179,0.816,18,241,259,210,77,15,102,161,986,Wesley Matthews
2017-2018,Dallas Mavericks,SF,63,63,2131,283,697,0.406,153,402,0.381,130,295,0.441,0.516,83,101,0.822,28,170,198,172,76,16,83,140,802,Wesley Matthews
2018-2019,Total,SF,69,68,2091,279,698,0.4,150,403,0.372,129,295,0.437,0.507,132,163,0.81,32,138,170,160,54,17,91,160,840,Wesley Matthews
2018-2019,Dallas Mavericks,SF,44,44,1312,194,469,0.414,100,263,0.38,94,206,0.456,0.52,87,110,0.791,20,82,102,100,33,12,58,102,575,Wesley Matthews
2018-2019,New York Knicks,SG,2,1,54,4,19,0.211,2,10,0.2,2,9,0.222,0.263,4,5,0.8,1,2,3,5,1,1,2,2,14,Wesley Matthews
2018-2019,Indiana Pacers,SG,23,23,725,81,210,0.386,48,130,0.369,33,80,0.413,0.5,41,48,0.854,11,54,65,55,20,4,31,56,251,Wesley Matthews
2019-2020,Milwaukee Bucks,SG,67,67,1635,167,422,0.396,108,297,0.364,59,125,0.472,0.524,52,68,0.765,22,144,166,92,38,9,43,103,494,Wesley Matthews
2020-2021,Los Angeles Lakers,SG,58,10,1130,89,252,0.353,66,197,0.335,23,55,0.418,0.484,35,41,0.854,20,73,93,54,38,17,26,80,279,Wesley Matthews
2021-2022,Milwaukee Bucks,SG,49,14,1002,87,220,0.395,53,157,0.338,34,63,0.54,0.516,22,28,0.786,30,62,92,36,23,8,18,87,249,Wesley Matthews
2022-2023,Milwaukee Bucks,SF,52,0,820,58,160,0.363,39,124,0.315,19,36,0.528,0.484,24,28,0.857,34,79,113,34,20,13,18,71,179,Wesley Matthews
2023-2024,Atlanta Hawks,SG,36,3,413,34,97,0.351,24,69,0.348,10,28,0.357,0.474,18,24,0.75,9,44,53,23,16,11,8,43,110,Wesley Matthews
2020-2021,Philadelphia 76ers,SG,61,8,935,198,429,0.462,31,103,0.301,167,326,0.512,0.498,61,70,0.871,11,93,104,120,26,13,41,79,488,Tyrese Maxey
2021-2022,Philadelphia 76ers,PG,75,74,2650,483,995,0.485,132,309,0.427,351,686,0.512,0.552,213,246,0.866,26,214,240,321,55,32,88,156,1311,Tyrese Maxey
2022-2023,Philadelphia 76ers,SG,60,41,2016,439,913,0.481,160,369,0.434,279,544,0.513,0.568,180,213,0.845,23,153,176,212,49,8,80,132,1218,Tyrese Maxey
2023-2024,Philadelphia 76ers,PG,70,70,2626,638,1419,0.45,212,569,0.373,426,850,0.501,0.524,328,378,0.868,36,222,258,433,69,33,116,151,1816,Tyrese Maxey
2024-2025,Philadelphia 76ers,PG,22,22,816,198,470,0.421,70,208,0.337,128,262,0.489,0.496,100,122,0.82,5,80,85,119,45,8,48,51,566,Tyrese Maxey
2020-2021,Atlanta Hawks,SG,33,0,269,44,98,0.449,14,40,0.35,30,58,0.517,0.52,22,25,0.88,10,25,35,30,14,2,9,15,124,Skylar Mays
2021-2022,Atlanta Hawks,SG,28,5,220,32,64,0.5,8,25,0.32,24,39,0.615,0.563,8,9,0.889,5,20,25,17,7,0,10,9,80,Skylar Mays
2022-2023,Portland Trail Blazers,PG,6,6,189,34,68,0.5,12,26,0.462,22,42,0.524,0.588,12,13,0.923,2,17,19,50,6,1,10,11,92,Skylar Mays
2023-2024,Total,SG,38,5,433,63,159,0.396,16,54,0.296,47,105,0.448,0.447,13,17,0.765,10,33,43,85,21,4,20,26,155,Skylar Mays
2023-2024,Portland Trail Blazers,PG,21,5,356,53,138,0.384,14,49,0.286,39,89,0.438,0.435,13,17,0.765,9,28,37,75,14,3,18,20,133,Skylar Mays
2023-2024,Los Angeles Lakers,SG,17,0,77,10,21,0.476,2,5,0.4,8,16,0.5,0.524,0,0,,1,5,6,10,7,1,2,6,22,Skylar Mays
2021-2022,New York Knicks,PG,40,2,372,32,108,0.296,17,68,0.25,15,40,0.375,0.375,8,12,0.667,4,38,42,41,14,1,5,45,89,Miles McBride
2022-2023,New York Knicks,PG,64,2,760,77,215,0.358,40,134,0.299,37,81,0.457,0.451,28,42,0.667,13,37,50,72,37,8,25,60,222,Miles McBride
2023-2024,New York Knicks,PG,68,14,1328,205,454,0.452,109,266,0.41,96,188,0.511,0.572,43,50,0.86,31,69,100,114,50,7,30,108,562,Miles McBride
2024-2025,New York Knicks,PG,26,0,650,92,213,0.432,51,125,0.408,41,88,0.466,0.552,27,33,0.818,19,53,72,77,22,5,25,41,262,Miles McBride
2024-2025,Philadelphia 76ers,SG,23,8,592,126,274,0.46,51,133,0.383,75,141,0.532,0.553,49,56,0.875,13,43,56,60,15,0,37,37,352,Jared McCain
2016-2017,Golden State Warriors,SG,71,20,1074,106,245,0.433,41,123,0.333,65,122,0.533,0.516,29,37,0.784,21,79,100,77,32,15,36,62,282,Patrick McCaw
2017-2018,Golden State Warriors,SG,57,10,961,92,225,0.409,19,80,0.238,73,145,0.503,0.451,26,34,0.765,16,66,82,81,43,10,41,67,229,Patrick McCaw
2018-2019,Total,SG,29,1,397,26,63,0.413,9,28,0.321,17,35,0.486,0.484,13,15,0.867,7,41,48,29,23,2,17,38,74,Patrick McCaw
2018-2019,Cleveland Cavaliers,SG,3,0,53,2,9,0.222,1,4,0.25,1,5,0.2,0.278,0,0,,0,3,3,2,2,0,3,1,5,Patrick McCaw
2018-2019,Toronto Raptors,SG,26,1,344,24,54,0.444,8,24,0.333,16,30,0.533,0.519,13,15,0.867,7,38,45,27,21,2,14,37,69,Patrick McCaw
2019-2020,Toronto Raptors,SF,37,12,908,67,162,0.414,23,71,0.324,44,91,0.484,0.485,13,18,0.722,19,67,86,79,39,4,29,60,170,Patrick McCaw
2020-2021,Toronto Raptors,SF,5,0,33,1,1,1,0,0,,1,1,1,1,3,3,1,1,2,3,4,2,0,0,6,5,Patrick McCaw
2021-2022,Total,PG,2,0,25,3,6,0.5,1,3,0.333,2,3,0.667,0.583,1,1,1,0,3,3,1,1,1,3,5,8,Mac McClung
2021-2022,Chicago Bulls,PG,1,0,3,1,1,1,0,0,,1,1,1,1,0,0,,0,0,0,0,0,0,1,0,2,Mac McClung
2021-2022,Los Angeles Lakers,SG,1,0,22,2,5,0.4,1,3,0.333,1,2,0.5,0.5,1,1,1,0,3,3,1,1,1,2,5,6,Mac McClung
2022-2023,Philadelphia 76ers,SG,2,0,41,9,20,0.45,4,11,0.364,5,9,0.556,0.55,3,5,0.6,3,7,10,9,0,0,3,3,25,Mac McClung
2024-2025,Orlando Magic,SG,1,0,5,0,0,,0,0,,0,0,,,0,0,,0,1,1,2,0,0,0,0,0,Mac McClung
2013-2014,Portland Trail Blazers,SG,38,0,476,74,178,0.416,30,80,0.375,44,98,0.449,0.5,23,34,0.676,7,41,48,27,14,2,35,53,201,CJ McCollum
2014-2015,Portland Trail Blazers,SG,62,3,973,159,365,0.436,55,139,0.396,104,226,0.46,0.511,51,73,0.699,14,77,91,64,43,8,48,81,424,CJ McCollum
2015-2016,Portland Trail Blazers,SG,80,80,2780,641,1431,0.448,197,472,0.417,444,959,0.463,0.517,187,226,0.827,47,212,259,341,97,23,196,187,1666,CJ McCollum
2016-2017,Portland Trail Blazers,SG,80,80,2796,692,1441,0.48,185,439,0.421,507,1002,0.506,0.544,268,294,0.912,60,229,289,285,72,42,172,202,1837,CJ McCollum
2017-2018,Portland Trail Blazers,SG,81,81,2923,667,1505,0.443,189,476,0.397,478,1029,0.465,0.506,209,250,0.836,53,268,321,272,77,35,151,168,1732,CJ McCollum
2018-2019,Portland Trail Blazers,SG,70,70,2375,571,1243,0.459,167,445,0.375,404,798,0.506,0.527,159,192,0.828,62,220,282,207,55,28,106,172,1468,CJ McCollum
2019-2020,Portland Trail Blazers,SG,70,70,2556,611,1356,0.451,194,512,0.379,417,844,0.494,0.522,140,185,0.757,46,251,297,310,54,42,127,183,1556,CJ McCollum
2020-2021,Portland Trail Blazers,SG,47,47,1600,405,884,0.458,169,420,0.402,236,464,0.509,0.554,108,133,0.812,30,155,185,223,44,21,65,87,1087,CJ McCollum
2021-2022,Total,SG,62,62,2145,536,1164,0.46,182,469,0.388,354,695,0.509,0.539,116,170,0.682,53,216,269,315,70,22,127,121,1370,CJ McCollum
2021-2022,Portland Trail Blazers,SG,36,36,1267,290,665,0.436,111,289,0.384,179,376,0.476,0.52,48,68,0.706,34,119,153,163,36,21,70,77,739,CJ McCollum
2021-2022,New Orleans Pelicans,PG,26,26,878,246,499,0.493,71,180,0.394,175,319,0.549,0.564,68,102,0.667,19,97,116,152,34,1,57,44,631,CJ McCollum
2022-2023,New Orleans Pelicans,PG,75,75,2649,587,1344,0.437,211,543,0.389,376,801,0.469,0.515,183,238,0.769,55,273,328,429,70,38,183,153,1568,CJ McCollum
2023-2024,New Orleans Pelicans,PG,66,66,2159,484,1055,0.459,239,557,0.429,245,498,0.492,0.572,115,139,0.827,39,247,286,305,62,41,110,126,1322,CJ McCollum
2024-2025,New Orleans Pelicans,PG,19,19,636,152,348,0.437,49,150,0.327,103,198,0.52,0.507,42,59,0.712,15,60,75,78,21,9,32,48,395,CJ McCollum
2015-2016,Philadelphia 76ers,PG,81,17,1606,218,464,0.47,31,89,0.348,187,375,0.499,0.503,26,41,0.634,43,207,250,367,95,10,140,114,493,T.J. McConnell
2016-2017,Philadelphia 76ers,PG,81,51,2133,236,512,0.461,11,55,0.2,225,457,0.492,0.472,73,90,0.811,39,212,251,534,134,10,159,139,556,T.J. McConnell
2017-2018,Philadelphia 76ers,PG,76,1,1706,210,421,0.499,27,62,0.435,183,359,0.51,0.531,31,39,0.795,37,189,226,303,92,13,112,122,478,T.J. McConnell
2018-2019,Philadelphia 76ers,PG,76,3,1470,220,419,0.525,14,42,0.333,206,377,0.546,0.542,29,37,0.784,28,146,174,258,79,17,91,105,483,T.J. McConnell
2019-2020,Indiana Pacers,PG,71,3,1326,212,411,0.516,5,17,0.294,207,394,0.525,0.522,35,42,0.833,38,151,189,355,56,11,100,73,464,T.J. McConnell
2020-2021,Indiana Pacers,PG,69,3,1796,274,490,0.559,15,48,0.313,259,442,0.586,0.574,33,48,0.688,55,201,256,456,128,23,135,113,596,T.J. McConnell
2021-2022,Indiana Pacers,PG,27,8,652,100,208,0.481,10,33,0.303,90,175,0.514,0.505,19,23,0.826,20,70,90,131,29,10,29,53,229,T.J. McConnell
2022-2023,Indiana Pacers,PG,75,6,1526,283,521,0.543,26,59,0.441,257,462,0.556,0.568,58,68,0.853,45,189,234,397,81,10,143,105,650,T.J. McConnell
2023-2024,Indiana Pacers,PG,71,4,1291,330,593,0.556,18,44,0.409,312,549,0.568,0.572,49,62,0.79,36,155,191,390,72,8,108,79,727,T.J. McConnell
2024-2025,Indiana Pacers,PG,31,0,616,159,285,0.558,7,22,0.318,152,263,0.578,0.57,25,33,0.758,18,60,78,136,36,9,49,31,350,T.J. McConnell
2020-2021,Minnesota Timberwolves,PF,63,27,1511,164,367,0.447,72,198,0.364,92,169,0.544,0.545,27,45,0.6,52,180,232,71,35,60,47,172,427,Jaden McDaniels
2021-2022,Minnesota Timberwolves,PF,70,31,1803,255,554,0.46,80,252,0.317,175,302,0.579,0.532,57,71,0.803,76,217,293,79,52,54,75,224,647,Jaden McDaniels
2022-2023,Minnesota Timberwolves,SF,79,79,2416,370,716,0.517,107,269,0.398,263,447,0.588,0.591,106,144,0.736,92,215,307,148,74,76,112,272,953,Jaden McDaniels
2023-2024,Minnesota Timberwolves,SF,72,71,2105,307,628,0.489,86,255,0.337,221,373,0.592,0.557,57,79,0.722,56,168,224,101,63,42,87,219,757,Jaden McDaniels
2024-2025,Minnesota Timberwolves,PF,30,30,889,115,267,0.431,35,110,0.318,80,157,0.51,0.496,23,33,0.697,42,89,131,51,42,23,30,90,288,Jaden McDaniels
2019-2020,Charlotte Hornets,SF,16,0,293,33,70,0.471,9,24,0.375,24,46,0.522,0.536,14,17,0.824,15,50,65,13,8,3,11,36,89,Jalen McDaniels
2020-2021,Charlotte Hornets,SF,47,18,904,133,284,0.468,35,105,0.333,98,179,0.547,0.53,45,64,0.703,45,124,169,53,28,19,45,95,346,Jalen McDaniels
2021-2022,Charlotte Hornets,SF,55,2,895,123,254,0.484,41,108,0.38,82,146,0.562,0.565,53,72,0.736,37,133,170,58,26,22,36,93,340,Jalen McDaniels
2022-2023,Total,SF,80,24,1913,281,617,0.455,77,232,0.332,204,385,0.53,0.518,116,138,0.841,63,283,346,130,83,34,93,209,755,Jalen McDaniels
2022-2023,Charlotte Hornets,SF,56,21,1494,221,494,0.447,65,202,0.322,156,292,0.534,0.513,88,104,0.846,44,226,270,111,66,29,80,158,595,Jalen McDaniels
2022-2023,Philadelphia 76ers,SF,24,3,419,60,123,0.488,12,30,0.4,48,93,0.516,0.537,28,34,0.824,19,57,76,19,17,5,13,51,160,Jalen McDaniels
2023-2024,Toronto Raptors,SF,50,1,538,65,189,0.344,12,71,0.169,53,118,0.449,0.376,27,37,0.73,18,61,79,37,19,6,30,52,169,Jalen McDaniels
2014-2015,Chicago Bulls,SF,36,0,321,43,107,0.402,13,41,0.317,30,66,0.455,0.463,10,15,0.667,6,37,43,6,4,1,17,29,109,Doug McDermott
2015-2016,Chicago Bulls,SF,81,4,1861,291,644,0.452,110,259,0.425,181,385,0.47,0.537,72,84,0.857,37,158,195,59,14,6,53,127,764,Doug McDermott
2016-2017,Total,SF,66,5,1508,222,497,0.447,77,208,0.37,145,289,0.502,0.524,71,84,0.845,20,159,179,58,13,5,38,79,592,Doug McDermott
2016-2017,Chicago Bulls,SF,44,4,1078,166,373,0.445,56,150,0.373,110,223,0.493,0.52,59,67,0.881,14,116,130,45,11,4,32,57,447,Doug McDermott
2016-2017,Oklahoma City Thunder,SF,22,1,430,56,124,0.452,21,58,0.362,35,66,0.53,0.536,12,17,0.706,6,43,49,13,2,1,6,22,145,Doug McDermott
2017-2018,Total,SF,81,4,1768,237,508,0.467,92,216,0.426,145,292,0.497,0.557,64,81,0.79,40,160,200,79,19,16,56,122,630,Doug McDermott
2017-2018,New York Knicks,SF,55,1,1172,151,328,0.46,53,137,0.387,98,191,0.513,0.541,40,53,0.755,33,101,134,50,10,12,34,73,395,Doug McDermott
2017-2018,Dallas Mavericks,SF,26,3,596,86,180,0.478,39,79,0.494,47,101,0.465,0.586,24,28,0.857,7,59,66,29,9,4,22,49,235,Doug McDermott
2018-2019,Indiana Pacers,SF,77,1,1340,207,422,0.491,84,206,0.408,123,216,0.569,0.59,66,79,0.835,17,92,109,67,18,8,42,104,564,Doug McDermott
2019-2020,Indiana Pacers,PF,69,0,1372,267,547,0.488,128,294,0.435,139,253,0.549,0.605,48,58,0.828,26,148,174,78,12,5,42,117,710,Doug McDermott
2020-2021,Indiana Pacers,PF,66,29,1619,354,665,0.532,111,286,0.388,243,379,0.641,0.616,80,98,0.816,60,161,221,85,20,6,53,117,899,Doug McDermott
2021-2022,San Antonio Spurs,PF,51,51,1223,215,465,0.462,108,256,0.422,107,209,0.512,0.578,40,51,0.784,18,97,115,64,13,6,43,79,578,Doug McDermott
2022-2023,San Antonio Spurs,SF,64,0,1314,239,523,0.457,123,298,0.413,116,225,0.516,0.575,53,70,0.757,23,116,139,91,13,6,58,118,654,Doug McDermott
2023-2024,Total,SF,64,0,904,123,284,0.433,94,229,0.41,29,55,0.527,0.599,11,19,0.579,10,49,59,70,16,2,28,64,351,Doug McDermott
2023-2024,San Antonio Spurs,SF,46,0,700,95,215,0.442,76,173,0.439,19,42,0.452,0.619,10,17,0.588,8,40,48,57,11,2,24,48,276,Doug McDermott
2023-2024,Indiana Pacers,SF,18,0,204,28,69,0.406,18,56,0.321,10,13,0.769,0.536,1,2,0.5,2,9,11,13,5,0,4,16,75,Doug McDermott
2024-2025,Sacramento Kings,SF,22,3,200,29,69,0.42,24,59,0.407,5,10,0.5,0.594,3,5,0.6,2,14,16,3,3,1,2,20,85,Doug McDermott
2020-2021,Memphis Grizzlies,SF,18,0,158,13,33,0.394,5,22,0.227,8,11,0.727,0.47,8,8,1,6,13,19,4,2,3,4,8,39,Sean McDermott
2008-2009,Washington Wizards,C,75,14,1143,191,387,0.494,0,0,,191,387,0.494,0.494,107,162,0.66,120,174,294,23,33,75,61,155,489,JaVale McGee
2009-2010,Washington Wizards,C,60,19,968,156,307,0.508,0,1,0,156,306,0.51,0.508,74,116,0.638,88,155,243,14,16,101,51,122,386,JaVale McGee
2010-2011,Washington Wizards,C,79,75,2193,332,604,0.55,0,3,0,332,601,0.552,0.55,134,230,0.583,223,411,634,38,41,193,102,232,798,JaVale McGee
2011-2012,Total,C,61,45,1535,307,552,0.556,0,0,,307,552,0.556,0.556,77,167,0.461,163,314,477,31,35,132,87,166,691,JaVale McGee
2011-2012,Washington Wizards,C,41,40,1124,214,400,0.535,0,0,,214,400,0.535,0.535,58,116,0.5,127,235,362,25,25,101,68,118,486,JaVale McGee
2011-2012,Denver Nuggets,C,20,5,411,93,152,0.612,0,0,,93,152,0.612,0.612,19,51,0.373,36,79,115,6,10,31,19,48,205,JaVale McGee
2012-2013,Denver Nuggets,C,79,0,1433,303,527,0.575,1,1,1,302,526,0.574,0.576,110,186,0.591,158,223,381,24,30,157,90,184,717,JaVale McGee
2013-2014,Denver Nuggets,C,5,5,79,17,38,0.447,0,0,,17,38,0.447,0.447,1,1,1,10,7,17,2,1,7,8,16,35,JaVale McGee
2014-2015,Total,C,23,0,256,42,79,0.532,0,0,,42,79,0.532,0.532,22,33,0.667,18,43,61,3,2,20,18,30,106,JaVale McGee
2014-2015,Denver Nuggets,C,17,0,195,34,61,0.557,0,0,,34,61,0.557,0.557,20,29,0.69,14,34,48,1,2,19,13,28,88,JaVale McGee
2014-2015,Philadelphia 76ers,C,6,0,61,8,18,0.444,0,0,,8,18,0.444,0.444,2,4,0.5,4,9,13,2,0,1,5,2,18,JaVale McGee
2015-2016,Dallas Mavericks,C,34,2,370,77,134,0.575,0,1,0,77,133,0.579,0.575,18,36,0.5,53,80,133,3,5,26,21,49,172,JaVale McGee
2016-2017,Golden State Warriors,C,77,10,739,208,319,0.652,0,3,0,208,316,0.658,0.652,56,111,0.505,100,144,244,17,19,67,40,109,472,JaVale McGee
2017-2018,Golden State Warriors,C,65,17,615,136,219,0.621,0,6,0,136,213,0.638,0.621,38,52,0.731,59,110,169,33,21,57,27,91,310,JaVale McGee
2018-2019,Los Angeles Lakers,C,75,62,1671,400,641,0.624,1,12,0.083,399,629,0.634,0.625,96,152,0.632,195,371,566,52,47,148,108,208,897,JaVale McGee
2019-2020,Los Angeles Lakers,C,68,68,1130,195,306,0.637,3,6,0.5,192,300,0.64,0.642,53,82,0.646,125,265,390,37,36,94,55,159,446,JaVale McGee
2020-2021,Total,C,46,2,678,144,282,0.511,5,24,0.208,139,258,0.539,0.52,44,67,0.657,77,162,239,39,19,54,60,121,337,JaVale McGee
2020-2021,Cleveland Cavaliers,C,33,1,503,112,215,0.521,5,20,0.25,107,195,0.549,0.533,36,55,0.655,54,116,170,33,16,40,45,80,265,JaVale McGee
2020-2021,Denver Nuggets,C,13,1,175,32,67,0.478,0,4,0,32,63,0.508,0.478,8,12,0.667,23,46,69,6,3,14,15,41,72,JaVale McGee
2021-2022,Phoenix Suns,C,74,17,1172,288,458,0.629,2,9,0.222,286,449,0.637,0.631,102,146,0.699,163,333,496,42,22,81,98,181,680,JaVale McGee
2022-2023,Dallas Mavericks,C,42,7,355,80,125,0.64,2,5,0.4,78,120,0.65,0.648,24,41,0.585,30,77,107,11,4,26,36,54,186,JaVale McGee
2023-2024,Sacramento Kings,C,46,0,339,79,132,0.598,1,7,0.143,78,125,0.624,0.602,26,45,0.578,42,84,126,17,14,20,34,46,185,JaVale McGee
2022-2023,Charlotte Hornets,SG,46,7,787,80,202,0.396,26,80,0.325,54,122,0.443,0.46,60,80,0.75,20,73,93,54,15,6,43,48,246,Bryce McGowens
2023-2024,Charlotte Hornets,SG,59,14,882,101,230,0.439,34,102,0.333,67,128,0.523,0.513,66,85,0.776,17,85,102,51,21,10,30,74,302,Bryce McGowens
2024-2025,Portland Trail Blazers,SG,1,0,3,1,2,0.5,0,1,0,1,1,1,0.5,0,0,,0,0,0,1,0,0,0,0,2,Bryce McGowens
2016-2017,Miami Heat,SG,78,65,1966,190,460,0.413,73,220,0.332,117,240,0.488,0.492,44,71,0.62,94,162,256,124,46,18,56,140,497,Rodney McGruder
2017-2018,Miami Heat,SG,18,2,299,36,73,0.493,15,35,0.429,21,38,0.553,0.596,4,8,0.5,11,22,33,17,8,3,4,21,91,Rodney McGruder
2018-2019,Miami Heat,SG,66,45,1550,186,461,0.403,79,225,0.351,107,236,0.453,0.489,52,72,0.722,60,178,238,112,36,12,64,115,503,Rodney McGruder
2019-2020,Los Angeles Clippers,SG,56,4,871,72,181,0.398,24,89,0.27,48,92,0.522,0.464,19,34,0.559,29,122,151,36,26,8,24,74,187,Rodney McGruder
2020-2021,Detroit Pistons,SG,16,2,194,37,70,0.529,11,24,0.458,26,46,0.565,0.607,6,8,0.75,8,14,22,16,8,1,7,12,91,Rodney McGruder
2021-2022,Detroit Pistons,SG,51,2,754,98,225,0.436,58,146,0.397,40,79,0.506,0.564,19,26,0.731,31,80,111,48,21,7,24,58,273,Rodney McGruder
2022-2023,Detroit Pistons,SG,32,12,524,62,152,0.408,41,97,0.423,21,55,0.382,0.543,18,22,0.818,20,54,74,28,16,1,11,39,183,Rodney McGruder
2017-2018,Toronto Raptors,SF,14,0,53,8,15,0.533,3,9,0.333,5,6,0.833,0.633,2,3,0.667,1,6,7,1,1,1,3,8,21,Alfonzo McKinnie
2018-2019,Golden State Warriors,SF,72,5,1003,134,275,0.487,42,118,0.356,92,157,0.586,0.564,27,48,0.563,81,166,247,31,18,15,30,134,337,Alfonzo McKinnie
2019-2020,Cleveland Cavaliers,SF,40,1,593,73,171,0.427,14,65,0.215,59,106,0.557,0.468,22,31,0.71,37,76,113,14,23,8,26,72,182,Alfonzo McKinnie
2020-2021,Los Angeles Lakers,SF,39,0,258,48,93,0.516,16,39,0.41,32,54,0.593,0.602,10,18,0.556,22,32,54,6,7,0,5,26,122,Alfonzo McKinnie
2021-2022,Chicago Bulls,SF,17,3,206,24,61,0.393,9,27,0.333,15,34,0.441,0.467,2,8,0.25,13,20,33,5,2,3,7,26,59,Alfonzo McKinnie
2021-2022,Dallas Mavericks,PG,4,0,11,0,2,0,0,1,0,0,1,0,0,0,0,0,0,0,2,0,0,0,1,0,0,JaQuori McLaughlin
2019-2020,Minnesota Timberwolves,PG,30,2,590,87,178,0.489,29,76,0.382,58,102,0.569,0.57,26,39,0.667,7,42,49,125,34,4,31,31,229,Jordan McLaughlin
2020-2021,Minnesota Timberwolves,PG,51,2,938,100,242,0.413,33,92,0.359,67,150,0.447,0.481,23,30,0.767,21,87,108,193,51,6,51,44,256,Jordan McLaughlin
2021-2022,Minnesota Timberwolves,PG,62,3,902,88,200,0.44,27,85,0.318,61,115,0.53,0.508,30,40,0.75,22,72,94,180,57,10,38,54,233,Jordan McLaughlin
2022-2023,Minnesota Timberwolves,PG,43,0,678,61,145,0.421,24,78,0.308,37,67,0.552,0.503,15,18,0.833,15,47,62,148,32,4,33,28,161,Jordan McLaughlin
2023-2024,Minnesota Timberwolves,PG,56,0,626,70,145,0.483,42,89,0.472,28,56,0.5,0.628,13,18,0.722,18,54,72,110,35,7,19,31,195,Jordan McLaughlin
2024-2025,Sacramento Kings,PG,22,0,164,15,39,0.385,9,23,0.391,6,16,0.375,0.5,10,14,0.714,3,16,19,19,9,0,9,11,49,Jordan McLaughlin
2024-2025,Houston Rockets,PF,6,0,21,3,11,0.273,2,8,0.25,1,3,0.333,0.364,0,0,1,3,4,1,0,1,1,1,8,0,Jack McVeigh
2018-2019,Phoenix Suns,PG,50,31,984,100,256,0.391,29,95,0.305,71,161,0.441,0.447,21,28,0.75,25,109,134,159,68,23,75,113,250,De'Anthony Melton
2019-2020,Memphis Grizzlies,PG,60,8,1167,161,401,0.401,40,140,0.286,121,261,0.464,0.451,93,121,0.769,43,177,220,175,77,20,84,109,455,De'Anthony Melton
2020-2021,Memphis Grizzlies,PG,52,1,1045,172,393,0.438,87,211,0.412,85,182,0.467,0.548,41,51,0.804,30,131,161,132,60,31,66,85,472,De'Anthony Melton
2021-2022,Memphis Grizzlies,SG,73,15,1657,281,695,0.404,139,372,0.374,142,323,0.44,0.504,90,120,0.75,64,264,328,194,104,39,112,128,791,De'Anthony Melton
2022-2023,Philadelphia 76ers,SG,77,58,2150,277,651,0.425,157,403,0.39,120,248,0.484,0.546,69,87,0.793,69,243,312,197,126,41,102,191,780,De'Anthony Melton
2023-2024,Philadelphia 76ers,SG,38,33,1023,139,360,0.386,77,214,0.36,62,146,0.425,0.493,66,79,0.835,28,113,141,114,60,16,39,84,421,De'Anthony Melton
2024-2025,Golden State Warriors,SG,6,2,121,22,54,0.407,13,35,0.371,9,19,0.474,0.528,5,8,0.625,6,14,20,17,7,2,10,18,62,De'Anthony Melton
2023-2024,Charlotte Hornets,C,25,0,307,12,28,0.429,0,0,12,28,0.429,0.429,9,12,0.75,29,36,65,9,6,14,14,64,33,0,Nathan Mensah
2020-2021,Milwaukee Bucks,SG,30,2,233,32,72,0.444,21,47,0.447,11,25,0.44,0.59,4,4,1,6,24,30,21,8,1,10,17,89,Sam Merrill
2021-2022,Memphis Grizzlies,SG,6,0,58,8,24,0.333,7,23,0.304,1,1,1,0.479,2,4,0.5,1,6,7,4,0,0,2,3,25,Sam Merrill
2022-2023,Cleveland Cavaliers,SG,5,0,59,9,22,0.409,5,18,0.278,4,4,1,0.523,2,2,1,0,9,9,5,4,0,0,3,25,Sam Merrill
2023-2024,Cleveland Cavaliers,SG,61,1,1069,158,393,0.402,143,354,0.404,15,39,0.385,0.584,26,28,0.929,22,98,120,108,19,4,19,72,485,Sam Merrill
2024-2025,Cleveland Cavaliers,SG,27,2,535,65,168,0.387,52,148,0.351,13,20,0.65,0.542,17,18,0.944,10,41,51,46,17,7,13,51,199,Sam Merrill
2018-2019,San Antonio Spurs,PF,29,0,145,19,58,0.328,0,2,0,19,56,0.339,0.328,13,17,0.765,9,27,36,13,6,2,15,14,51,Chimezie Metu
2019-2020,San Antonio Spurs,C,18,0,105,24,42,0.571,0,2,0,24,40,0.6,0.571,10,13,0.769,12,21,33,10,3,6,10,7,58,Chimezie Metu
2020-2021,Sacramento Kings,C,36,6,488,91,179,0.508,13,37,0.351,78,142,0.549,0.545,31,43,0.721,31,81,112,28,14,18,29,59,226,Chimezie Metu
2021-2022,Sacramento Kings,C,60,20,1279,203,449,0.452,57,186,0.306,146,263,0.555,0.516,71,91,0.78,34,301,335,60,51,32,61,93,534,Chimezie Metu
2022-2023,Sacramento Kings,PF,66,0,689,129,219,0.589,9,38,0.237,120,181,0.663,0.61,54,73,0.74,47,151,198,40,22,21,32,81,321,Chimezie Metu
2023-2024,Total,C,51,12,859,123,244,0.504,28,94,0.298,95,150,0.633,0.561,58,64,0.906,41,153,194,46,43,16,52,71,332,Chimezie Metu
2023-2024,Phoenix Suns,C,37,5,448,66,130,0.508,15,51,0.294,51,79,0.646,0.565,38,43,0.884,24,86,110,19,19,9,27,39,185,Chimezie Metu
2023-2024,Detroit Pistons,C,14,7,411,57,114,0.5,13,43,0.302,44,71,0.62,0.557,20,21,0.952,17,67,84,27,24,7,25,32,147,Chimezie Metu
2023-2024,Total,PG,60,21,1176,159,370,0.43,43,154,0.279,116,216,0.537,0.488,61,75,0.813,14,74,88,262,31,7,99,68,422,Vasilije Micić
2023-2024,Oklahoma City Thunder,PG,30,0,361,37,91,0.407,11,45,0.244,26,46,0.565,0.467,14,19,0.737,1,23,24,76,9,3,29,22,99,Vasilije Micić
2023-2024,Charlotte Hornets,PG,30,21,815,122,279,0.437,32,109,0.294,90,170,0.529,0.495,47,56,0.839,13,51,64,186,22,4,70,46,323,Vasilije Micić
2024-2025,Charlotte Hornets,PG,19,8,398,52,146,0.356,24,66,0.364,28,80,0.35,0.438,12,15,0.8,15,33,48,68,10,0,37,22,140,Vasilije Micić
2012-2013,Detroit Pistons,SG,27,0,475,62,141,0.44,14,45,0.311,48,96,0.5,0.489,27,32,0.844,4,46,50,28,15,4,11,53,165,Khris Middleton
2013-2014,Milwaukee Bucks,SF,82,64,2460,376,854,0.44,120,290,0.414,256,564,0.454,0.511,118,137,0.861,60,250,310,169,83,20,123,243,990,Khris Middleton
2014-2015,Milwaukee Bucks,SF,79,58,2378,406,869,0.467,109,268,0.407,297,601,0.494,0.53,134,156,0.859,48,299,347,182,122,11,113,183,1055,Khris Middleton
2015-2016,Milwaukee Bucks,SG,79,79,2852,507,1142,0.444,143,361,0.396,364,781,0.466,0.507,277,312,0.888,44,258,302,331,131,19,180,204,1434,Khris Middleton
2016-2017,Milwaukee Bucks,SF,29,23,889,150,333,0.45,45,104,0.433,105,229,0.459,0.518,81,92,0.88,11,112,123,99,41,7,65,79,426,Khris Middleton
2017-2018,Milwaukee Bucks,SF,82,82,2982,593,1272,0.466,146,407,0.359,447,865,0.517,0.524,320,362,0.884,45,384,429,328,119,21,191,270,1652,Khris Middleton
2018-2019,Milwaukee Bucks,SF,77,77,2393,506,1148,0.441,179,474,0.378,327,674,0.485,0.519,216,258,0.837,50,411,461,331,80,7,174,172,1407,Khris Middleton
2019-2020,Milwaukee Bucks,SF,62,59,1853,471,947,0.497,147,354,0.415,324,593,0.546,0.575,208,227,0.916,44,338,382,265,53,7,137,142,1297,Khris Middleton
2020-2021,Milwaukee Bucks,SF,68,68,2269,511,1074,0.476,151,365,0.414,360,709,0.508,0.546,212,236,0.898,54,352,406,370,74,9,178,160,1385,Khris Middleton
2021-2022,Milwaukee Bucks,SF,66,66,2141,452,1021,0.443,162,434,0.373,290,587,0.494,0.522,259,291,0.89,41,315,356,358,76,18,190,160,1325,Khris Middleton
2022-2023,Milwaukee Bucks,SF,33,19,801,177,406,0.436,51,162,0.315,126,244,0.516,0.499,92,102,0.902,28,112,140,163,23,5,71,68,497,Khris Middleton
2023-2024,Milwaukee Bucks,SF,55,55,1487,317,643,0.493,94,247,0.381,223,396,0.563,0.566,100,120,0.833,40,217,257,292,51,15,127,141,828,Khris Middleton
2024-2025,Milwaukee Bucks,SF,8,3,177,36,81,0.444,14,31,0.452,22,50,0.44,0.531,16,20,0.8,2,29,31,44,9,2,20,21,102,Khris Middleton
2019-2020,Sacramento Kings,C,1,0,19,2,3,0.667,0,0,2,3,0.667,0.667,2,2,1,2,5,7,0,0,0,0,5,6,0,Eric Mika
2023-2024,Charlotte Hornets,SF,74,68,2383,476,1083,0.44,184,493,0.373,292,590,0.495,0.524,143,173,0.827,60,255,315,175,66,42,132,184,1279,Brandon Miller
2024-2025,Charlotte Hornets,SF,23,23,793,171,427,0.4,89,253,0.352,82,174,0.471,0.505,61,68,0.897,21,96,117,85,25,17,65,63,492,Brandon Miller
2023-2024,Los Angeles Clippers,SF,8,0,28,5,9,0.556,1,2,0.5,4,7,0.571,0.611,2,2,1,3,2,5,0,0,0,1,2,13,Jordan Miller
2024-2025,Los Angeles Clippers,SF,19,0,271,44,102,0.431,7,30,0.233,37,72,0.514,0.466,17,22,0.773,17,18,35,20,6,3,16,19,112,Jordan Miller
2023-2024,Minnesota Timberwolves,SF,17,0,52,13,20,0.65,2,5,0.4,11,15,0.733,0.7,1,2,0.5,5,15,20,8,2,1,1,5,29,Leonard Miller
2024-2025,Minnesota Timberwolves,SF,1,0,2,0,0,,0,0,,0,0,,,2,2,1,0,0,0,0,1,0,0,0,2,Leonard Miller
2017-2018,Toronto Raptors,SF,15,4,126,13,28,0.464,8,21,0.381,5,7,0.714,0.607,4,4,1,4,11,15,3,1,2,5,10,38,Malcolm Miller
2018-2019,Toronto Raptors,SF,10,0,67,11,26,0.423,10,21,0.476,1,5,0.2,0.615,3,4,0.75,1,4,5,1,1,1,1,5,35,Malcolm Miller
2019-2020,Toronto Raptors,SF,28,1,162,12,29,0.414,8,22,0.364,4,7,0.571,0.552,3,8,0.375,2,14,16,11,5,2,4,18,35,Malcolm Miller
2023-2024,Brooklyn Nets,SF,2,0,24,1,5,0.2,0,3,0,1,2,0.5,0.2,1,2,0.5,0,4,4,3,0,1,0,0,3,Dariq Whitehead
2024-2025,Brooklyn Nets,SF,4,0,28,6,11,0.545,6,10,0.6,0,1,0,0.818,0,0,,0,3,3,1,3,1,3,1,18,Dariq Whitehead
2009-2010,Portland Trail Blazers,PG,10,0,38,10,24,0.417,2,4,0.5,8,20,0.4,0.458,4,7,0.571,1,1,2,5,0,0,4,6,26,Patty Mills
2010-2011,Portland Trail Blazers,PG,64,0,783,135,328,0.412,47,133,0.353,88,195,0.451,0.483,36,47,0.766,19,32,51,109,27,1,62,63,353,Patty Mills
2011-2012,San Antonio Spurs,PG,16,3,261,63,130,0.485,24,56,0.429,39,74,0.527,0.577,15,15,1,4,24,28,39,10,1,26,14,165,Patty Mills
2012-2013,San Antonio Spurs,PG,58,2,656,113,241,0.469,52,130,0.4,61,111,0.55,0.577,16,19,0.842,9,41,50,62,26,4,39,55,294,Patty Mills
2013-2014,San Antonio Spurs,PG,81,2,1527,309,666,0.464,135,318,0.425,174,348,0.5,0.565,73,82,0.89,34,135,169,149,68,9,63,114,826,Patty Mills
2014-2015,San Antonio Spurs,PG,51,0,801,128,336,0.381,62,182,0.341,66,154,0.429,0.473,33,40,0.825,21,54,75,87,28,2,35,58,351,Patty Mills
2015-2016,San Antonio Spurs,PG,81,3,1662,260,612,0.425,123,320,0.384,137,292,0.469,0.525,47,58,0.81,27,131,158,226,59,6,76,102,690,Patty Mills
2016-2017,San Antonio Spurs,PG,80,8,1754,273,621,0.44,147,355,0.414,126,266,0.474,0.558,66,80,0.825,24,117,141,280,65,3,101,109,759,Patty Mills
2017-2018,San Antonio Spurs,PG,82,36,2107,280,682,0.411,154,414,0.372,126,268,0.47,0.523,105,118,0.89,26,128,154,229,55,11,106,128,819,Patty Mills
2018-2019,San Antonio Spurs,PG,82,1,1908,282,663,0.425,159,404,0.394,123,259,0.475,0.545,88,103,0.854,24,158,182,245,49,10,93,129,811,Patty Mills
2019-2020,San Antonio Spurs,PG,66,1,1485,258,598,0.431,154,403,0.382,104,195,0.533,0.56,97,112,0.866,22,86,108,118,53,6,54,105,767,Patty Mills
2020-2021,San Antonio Spurs,PG,68,1,1685,252,611,0.412,161,429,0.375,91,182,0.5,0.544,71,78,0.91,18,98,116,162,42,3,66,81,736,Patty Mills
2021-2022,Brooklyn Nets,SG,81,48,2346,324,794,0.408,227,568,0.4,97,226,0.429,0.551,48,59,0.814,18,138,156,183,51,17,73,112,923,Patty Mills
2022-2023,Brooklyn Nets,PG,40,2,567,86,209,0.411,49,134,0.366,37,75,0.493,0.529,25,30,0.833,8,36,44,56,15,3,30,32,246,Patty Mills
2023-2024,Total,PG,32,5,415,46,131,0.351,24,87,0.276,22,44,0.5,0.443,11,11,1,9,26,35,34,20,1,16,32,127,Patty Mills
2023-2024,Atlanta Hawks,PG,19,0,202,19,51,0.373,13,34,0.382,6,17,0.353,0.5,0,0,,5,15,20,14,9,1,8,17,51,Patty Mills
2023-2024,Miami Heat,PG,13,5,213,27,80,0.338,11,53,0.208,16,27,0.593,0.406,11,11,1,4,11,15,20,11,0,8,15,76,Patty Mills
2024-2025,Utah Jazz,PG,9,0,138,11,31,0.355,7,24,0.292,4,7,0.571,0.468,3,3,1,1,7,8,13,6,2,8,8,32,Patty Mills
2018-2019,Philadelphia 76ers,SG,20,0,268,34,87,0.391,14,44,0.318,20,43,0.465,0.471,5,7,0.714,9,26,35,18,8,8,6,29,87,Shake Milton
2019-2020,Philadelphia 76ers,SG,40,24,805,134,277,0.484,58,135,0.43,76,142,0.535,0.588,51,65,0.785,15,73,88,104,20,7,47,92,377,Shake Milton
2020-2021,Philadelphia 76ers,SG,63,4,1461,300,667,0.45,71,203,0.35,229,464,0.494,0.503,146,176,0.83,33,115,148,193,39,18,103,130,817,Shake Milton
2021-2022,Philadelphia 76ers,SG,55,6,1179,173,403,0.429,43,133,0.323,130,270,0.481,0.483,61,73,0.836,30,112,142,139,28,17,44,99,450,Shake Milton
2022-2023,Philadelphia 76ers,SG,76,11,1567,241,503,0.479,56,148,0.378,185,355,0.521,0.535,99,116,0.853,39,152,191,240,25,13,94,123,637,Shake Milton
2023-2024,Total,SG,48,0,581,79,195,0.405,18,64,0.281,61,131,0.466,0.451,40,49,0.816,14,61,75,60,19,6,31,54,216,Shake Milton
2023-2024,Minnesota Timberwolves,SG,38,0,491,64,160,0.4,14,53,0.264,50,107,0.467,0.444,36,44,0.818,7,44,51,50,16,5,28,44,178,Shake Milton
2023-2024,Detroit Pistons,SG,4,0,63,11,26,0.423,3,9,0.333,8,17,0.471,0.481,2,3,0.667,7,11,18,6,2,1,3,3,27,Shake Milton
2023-2024,New York Knicks,SG,6,0,27,4,9,0.444,1,2,0.5,3,7,0.429,0.5,2,2,1,0,6,6,4,1,0,0,7,11,Shake Milton
2024-2025,Brooklyn Nets,SG,27,1,492,73,157,0.465,28,72,0.389,45,85,0.529,0.554,25,33,0.758,16,35,51,64,15,1,20,43,199,Shake Milton
2022-2023,Portland Trail Blazers,SF,4,0,89,7,23,0.304,3,12,0.25,4,11,0.364,0.37,0,1,0,3,12,15,4,2,5,4,9,17,Justin Minaya
2023-2024,Portland Trail Blazers,SF,34,1,381,22,74,0.297,12,49,0.245,10,25,0.4,0.378,5,9,0.556,30,26,56,21,9,10,9,35,61,Justin Minaya
2024-2025,Portland Trail Blazers,SF,1,0,6,0,0,,0,0,,0,0,,,0,0,,0,1,1,0,0,0,0,1,0,Justin Minaya
2024-2025,San Antonio Spurs,SF,1,0,7,0,1,0,0,1,0,0,0,0,0,0,0,2,2,0,0,0,0,0,0,0,,Riley Minix
2022-2023,Minnesota Timberwolves,SF,15,0,96,18,36,0.5,2,6,0.333,16,30,0.533,0.528,8,8,1,5,20,25,5,4,6,3,10,46,Josh Minott
2023-2024,Minnesota Timberwolves,SF,32,0,91,17,36,0.472,4,10,0.4,13,26,0.5,0.528,12,14,0.857,4,13,17,8,5,5,2,10,50,Josh Minott
2024-2025,Minnesota Timberwolves,SF,17,0,122,20,37,0.541,4,16,0.25,16,21,0.762,0.595,5,7,0.714,5,17,22,10,9,5,5,15,49,Josh Minott
2024-2025,New Orleans Pelicans,C,31,25,827,116,211,0.55,0,1,0,116,210,0.552,0.55,57,88,0.648,121,143,264,41,21,40,37,70,289,Yves Missi
2024-2025,Oklahoma City Thunder,SG,29,0,452,67,131,0.511,17,38,0.447,50,93,0.538,0.576,18,23,0.783,14,41,55,47,23,3,25,50,169,Ajay Mitchell
2021-2022,Sacramento Kings,PG,75,19,2076,352,843,0.418,101,320,0.316,251,523,0.48,0.477,56,85,0.659,33,133,166,313,55,24,114,141,861,Davion Mitchell
2022-2023,Sacramento Kings,PG,80,9,1447,181,399,0.454,63,197,0.32,118,202,0.584,0.533,25,31,0.806,16,89,105,185,44,15,62,112,450,Davion Mitchell
2023-2024,Sacramento Kings,PG,72,4,1101,146,323,0.452,57,158,0.361,89,165,0.539,0.54,30,42,0.714,19,76,95,134,17,3,43,85,379,Davion Mitchell
2024-2025,Toronto Raptors,PG,29,13,762,72,180,0.4,27,88,0.307,45,92,0.489,0.475,21,31,0.677,14,47,61,144,24,7,54,80,192,Davion Mitchell
2017-2018,Utah Jazz,SG,79,71,2638,595,1362,0.437,187,550,0.34,408,812,0.502,0.506,239,297,0.805,52,244,296,291,118,27,215,213,1616,Donovan Mitchell
2018-2019,Utah Jazz,SG,77,77,2598,661,1530,0.432,188,519,0.362,473,1011,0.468,0.493,319,396,0.806,59,257,316,322,106,31,218,208,1829,Donovan Mitchell
2019-2020,Utah Jazz,SG,69,69,2364,602,1342,0.449,173,473,0.366,429,869,0.494,0.513,278,322,0.863,53,251,304,294,70,14,184,172,1655,Donovan Mitchell
2020-2021,Utah Jazz,PG,53,53,1771,478,1091,0.438,178,461,0.386,300,630,0.476,0.52,267,316,0.845,50,185,235,277,52,15,147,117,1401,Donovan Mitchell
2021-2022,Utah Jazz,SG,67,67,2266,617,1376,0.448,232,654,0.355,385,722,0.533,0.533,267,313,0.853,55,227,282,358,99,12,200,164,1733,Donovan Mitchell
2022-2023,Cleveland Cavaliers,SG,68,68,2432,679,1402,0.484,245,635,0.386,434,767,0.566,0.572,319,368,0.867,63,226,289,301,99,27,180,168,1922,Donovan Mitchell
2023-2024,Cleveland Cavaliers,SG,55,55,1942,503,1089,0.462,182,494,0.368,321,595,0.539,0.545,275,318,0.865,46,234,280,333,101,30,154,118,1463,Donovan Mitchell
2024-2025,Cleveland Cavaliers,SG,30,30,949,250,547,0.457,114,277,0.412,136,270,0.504,0.561,94,116,0.81,16,123,139,140,48,8,63,63,708,Donovan Mitchell
2021-2022,Cleveland Cavaliers,PF,69,69,2331,422,830,0.508,23,92,0.25,399,738,0.541,0.522,167,252,0.663,143,427,570,174,56,115,133,147,1034,Evan Mobley
2022-2023,Cleveland Cavaliers,PF,79,79,2715,525,947,0.554,22,102,0.216,503,845,0.595,0.566,205,304,0.674,187,524,711,224,60,119,146,218,1277,Evan Mobley
2023-2024,Cleveland Cavaliers,PF,50,50,1532,320,552,0.58,22,59,0.373,298,493,0.604,0.6,123,171,0.719,111,357,468,160,45,72,90,134,785,Evan Mobley
2024-2025,Cleveland Cavaliers,PF,29,29,881,210,366,0.574,31,71,0.437,179,295,0.607,0.616,93,120,0.775,63,195,258,87,30,42,60,62,544,Evan Mobley
2022-2023,Cleveland Cavaliers,PF,12,0,84,12,28,0.429,3,8,0.375,9,20,0.45,0.482,4,4,1,4,16,20,3,4,3,1,8,31,Isaiah Mobley
2023-2024,Cleveland Cavaliers,PF,10,0,72,10,24,0.417,3,10,0.3,7,14,0.5,0.479,0,1,0,3,7,10,6,2,0,2,6,23,Isaiah Mobley
2024-2025,Toronto Raptors,PF,31,6,553,65,143,0.455,7,24,0.292,58,119,0.487,0.479,33,46,0.717,60,83,143,55,26,16,28,61,170,Jonathan Mogbo
2019-2020,Chicago Bulls,SF,11,0,112,12,28,0.429,6,15,0.4,6,13,0.462,0.536,2,4,0.5,7,3,10,4,4,0,2,17,32,Adam Mokoka
2020-2021,Chicago Bulls,SG,14,0,56,7,19,0.368,1,10,0.1,6,9,0.667,0.395,0,1,0,1,4,5,5,2,1,5,5,15,Adam Mokoka
2022-2023,Sacramento Kings,SF,2,0,8,1,2,0.5,0,0,1,2,0.5,0.5,0,2,0,2,0,2,1,0,0,2,2,2,0,Chima Moneke
2017-2018,Charlotte Hornets,SG,63,0,854,153,425,0.36,83,243,0.342,70,182,0.385,0.458,32,38,0.842,8,58,66,91,20,9,49,60,421,Malik Monk
2018-2019,Charlotte Hornets,SG,73,0,1258,227,586,0.387,109,330,0.33,118,256,0.461,0.48,90,102,0.882,16,121,137,117,37,19,86,106,653,Malik Monk
2019-2020,Charlotte Hornets,SG,55,1,1169,212,488,0.434,58,204,0.284,154,284,0.542,0.494,82,100,0.82,27,130,157,114,25,16,77,74,564,Malik Monk
2020-2021,Charlotte Hornets,SG,42,0,878,173,399,0.434,85,212,0.401,88,187,0.471,0.54,59,72,0.819,14,87,101,87,19,4,55,47,490,Malik Monk
2021-2022,Los Angeles Lakers,SG,76,37,2139,391,826,0.473,173,442,0.391,218,384,0.568,0.578,93,117,0.795,37,219,256,218,61,29,122,138,1048,Malik Monk
2022-2023,Sacramento Kings,SG,77,0,1719,357,796,0.448,143,398,0.359,214,398,0.538,0.538,184,207,0.889,32,171,203,298,49,20,146,125,1041,Malik Monk
2023-2024,Sacramento Kings,SG,72,0,1872,396,893,0.443,148,423,0.35,248,470,0.528,0.526,170,205,0.829,28,184,212,370,45,39,150,156,1110,Malik Monk
2024-2025,Sacramento Kings,SG,24,11,714,136,309,0.44,57,161,0.354,79,148,0.534,0.532,47,55,0.855,4,80,84,113,19,15,43,56,376,Malik Monk
2021-2022,Golden State Warriors,SG,52,11,607,80,183,0.437,40,110,0.364,40,73,0.548,0.546,28,36,0.778,17,63,80,23,7,10,13,43,228,Moses Moody
2022-2023,Golden State Warriors,SG,63,3,817,108,227,0.476,49,135,0.363,59,92,0.641,0.584,37,53,0.698,28,77,105,51,18,7,34,54,302,Moses Moody
2023-2024,Golden State Warriors,SG,66,9,1156,194,420,0.462,72,200,0.36,122,220,0.555,0.548,73,93,0.785,65,131,196,57,42,24,44,90,533,Moses Moody
2024-2025,Golden State Warriors,SG,25,4,392,63,153,0.412,32,91,0.352,31,62,0.5,0.516,27,37,0.73,10,35,45,21,9,6,19,30,185,Moses Moody
2021-2022,Los Angeles Clippers,SG,10,0,137,25,51,0.49,5,14,0.357,20,37,0.541,0.539,3,5,0.6,2,12,14,24,7,3,6,9,58,Xavier Moon
2022-2023,Los Angeles Clippers,SG,4,0,20,3,9,0.333,1,3,0.333,2,6,0.333,0.389,0,0,,0,3,3,5,0,0,1,2,7,Xavier Moon
2023-2024,Los Angeles Clippers,SG,14,1,119,15,46,0.326,2,17,0.118,13,29,0.448,0.348,1,2,0.5,8,10,18,21,3,3,5,8,33,Xavier Moon
2023-2024,Portland Trail Blazers,SG,4,0,40,8,19,0.421,1,7,0.143,7,12,0.583,0.447,1,2,0.5,4,4,8,5,2,0,3,4,18,Taze Moore
2024-2025,Portland Trail Blazers,SG,2,0,20,2,10,0.2,1,4,0.25,1,6,0.167,0.25,1,2,0.5,4,4,8,1,2,0,2,0,6,Taze Moore
2022-2023,Minnesota Timberwolves,SG,29,2,153,18,43,0.419,2,17,0.118,16,26,0.615,0.442,4,5,0.8,4,14,18,18,8,5,8,13,42,Wendell Moore Jr.
2023-2024,Minnesota Timberwolves,SG,25,0,75,9,18,0.5,0,6,0,9,12,0.75,0.5,0,0,,0,12,12,6,5,1,4,5,18,Wendell Moore Jr.
2024-2025,Detroit Pistons,SG,12,0,171,19,36,0.528,3,9,0.333,16,27,0.593,0.569,11,12,0.917,9,28,37,14,8,3,8,13,52,Wendell Moore Jr.
2019-2020,Memphis Grizzlies,PG,67,67,2074,447,937,0.477,60,179,0.335,387,758,0.511,0.509,239,308,0.776,51,208,259,488,58,18,220,110,1193,Ja Morant
2020-2021,Memphis Grizzlies,PG,63,63,2053,430,957,0.449,73,241,0.303,357,716,0.499,0.487,271,372,0.728,59,193,252,465,57,13,203,87,1204,Ja Morant
2021-2022,Memphis Grizzlies,PG,57,57,1889,580,1177,0.493,88,256,0.344,492,921,0.534,0.53,316,415,0.761,77,248,325,384,66,22,196,86,1564,Ja Morant
2022-2023,Memphis Grizzlies,PG,61,59,1948,566,1214,0.466,92,300,0.307,474,914,0.519,0.504,372,497,0.748,61,296,357,493,66,16,206,100,1596,Ja Morant
2023-2024,Memphis Grizzlies,PG,9,9,318,80,170,0.471,14,51,0.275,66,119,0.555,0.512,52,64,0.813,6,44,50,73,7,5,27,19,226,Ja Morant
2024-2025,Memphis Grizzlies,PG,20,20,553,142,313,0.454,31,96,0.323,111,217,0.512,0.503,109,130,0.838,13,75,88,158,22,8,76,32,424,Ja Morant
2019-2020,Utah Jazz,PF,21,0,134,15,26,0.577,3,8,0.375,12,18,0.667,0.635,3,4,0.75,10,19,29,6,1,2,6,19,36,Juwan Morgan
2020-2021,Utah Jazz,PF,29,0,147,14,30,0.467,4,13,0.308,10,17,0.588,0.533,3,7,0.429,9,19,28,9,4,1,4,21,35,Juwan Morgan
2021-2022,Total,PF,2,0,31,2,3,0.667,1,2,0.5,1,1,1,0.833,0,0,,2,2,4,1,0,0,0,3,5,Juwan Morgan
2021-2022,Toronto Raptors,PF,1,0,27,2,3,0.667,1,2,0.5,1,1,1,0.833,0,0,,2,2,4,1,0,0,0,3,5,Juwan Morgan
2021-2022,Boston Celtics,PF,1,0,4,0,0,,0,0,,0,0,,,0,0,,0,0,0,0,0,0,0,0,0,Juwan Morgan
2011-2012,Houston Rockets,PF,17,0,126,16,54,0.296,2,17,0.118,14,37,0.378,0.315,6,8,0.75,5,11,16,3,2,2,4,12,40,Marcus Morris
2012-2013,Total,PF,77,23,1524,222,526,0.422,86,233,0.369,136,293,0.464,0.504,66,117,0.564,80,197,277,62,45,20,77,160,596,Marcus Morris
2012-2013,Houston Rockets,PF,54,17,1154,171,400,0.428,74,194,0.381,97,206,0.471,0.52,49,75,0.653,63,156,219,47,27,16,53,120,465,Marcus Morris
2012-2013,Phoenix Suns,SF,23,6,370,51,126,0.405,12,39,0.308,39,87,0.448,0.452,17,42,0.405,17,41,58,15,18,4,24,40,131,Marcus Morris
2013-2014,Phoenix Suns,SF,82,1,1800,288,651,0.442,99,260,0.381,189,391,0.483,0.518,121,159,0.761,84,235,319,88,72,18,95,157,796,Marcus Morris
2014-2015,Phoenix Suns,PF,81,35,2045,331,763,0.434,112,313,0.358,219,450,0.487,0.507,71,113,0.628,73,312,385,133,63,16,73,188,845,Marcus Morris
2015-2016,Detroit Pistons,SF,80,80,2856,410,945,0.434,108,298,0.362,302,647,0.467,0.491,203,271,0.749,91,313,404,201,67,23,140,170,1131,Marcus Morris
2016-2017,Detroit Pistons,SF,79,79,2565,421,1007,0.418,118,357,0.331,303,650,0.466,0.477,145,185,0.784,77,289,366,160,52,25,87,168,1105,Marcus Morris
2017-2018,Boston Celtics,PF,54,21,1442,262,611,0.429,86,234,0.368,176,377,0.467,0.499,124,154,0.805,43,246,289,72,35,12,65,100,734,Marcus Morris
2018-2019,Boston Celtics,PF,75,53,2091,377,844,0.447,146,389,0.375,231,455,0.508,0.533,146,173,0.844,76,382,458,109,43,25,92,181,1046,Marcus Morris
2019-2020,Total,SF,62,62,1936,355,810,0.438,142,348,0.408,213,462,0.461,0.526,181,220,0.823,59,252,311,86,47,30,97,180,1033,Marcus Morris
2019-2020,New York Knicks,SF,43,43,1387,281,636,0.442,116,264,0.439,165,372,0.444,0.533,163,198,0.823,48,185,233,59,34,17,73,128,841,Marcus Morris
2019-2020,Los Angeles Clippers,PF,19,19,549,74,174,0.425,26,84,0.31,48,90,0.533,0.5,18,22,0.818,11,67,78,27,13,13,24,52,192,Marcus Morris
2020-2021,Los Angeles Clippers,PF,57,29,1502,276,584,0.473,140,296,0.473,136,288,0.472,0.592,73,89,0.82,35,199,234,58,34,15,57,117,765,Marcus Morris
2021-2022,Los Angeles Clippers,PF,54,54,1564,300,691,0.434,101,275,0.367,199,416,0.478,0.507,129,148,0.872,26,213,239,113,28,18,69,115,830,Marcus Morris
2022-2023,Los Angeles Clippers,PF,65,65,1825,274,643,0.426,112,308,0.364,162,335,0.484,0.513,68,87,0.782,29,229,258,114,42,21,56,136,728,Marcus Morris
2023-2024,Total,PF,49,7,817,116,264,0.439,48,119,0.403,68,145,0.469,0.53,36,44,0.818,23,111,134,36,15,13,30,74,316,Marcus Morris
2023-2024,Philadelphia 76ers,PF,37,7,637,90,205,0.439,36,90,0.4,54,115,0.47,0.527,31,36,0.861,18,91,109,26,13,11,19,61,247,Marcus Morris
2023-2024,Cleveland Cavaliers,PF,12,0,180,26,59,0.441,12,29,0.414,14,30,0.467,0.542,5,8,0.625,5,20,25,10,2,2,11,13,69,Marcus Morris
2011-2012,Phoenix Suns,PF,63,7,1227,174,436,0.399,43,124,0.347,131,312,0.42,0.448,76,106,0.717,69,210,279,65,41,42,70,179,467,Markieff Morris
2012-2013,Phoenix Suns,PF,82,32,1837,266,653,0.407,45,134,0.336,221,519,0.426,0.442,93,127,0.732,131,265,396,108,77,64,104,209,670,Markieff Morris
2013-2014,Phoenix Suns,PF,81,0,2153,411,845,0.486,34,108,0.315,377,737,0.512,0.507,259,327,0.792,139,346,485,144,68,51,147,232,1115,Markieff Morris
2014-2015,Phoenix Suns,PF,82,82,2581,512,1100,0.465,57,179,0.318,455,921,0.494,0.491,177,232,0.763,110,396,506,192,101,39,170,245,1258,Markieff Morris
2015-2016,Total,PF,64,45,1629,305,718,0.425,47,155,0.303,258,563,0.458,0.458,108,147,0.735,73,279,352,124,58,34,135,184,765,Markieff Morris
2015-2016,Phoenix Suns,PF,37,24,917,171,431,0.397,22,76,0.289,149,355,0.42,0.422,66,92,0.717,43,151,194,87,33,17,90,104,430,Markieff Morris
2015-2016,Washington Wizards,PF,27,21,712,134,287,0.467,25,79,0.316,109,208,0.524,0.51,42,55,0.764,30,128,158,37,25,17,45,80,335,Markieff Morris
2016-2017,Washington Wizards,PF,76,76,2374,406,889,0.457,71,196,0.362,335,693,0.483,0.497,180,215,0.837,107,386,493,126,82,42,129,254,1063,Markieff Morris
2017-2018,Washington Wizards,PF,73,73,1968,330,687,0.48,76,207,0.367,254,480,0.529,0.536,105,128,0.82,75,334,409,142,56,38,127,216,841,Markieff Morris
2018-2019,Total,PF,58,16,1270,204,484,0.421,68,203,0.335,136,281,0.484,0.492,71,92,0.772,61,204,265,79,36,22,54,175,547,Markieff Morris
2018-2019,Washington Wizards,PF,34,15,883,143,328,0.436,48,144,0.333,95,184,0.516,0.509,57,73,0.781,41,133,174,60,25,20,47,117,391,Markieff Morris
2018-2019,Oklahoma City Thunder,PF,24,1,387,61,156,0.391,20,59,0.339,41,97,0.423,0.455,14,19,0.737,20,71,91,19,11,2,7,58,156,Markieff Morris
2019-2020,Total,PF,58,17,1187,203,458,0.443,88,228,0.386,115,230,0.5,0.539,66,85,0.776,40,178,218,77,31,17,76,133,560,Markieff Morris
2019-2020,Detroit Pistons,PF,44,16,988,175,389,0.45,75,189,0.397,100,200,0.5,0.546,61,79,0.772,24,149,173,69,26,11,70,104,486,Markieff Morris
2019-2020,Los Angeles Lakers,PF,14,1,199,28,69,0.406,13,39,0.333,15,30,0.5,0.5,5,6,0.833,16,29,45,8,5,6,6,29,74,Markieff Morris
2020-2021,Los Angeles Lakers,PF,61,27,1200,153,378,0.405,65,209,0.311,88,169,0.521,0.491,36,50,0.72,48,218,266,73,22,19,54,105,407,Markieff Morris
2021-2022,Miami Heat,PF,17,1,298,54,114,0.474,13,39,0.333,41,75,0.547,0.531,8,9,0.889,17,28,45,23,6,1,20,33,129,Markieff Morris
2022-2023,Total,PF,35,2,355,47,115,0.409,28,71,0.394,19,44,0.432,0.53,10,10,1,13,58,71,31,9,5,18,48,132,Markieff Morris
2022-2023,Brooklyn Nets,PF,27,1,285,33,82,0.402,20,49,0.408,13,33,0.394,0.524,10,10,1,13,46,59,25,8,5,14,33,96,Markieff Morris
2022-2023,Dallas Mavericks,PF,8,1,70,14,33,0.424,8,22,0.364,6,11,0.545,0.545,0,0,,0,12,12,6,1,0,4,15,36,Markieff Morris
2023-2024,Dallas Mavericks,PF,26,1,216,23,68,0.338,15,42,0.357,8,26,0.308,0.449,5,6,0.833,4,35,39,16,5,3,12,12,66,Markieff Morris
2024-2025,Dallas Mavericks,PF,4,0,21,2,9,0.222,1,3,0.333,1,6,0.167,0.278,0,0,,0,5,5,2,0,1,2,0,5,Markieff Morris
2017-2018,Denver Nuggets,PG,3,0,25,4,6,0.667,0,1,0,4,5,0.8,0.667,2,2,1,0,2,2,7,3,0,1,1,10,Monte Morris
2018-2019,Denver Nuggets,PG,82,6,1970,346,702,0.493,94,227,0.414,252,475,0.531,0.56,65,81,0.802,35,159,194,297,73,4,52,102,851,Monte Morris
2019-2020,Denver Nuggets,PG,73,12,1636,260,566,0.459,65,172,0.378,195,394,0.495,0.517,75,89,0.843,24,113,137,255,55,17,53,73,660,Monte Morris
2020-2021,Denver Nuggets,PG,47,13,1196,186,387,0.481,51,134,0.381,135,253,0.534,0.547,58,73,0.795,11,85,96,150,34,13,34,48,481,Monte Morris
2021-2022,Denver Nuggets,PG,75,74,2239,374,773,0.484,124,314,0.395,250,459,0.545,0.564,73,84,0.869,27,199,226,333,56,14,78,92,945,Monte Morris
2022-2023,Washington Wizards,PG,62,61,1695,247,515,0.48,78,204,0.382,169,311,0.543,0.555,64,77,0.831,26,184,210,326,43,13,60,75,636,Monte Morris
2023-2024,Total,PG,33,0,476,62,153,0.405,27,70,0.386,35,83,0.422,0.493,13,19,0.684,7,50,57,69,19,9,7,14,164,Monte Morris
2023-2024,Detroit Pistons,PG,6,0,68,12,33,0.364,2,11,0.182,10,22,0.455,0.394,1,2,0.5,2,10,12,8,1,1,2,1,27,Monte Morris
2023-2024,Minnesota Timberwolves,PG,27,0,408,50,120,0.417,25,59,0.424,25,61,0.41,0.521,12,17,0.706,5,40,45,61,18,8,5,13,137,Monte Morris
2024-2025,Phoenix Suns,PG,25,0,329,44,110,0.4,16,52,0.308,28,58,0.483,0.473,24,29,0.828,7,32,39,45,12,3,12,14,128,Monte Morris
2015-2016,Denver Nuggets,PG,68,66,2068,329,905,0.364,74,232,0.319,255,673,0.379,0.404,140,209,0.67,32,200,232,372,65,35,217,141,872,Emmanuel Mudiay
2016-2017,Denver Nuggets,PG,55,41,1406,208,551,0.377,56,178,0.315,152,373,0.408,0.428,131,167,0.784,29,149,178,217,41,13,123,95,603,Emmanuel Mudiay
2017-2018,Total,PG,64,14,1245,204,526,0.388,47,148,0.318,157,378,0.415,0.433,98,129,0.76,26,126,152,206,41,11,113,80,553,Emmanuel Mudiay
2017-2018,Denver Nuggets,PG,42,0,752,129,322,0.401,38,102,0.373,91,220,0.414,0.46,63,78,0.808,16,78,94,121,21,4,72,47,359,Emmanuel Mudiay
2017-2018,New York Knicks,PG,22,14,493,75,204,0.368,9,46,0.196,66,158,0.418,0.39,35,51,0.686,10,48,58,85,20,7,41,33,194,Emmanuel Mudiay
2018-2019,New York Knicks,PG,59,42,1607,330,740,0.446,69,210,0.329,261,530,0.492,0.493,144,186,0.774,33,163,196,228,43,19,140,103,873,Emmanuel Mudiay
2019-2020,Utah Jazz,PG,54,2,850,151,327,0.462,30,87,0.345,121,240,0.504,0.508,63,83,0.759,18,108,126,116,24,10,76,72,395,Emmanuel Mudiay
2021-2022,Sacramento Kings,PG,2,0,11,0,2,0,0,0,,0,2,0,0,3,4,0.75,0,0,0,4,1,0,1,1,3,Emmanuel Mudiay
2019-2020,Golden State Warriors,SF,7,3,204,26,67,0.388,16,52,0.308,10,15,0.667,0.507,9,12,0.75,3,20,23,8,2,1,5,20,77,Mychal Mulder
2020-2021,Golden State Warriors,PG,60,6,766,119,265,0.449,85,214,0.397,34,51,0.667,0.609,14,22,0.636,8,52,60,26,12,12,16,56,337,Mychal Mulder
2021-2022,Total,PG,17,3,239,24,77,0.312,17,54,0.315,7,23,0.304,0.422,4,4,1,2,22,24,5,4,2,8,13,69,Mychal Mulder
2021-2022,Orlando Magic,PG,15,2,195,20,67,0.299,13,46,0.283,7,21,0.333,0.396,2,2,1,2,19,21,3,4,1,8,12,55,Mychal Mulder
2021-2022,Miami Heat,PG,2,1,44,4,10,0.4,4,8,0.5,0,2,0,0.6,2,2,1,0,3,3,2,0,1,0,1,14,Mychal Mulder
2021-2022,New Orleans Pelicans,SF,62,1,864,109,277,0.394,71,186,0.382,38,91,0.418,0.522,45,51,0.882,47,100,147,38,23,7,16,60,334,Trey Murphy III
2022-2023,New Orleans Pelicans,SF,79,65,2448,387,800,0.484,202,497,0.406,185,303,0.611,0.61,172,190,0.905,59,222,281,112,89,43,61,155,1148,Trey Murphy III
2023-2024,New Orleans Pelicans,SF,57,23,1690,275,621,0.443,169,445,0.38,106,176,0.602,0.579,123,151,0.815,42,238,280,124,51,28,34,70,842,Trey Murphy III
2024-2025,New Orleans Pelicans,SF,19,17,644,132,292,0.452,57,158,0.361,75,134,0.56,0.55,63,71,0.887,15,71,86,46,20,13,33,44,384,Trey Murphy III
2016-2017,San Antonio Spurs,PG,38,8,322,50,116,0.431,9,23,0.391,41,93,0.441,0.47,21,30,0.7,6,36,42,48,8,6,38,29,130,Dejounte Murray
2017-2018,San Antonio Spurs,PG,81,48,1743,270,609,0.443,9,34,0.265,261,575,0.454,0.451,105,148,0.709,110,349,459,231,97,31,134,151,654,Dejounte Murray
2019-2020,San Antonio Spurs,PG,66,58,1687,294,637,0.462,41,111,0.369,253,526,0.481,0.494,91,114,0.798,69,314,383,271,111,17,125,143,720,Dejounte Murray
2020-2021,San Antonio Spurs,PG,67,67,2139,441,974,0.453,63,199,0.317,378,775,0.488,0.485,106,134,0.791,58,415,473,363,101,7,117,135,1051,Dejounte Murray
2021-2022,San Antonio Spurs,PG,68,68,2366,573,1241,0.462,96,294,0.327,477,947,0.504,0.5,196,247,0.794,80,483,563,627,138,23,180,138,1438,Dejounte Murray
2022-2023,Atlanta Hawks,SG,74,74,2693,612,1319,0.464,133,387,0.344,479,932,0.514,0.514,158,190,0.832,53,336,389,448,112,19,160,106,1515,Dejounte Murray
2023-2024,Atlanta Hawks,SG,78,78,2783,672,1463,0.459,201,554,0.363,471,909,0.518,0.528,208,262,0.794,62,354,416,502,111,24,201,138,1753,Dejounte Murray
2024-2025,New Orleans Pelicans,PG,15,15,504,89,244,0.365,22,80,0.275,67,164,0.409,0.41,43,52,0.827,7,91,98,112,35,8,61,35,243,Dejounte Murray
2016-2017,Denver Nuggets,SG,82,10,1764,295,730,0.404,115,344,0.334,180,386,0.466,0.483,106,120,0.883,41,173,214,170,51,24,113,124,811,Jamal Murray
2017-2018,Denver Nuggets,PG,81,80,2565,479,1062,0.451,165,436,0.378,314,626,0.502,0.529,229,253,0.905,82,215,297,274,79,28,172,173,1352,Jamal Murray
2018-2019,Denver Nuggets,PG,75,74,2447,513,1173,0.437,152,414,0.367,361,759,0.476,0.502,189,223,0.848,65,252,317,363,67,27,158,153,1367,Jamal Murray
2019-2020,Denver Nuggets,PG,59,59,1904,408,894,0.456,112,324,0.346,296,570,0.519,0.519,163,185,0.881,45,191,236,284,67,17,127,102,1091,Jamal Murray
2020-2021,Denver Nuggets,PG,48,48,1704,378,792,0.477,129,316,0.408,249,476,0.523,0.559,133,153,0.869,37,157,194,231,64,13,108,95,1018,Jamal Murray
2022-2023,Denver Nuggets,PG,65,65,2133,473,1041,0.454,172,432,0.398,301,609,0.494,0.537,180,216,0.833,48,209,257,400,66,16,145,103,1298,Jamal Murray
2023-2024,Denver Nuggets,PG,59,59,1861,474,986,0.481,145,341,0.425,329,645,0.51,0.554,157,184,0.853,42,200,242,384,57,39,125,104,1250,Jamal Murray
2024-2025,Denver Nuggets,PG,23,23,841,159,367,0.433,48,135,0.356,111,232,0.478,0.499,75,90,0.833,10,85,95,146,35,13,54,42,441,Jamal Murray
2022-2023,Sacramento Kings,SF,80,78,2382,354,782,0.453,206,501,0.411,148,281,0.527,0.584,62,81,0.765,89,282,371,98,61,42,60,162,976,Keegan Murray
2023-2024,Sacramento Kings,SF,77,77,2588,443,975,0.454,183,511,0.358,260,464,0.56,0.548,103,124,0.831,106,314,420,129,79,59,64,205,1172,Keegan Murray
2024-2025,Sacramento Kings,PF,30,30,1072,140,334,0.419,49,166,0.295,91,168,0.542,0.493,34,39,0.872,67,160,227,44,21,25,29,88,363,Keegan Murray
2023-2024,Portland Trail Blazers,SF,62,29,1348,145,366,0.396,49,183,0.268,96,183,0.525,0.463,37,56,0.661,85,139,224,80,53,21,55,92,376,Kris Murray
2024-2025,Portland Trail Blazers,SF,24,0,296,39,86,0.453,11,35,0.314,28,51,0.549,0.517,8,20,0.4,23,28,51,18,10,3,13,25,97,Kris Murray
2013-2014,Atlanta Hawks,PF,20,0,215,31,73,0.425,0,3,0,31,70,0.443,0.425,14,14,1,17,35,52,7,3,10,12,29,76,Mike Muscala
2014-2015,Atlanta Hawks,PF,40,8,502,83,151,0.55,9,22,0.409,74,129,0.574,0.579,22,25,0.88,52,67,119,25,16,19,21,52,197,Mike Muscala
2015-2016,Atlanta Hawks,C,60,0,565,76,152,0.5,12,39,0.308,64,113,0.566,0.539,31,39,0.795,38,79,117,34,13,27,27,72,195,Mike Muscala
2016-2017,Atlanta Hawks,C,70,3,1237,170,337,0.504,46,110,0.418,124,227,0.546,0.573,49,64,0.766,76,164,240,95,30,41,55,97,435,Mike Muscala
2017-2018,Atlanta Hawks,C,53,7,1060,143,312,0.458,62,167,0.371,81,145,0.559,0.558,57,62,0.919,56,174,230,51,31,27,42,80,405,Mike Muscala
2018-2019,Total,PF,64,10,1306,145,361,0.402,89,256,0.348,56,105,0.533,0.525,70,85,0.824,57,187,244,76,22,38,48,130,449,Mike Muscala
2018-2019,Philadelphia 76ers,PF,47,6,1041,109,278,0.392,68,199,0.342,41,79,0.519,0.514,63,77,0.818,51,149,200,62,18,27,43,112,349,Mike Muscala
2018-2019,Los Angeles Lakers,PF,17,4,265,36,83,0.434,21,57,0.368,15,26,0.577,0.56,7,8,0.875,6,38,44,14,4,11,5,18,100,Mike Muscala
2019-2020,Oklahoma City Thunder,C,47,2,572,77,189,0.407,54,143,0.378,23,46,0.5,0.55,18,22,0.818,16,92,108,40,9,12,17,58,226,Mike Muscala
2020-2021,Oklahoma City Thunder,C,35,0,645,119,267,0.446,68,184,0.37,51,83,0.614,0.573,33,36,0.917,19,113,132,28,8,11,21,54,339,Mike Muscala
2021-2022,Oklahoma City Thunder,C,43,0,592,113,248,0.456,70,163,0.429,43,85,0.506,0.597,48,57,0.842,21,108,129,22,18,26,14,58,344,Mike Muscala
2022-2023,Total,C,63,9,945,131,292,0.449,81,207,0.391,50,85,0.588,0.587,40,52,0.769,37,166,203,50,15,24,23,98,383,Mike Muscala
2022-2023,Oklahoma City Thunder,C,43,5,622,89,203,0.438,56,142,0.394,33,61,0.541,0.576,31,39,0.795,23,112,135,38,11,19,14,70,265,Mike Muscala
2022-2023,Boston Celtics,C,20,4,323,42,89,0.472,25,65,0.385,17,24,0.708,0.612,9,13,0.692,14,54,68,12,4,5,9,28,118,Mike Muscala
2023-2024,Total,C,53,6,600,56,156,0.359,28,96,0.292,28,60,0.467,0.449,17,25,0.68,39,86,125,36,9,13,22,52,157,Mike Muscala
2023-2024,Washington Wizards,C,24,2,338,33,90,0.367,14,51,0.275,19,39,0.487,0.444,15,20,0.75,22,53,75,22,5,7,16,31,95,Mike Muscala
2023-2024,Detroit Pistons,C,13,4,171,15,44,0.341,13,34,0.382,2,10,0.2,0.489,2,4,0.5,10,19,29,10,3,5,2,13,45,Mike Muscala
2023-2024,Oklahoma City Thunder,C,16,0,91,8,22,0.364,1,11,0.091,7,11,0.636,0.386,0,1,0,7,14,21,4,1,1,4,8,17,Mike Muscala
2018-2019,Total,SF,42,0,440,46,140,0.329,29,89,0.326,17,51,0.333,0.432,12,20,0.6,9,27,36,37,14,1,21,25,133,Svi Mykhailiuk
2018-2019,Los Angeles Lakers,SF,39,0,420,44,132,0.333,27,85,0.318,17,47,0.362,0.436,12,20,0.6,8,26,34,33,13,1,20,25,127,Svi Mykhailiuk
2018-2019,Detroit Pistons,SF,3,0,20,2,8,0.25,2,4,0.5,0,4,0,0.375,0,0,,1,1,2,4,1,0,1,0,6,Svi Mykhailiuk
2019-2020,Detroit Pistons,SF,56,27,1265,166,405,0.41,115,285,0.404,51,120,0.425,0.552,57,70,0.814,17,87,104,106,41,4,61,87,504,Svi Mykhailiuk
2020-2021,Total,SF,66,14,1324,208,506,0.411,105,314,0.334,103,192,0.536,0.515,38,50,0.76,24,139,163,110,51,12,88,63,559,Svi Mykhailiuk
2020-2021,Detroit Pistons,SF,36,5,634,84,223,0.377,57,171,0.333,27,52,0.519,0.504,24,30,0.8,11,63,74,57,27,6,39,33,249,Svi Mykhailiuk
2020-2021,Oklahoma City Thunder,SF,30,9,690,124,283,0.438,48,143,0.336,76,140,0.543,0.523,14,20,0.7,13,76,89,53,24,6,49,30,310,Svi Mykhailiuk
2021-2022,Toronto Raptors,SF,56,5,716,91,234,0.389,41,134,0.306,50,100,0.5,0.476,32,37,0.865,20,72,92,45,26,4,32,54,255,Svi Mykhailiuk
2022-2023,Total,SF,32,8,468,77,173,0.445,42,99,0.424,35,74,0.473,0.566,26,39,0.667,15,38,53,53,15,4,24,23,222,Svi Mykhailiuk
2022-2023,New York Knicks,SF,13,0,40,6,12,0.5,6,10,0.6,0,2,0,0.75,3,5,0.6,0,7,7,1,1,0,2,1,21,Svi Mykhailiuk
2022-2023,Charlotte Hornets,SF,19,8,428,71,161,0.441,36,89,0.404,35,72,0.486,0.553,23,34,0.676,15,31,46,52,14,4,22,22,201,Svi Mykhailiuk
2023-2024,Boston Celtics,SF,41,2,413,57,137,0.416,42,108,0.389,15,29,0.517,0.569,6,9,0.667,11,40,51,35,11,1,12,19,162,Svi Mykhailiuk
2024-2025,Utah Jazz,SF,9,5,151,27,61,0.443,19,47,0.404,8,14,0.571,0.598,4,6,0.667,1,13,14,13,8,2,14,9,77,Svi Mykhailiuk
2015-2016,Los Angeles Lakers,PF,63,22,1266,158,300,0.527,1,10,0.1,157,290,0.541,0.528,32,47,0.681,101,211,312,44,54,23,41,124,349,Larry Nance Jr.
2016-2017,Los Angeles Lakers,PF,63,7,1442,190,361,0.526,10,36,0.278,180,325,0.554,0.54,59,80,0.738,120,249,369,96,82,39,56,149,449,Larry Nance Jr.
2017-2018,Total,C,66,26,1421,240,413,0.581,2,12,0.167,238,401,0.594,0.584,91,137,0.664,161,291,452,82,88,38,51,172,573,Larry Nance Jr.
2017-2018,Los Angeles Lakers,C,42,17,922,152,253,0.601,1,4,0.25,151,249,0.606,0.603,55,87,0.632,108,176,284,57,59,20,41,113,360,Larry Nance Jr.
2017-2018,Cleveland Cavaliers,C,24,9,499,88,160,0.55,1,8,0.125,87,152,0.572,0.553,36,50,0.72,53,115,168,25,29,18,10,59,213,Larry Nance Jr.
2018-2019,Cleveland Cavaliers,C,67,30,1795,249,479,0.52,33,98,0.337,216,381,0.567,0.554,96,134,0.716,168,384,552,214,100,40,97,192,627,Larry Nance Jr.
2019-2020,Cleveland Cavaliers,PF,56,10,1472,229,431,0.531,56,159,0.352,173,272,0.636,0.596,50,74,0.676,106,303,409,123,56,22,60,91,564,Larry Nance Jr.
2020-2021,Cleveland Cavaliers,PF,35,27,1091,128,272,0.471,41,114,0.36,87,158,0.551,0.546,30,49,0.612,54,181,235,107,61,17,55,72,327,Larry Nance Jr.
2021-2022,Total,PF,46,11,1040,129,247,0.522,23,70,0.329,106,177,0.599,0.569,40,57,0.702,72,176,248,81,43,20,37,84,321,Larry Nance Jr.
2021-2022,Portland Trail Blazers,C,37,11,858,102,198,0.515,19,62,0.306,83,136,0.61,0.563,32,49,0.653,58,151,209,73,38,13,27,67,255,Larry Nance Jr.
2021-2022,New Orleans Pelicans,PF,9,0,182,27,49,0.551,4,8,0.5,23,41,0.561,0.592,8,8,1,14,25,39,8,5,7,10,17,66,Larry Nance Jr.
2022-2023,New Orleans Pelicans,C,65,1,1381,186,305,0.61,14,42,0.333,172,263,0.654,0.633,55,79,0.696,106,248,354,119,56,37,42,133,441,Larry Nance Jr.
2023-2024,New Orleans Pelicans,C,61,0,1216,138,241,0.573,27,65,0.415,111,176,0.631,0.629,47,61,0.77,94,213,307,113,61,19,49,98,350,Larry Nance Jr.
2024-2025,Atlanta Hawks,PF,14,2,264,51,88,0.58,26,49,0.531,25,39,0.641,0.727,5,6,0.833,14,40,54,23,14,11,7,23,133,Larry Nance Jr.
2023-2024,Cleveland Cavaliers,PF,8,0,27,1,6,0.167,1,1,1,0,5,0,0.25,0,2,0,0,3,3,0,1,0,1,2,3,Pete Nance
2014-2015,Miami Heat,PG,51,10,1012,87,228,0.382,43,118,0.364,44,110,0.4,0.476,44,56,0.786,17,96,113,130,40,4,81,76,261,Shabazz Napier
2015-2016,Orlando Magic,PG,55,0,600,68,201,0.338,34,104,0.327,34,97,0.351,0.423,33,45,0.733,9,46,55,97,23,1,46,38,203,Shabazz Napier
2016-2017,Portland Trail Blazers,PG,53,2,512,73,183,0.399,34,92,0.37,39,91,0.429,0.492,38,49,0.776,8,53,61,67,32,2,41,38,218,Shabazz Napier
2017-2018,Portland Trail Blazers,PG,74,9,1535,223,531,0.42,82,218,0.376,141,313,0.45,0.497,116,138,0.841,26,144,170,150,81,14,90,84,644,Shabazz Napier
2018-2019,Brooklyn Nets,PG,56,2,983,169,435,0.389,76,228,0.333,93,207,0.449,0.476,115,138,0.833,18,82,100,143,41,16,66,67,529,Shabazz Napier
2019-2020,Total,PG,56,32,1344,188,456,0.412,76,240,0.317,112,216,0.519,0.496,126,153,0.824,26,132,158,262,69,11,128,101,578,Shabazz Napier
2019-2020,Minnesota Timberwolves,PG,36,22,856,114,283,0.403,47,159,0.296,67,124,0.54,0.486,72,88,0.818,17,93,110,187,40,7,76,62,347,Shabazz Napier
2019-2020,Washington Wizards,PG,20,10,488,74,173,0.428,29,81,0.358,45,92,0.489,0.512,54,65,0.831,9,39,48,75,29,4,52,39,231,Shabazz Napier
2022-2023,Indiana Pacers,SG,75,63,2073,284,644,0.441,92,263,0.35,192,381,0.504,0.512,49,62,0.79,35,164,199,341,70,13,126,179,709,Andrew Nembhard
2023-2024,Indiana Pacers,PG,68,47,1697,260,522,0.498,61,171,0.357,199,351,0.567,0.557,45,56,0.804,36,105,141,280,63,6,101,143,626,Andrew Nembhard
2024-2025,Indiana Pacers,SG,17,17,447,67,140,0.479,13,40,0.325,54,100,0.54,0.525,33,37,0.892,6,41,47,80,14,2,31,29,180,Andrew Nembhard
2021-2022,Cleveland Cavaliers,SG,14,0,63,6,18,0.333,0,2,0,6,16,0.375,0.333,3,4,0.75,3,4,7,12,1,0,3,2,15,RJ Nembhard Jr.
2020-2021,Boston Celtics,SF,46,1,669,78,178,0.438,40,108,0.37,38,70,0.543,0.551,22,28,0.786,28,99,127,23,15,9,23,87,218,Aaron Nesmith
2021-2022,Boston Celtics,SF,52,3,574,72,182,0.396,31,115,0.27,41,67,0.612,0.481,21,26,0.808,15,74,89,22,20,5,31,70,196,Aaron Nesmith
2022-2023,Indiana Pacers,SF,73,60,1816,252,590,0.427,115,314,0.366,137,276,0.496,0.525,119,142,0.838,62,215,277,98,55,34,75,235,738,Aaron Nesmith
2023-2024,Indiana Pacers,SF,72,47,1995,315,635,0.496,140,334,0.419,175,301,0.581,0.606,107,137,0.781,63,212,275,108,65,49,64,241,877,Aaron Nesmith
2024-2025,Indiana Pacers,SF,6,6,136,19,36,0.528,6,11,0.545,13,25,0.52,0.611,11,13,0.846,4,20,24,6,4,2,5,24,55,Aaron Nesmith
2015-2016,Utah Jazz,PG,81,53,1499,180,418,0.431,64,162,0.395,116,256,0.453,0.507,52,70,0.743,17,103,120,174,62,2,109,122,476,Raul Neto
2016-2017,Utah Jazz,PG,40,0,346,41,91,0.451,10,31,0.323,31,60,0.517,0.505,8,9,0.889,4,26,30,34,21,5,15,48,100,Raul Neto
2017-2018,Utah Jazz,PG,41,0,498,69,151,0.457,19,47,0.404,50,104,0.481,0.52,26,35,0.743,7,42,49,75,13,4,36,38,183,Raul Neto
2018-2019,Utah Jazz,PG,37,1,474,74,161,0.46,20,60,0.333,54,101,0.535,0.522,28,33,0.848,6,56,62,93,14,4,35,49,196,Raul Neto
2019-2020,Philadelphia 76ers,PG,54,3,668,101,222,0.455,34,88,0.386,67,134,0.5,0.532,39,47,0.83,11,50,61,95,24,6,47,50,275,Raul Neto
2020-2021,Washington Wizards,PG,64,22,1403,209,447,0.468,64,164,0.39,145,283,0.512,0.539,75,85,0.882,28,128,156,146,73,6,53,109,557,Raul Neto
2021-2022,Washington Wizards,PG,70,19,1372,204,441,0.463,35,120,0.292,169,321,0.526,0.502,83,108,0.769,13,121,134,217,55,3,79,104,526,Raul Neto
2022-2023,Cleveland Cavaliers,PG,48,1,505,57,110,0.518,12,42,0.286,45,68,0.662,0.573,31,34,0.912,10,36,46,79,17,4,24,49,157,Raul Neto
2024-2025,Indiana Pacers,SG,5,0,8,1,6,0.167,0,3,0,1,3,0.333,0.167,1,1,1,0,0,0,1,0,0,1,2,3,Tristen Newton
2016-2017,Indiana Pacers,PF,23,0,93,9,36,0.25,1,12,0.083,8,24,0.333,0.264,2,2,1,2,15,17,5,3,0,5,6,21,Georges Niang
2017-2018,Utah Jazz,PF,9,0,32,4,11,0.364,0,4,0,4,7,0.571,0.364,1,2,0.5,3,6,9,3,2,0,3,1,9,Georges Niang
2018-2019,Utah Jazz,PF,59,0,516,86,181,0.475,43,105,0.41,43,76,0.566,0.594,20,24,0.833,11,76,87,35,10,6,23,57,235,Georges Niang
2019-2020,Utah Jazz,PF,66,1,923,141,322,0.438,90,225,0.4,51,97,0.526,0.578,20,24,0.833,15,112,127,44,18,5,30,75,392,Georges Niang
2020-2021,Utah Jazz,PF,72,10,1154,177,405,0.437,124,292,0.425,53,113,0.469,0.59,22,23,0.957,28,148,176,59,25,8,51,116,500,Georges Niang
2021-2022,Philadelphia 76ers,PF,76,7,1736,246,563,0.437,156,387,0.403,90,176,0.511,0.575,52,59,0.881,25,178,203,102,30,13,59,190,700,Georges Niang
2022-2023,Philadelphia 76ers,PF,78,1,1512,222,502,0.442,154,384,0.401,68,118,0.576,0.596,39,45,0.867,19,166,185,77,30,14,54,145,637,Georges Niang
2023-2024,Cleveland Cavaliers,PF,82,10,1831,284,632,0.449,149,396,0.376,135,236,0.572,0.567,51,60,0.85,22,256,278,98,30,18,72,192,768,Georges Niang
2024-2025,Cleveland Cavaliers,PF,31,1,643,102,217,0.47,52,140,0.371,50,77,0.649,0.59,11,14,0.786,23,102,125,43,11,5,30,71,267,Georges Niang
2021-2022,Houston Rockets,SG,24,0,261,27,67,0.403,7,26,0.269,20,41,0.488,0.455,16,30,0.533,7,26,33,40,15,0,26,21,77,Daishen Nix
2022-2023,Houston Rockets,PG,57,7,914,81,237,0.342,40,140,0.286,41,97,0.423,0.426,24,36,0.667,18,80,98,132,31,7,86,59,226,Daishen Nix
2023-2024,Minnesota Timberwolves,PG,15,0,50,9,24,0.375,6,17,0.353,3,7,0.429,0.5,3,6,0.5,1,2,3,6,5,0,5,2,27,Daishen Nix
2024-2025,Minnesota Timberwolves,PG,3,0,13,0,1,0,0,1,0,0,0,,0,1,2,0.5,0,4,4,3,0,0,4,1,1,Daishen Nix
2020-2021,Denver Nuggets,PF,42,1,397,50,104,0.481,24,59,0.407,26,45,0.578,0.596,12,15,0.8,14,51,65,10,8,4,7,29,136,Zeke Nnaji
2021-2022,Denver Nuggets,PF,41,1,698,96,186,0.516,37,80,0.463,59,106,0.557,0.616,41,65,0.631,56,91,147,17,16,13,23,79,270,Zeke Nnaji
2022-2023,Denver Nuggets,PF,53,5,728,110,196,0.561,17,65,0.262,93,131,0.71,0.605,40,62,0.645,65,73,138,18,17,23,31,105,277,Zeke Nnaji
2023-2024,Denver Nuggets,PF,58,0,576,69,149,0.463,6,23,0.261,63,126,0.5,0.483,42,62,0.677,61,65,126,32,15,38,27,81,186,Zeke Nnaji
2024-2025,Denver Nuggets,PF,18,0,84,10,24,0.417,0,9,0,10,15,0.667,0.417,1,5,0.2,2,5,7,4,1,2,2,7,21,Zeke Nnaji
2014-2015,Philadelphia 76ers,C,75,71,2311,302,653,0.462,0,0,,302,653,0.462,0.462,140,230,0.609,185,426,611,128,133,142,146,208,744,Nerlens Noel
2015-2016,Philadelphia 76ers,C,67,62,1965,306,587,0.521,1,2,0.5,305,585,0.521,0.522,134,227,0.59,154,388,542,122,118,100,158,192,747,Nerlens Noel
2016-2017,Total,C,51,19,1047,184,309,0.595,0,1,0,184,308,0.597,0.595,77,111,0.694,93,201,294,50,65,50,51,126,445,Nerlens Noel
2016-2017,Philadelphia 76ers,C,29,7,564,107,175,0.611,0,1,0,107,174,0.615,0.611,43,63,0.683,46,98,144,30,43,26,29,71,257,Nerlens Noel
2016-2017,Dallas Mavericks,C,22,12,483,77,134,0.575,0,0,,77,134,0.575,0.575,34,48,0.708,47,103,150,20,22,24,22,55,188,Nerlens Noel
2017-2018,Dallas Mavericks,C,30,6,472,55,105,0.524,0,1,0,55,104,0.529,0.524,21,28,0.75,48,120,168,20,31,22,26,59,131,Nerlens Noel
2018-2019,Oklahoma City Thunder,C,77,2,1055,162,276,0.587,0,0,,162,276,0.587,0.587,54,79,0.684,127,198,325,45,66,96,48,166,378,Nerlens Noel
2019-2020,Oklahoma City Thunder,C,61,7,1127,184,269,0.684,1,3,0.333,183,266,0.688,0.686,80,106,0.755,91,209,300,57,59,91,66,166,449,Nerlens Noel
2020-2021,New York Knicks,C,64,41,1547,137,223,0.614,0,3,0,137,220,0.623,0.614,50,70,0.714,142,266,408,46,70,141,65,176,324,Nerlens Noel
2021-2022,New York Knicks,C,25,11,562,32,60,0.533,0,3,0,32,57,0.561,0.533,21,30,0.7,48,93,141,23,30,31,20,67,85,Nerlens Noel
2022-2023,Total,C,17,4,195,13,36,0.361,1,2,0.5,12,34,0.353,0.375,8,12,0.667,10,36,46,10,16,10,13,32,35,Nerlens Noel
2022-2023,Detroit Pistons,C,14,3,152,12,30,0.4,1,2,0.5,11,28,0.393,0.417,7,10,0.7,7,30,37,7,13,9,8,25,32,Nerlens Noel
2022-2023,Brooklyn Nets,C,3,1,43,1,6,0.167,0,0,,1,6,0.167,0.167,1,2,0.5,3,6,9,3,3,1,5,7,3,Nerlens Noel
2019-2020,Minnesota Timberwolves,SG,15,0,151,19,53,0.358,3,26,0.115,16,27,0.593,0.387,16,17,0.941,3,10,13,19,3,1,3,11,57,Jaylen Nowell
2020-2021,Minnesota Timberwolves,SG,42,0,759,142,335,0.424,50,150,0.333,92,185,0.497,0.499,45,55,0.818,19,76,95,62,22,12,28,72,379,Jaylen Nowell
2021-2022,Minnesota Timberwolves,SG,62,1,975,196,413,0.475,63,160,0.394,133,253,0.526,0.551,72,92,0.783,22,101,123,130,27,10,36,73,527,Jaylen Nowell
2022-2023,Minnesota Timberwolves,SG,65,2,1252,280,625,0.448,67,232,0.289,213,393,0.542,0.502,77,99,0.778,36,134,170,132,42,5,65,101,704,Jaylen Nowell
2023-2024,Total,SG,13,1,214,34,78,0.436,6,29,0.207,28,49,0.571,0.474,7,9,0.778,6,18,24,19,4,2,7,15,81,Jaylen Nowell
2023-2024,Memphis Grizzlies,SG,9,1,156,22,55,0.4,4,23,0.174,18,32,0.563,0.436,3,3,1,3,11,14,16,3,0,5,13,51,Jaylen Nowell
2023-2024,Detroit Pistons,SG,4,0,58,12,23,0.522,2,6,0.333,10,17,0.588,0.565,4,6,0.667,3,7,10,3,1,2,2,2,30,Jaylen Nowell
2024-2025,New Orleans Pelicans,SG,8,0,168,26,73,0.356,8,27,0.296,18,46,0.391,0.411,7,11,0.636,6,14,20,18,1,4,8,9,67,Jaylen Nowell
2023-2024,Toronto Raptors,SG,1,0,4,0,1,0,0,0,0,1,0,0,2,2,1,2,0,2,2,1,0,0,0,2,0,Markquis Nowell
2017-2018,New York Knicks,PG,78,9,1706,182,500,0.364,50,157,0.318,132,343,0.385,0.414,49,68,0.721,37,140,177,250,65,18,131,181,463,Frank Ntilikina
2018-2019,New York Knicks,PG,43,16,904,95,282,0.337,33,115,0.287,62,167,0.371,0.395,23,30,0.767,12,75,87,121,30,14,56,104,246,Frank Ntilikina
2019-2020,New York Knicks,PG,57,26,1187,131,333,0.393,44,137,0.321,87,196,0.444,0.459,51,59,0.864,23,98,121,172,54,16,71,142,357,Frank Ntilikina
2020-2021,New York Knicks,PG,33,4,322,29,79,0.367,23,48,0.479,6,31,0.194,0.513,8,18,0.444,6,25,31,19,18,4,11,45,89,Frank Ntilikina
2021-2022,Dallas Mavericks,SG,58,5,685,89,223,0.399,38,111,0.342,51,112,0.455,0.484,24,25,0.96,12,67,79,69,27,7,31,61,240,Frank Ntilikina
2022-2023,Dallas Mavericks,SG,47,5,607,48,132,0.364,17,67,0.254,31,65,0.477,0.428,22,33,0.667,7,55,62,58,16,7,29,65,135,Frank Ntilikina
2023-2024,Charlotte Hornets,PG,5,0,43,1,9,0.111,1,8,0.125,0,1,0,0.167,2,2,1,1,5,6,4,0,0,1,4,5,Frank Ntilikina
2019-2020,Miami Heat,PG,67,67,1962,401,914,0.439,137,391,0.35,264,523,0.505,0.514,85,100,0.85,21,159,180,220,56,15,114,152,1024,Kendrick Nunn
2020-2021,Miami Heat,PG,56,44,1650,319,658,0.485,122,320,0.381,197,338,0.583,0.578,56,60,0.933,21,158,179,148,52,14,80,108,816,Kendrick Nunn
2022-2023,Total,SG,70,2,964,191,450,0.424,79,223,0.354,112,227,0.493,0.512,35,41,0.854,15,94,109,90,28,7,66,66,496,Kendrick Nunn
2022-2023,Los Angeles Lakers,SG,39,2,528,102,251,0.406,41,126,0.325,61,125,0.488,0.488,17,21,0.81,5,50,55,34,11,3,31,35,262,Kendrick Nunn
2022-2023,Washington Wizards,SG,31,0,436,89,199,0.447,38,97,0.392,51,102,0.5,0.543,18,20,0.9,10,44,54,56,17,4,35,31,234,Kendrick Nunn
2014-2015,Denver Nuggets,C,62,27,1103,171,383,0.446,0,2,0,171,381,0.449,0.446,84,132,0.636,125,257,382,50,52,68,86,207,426,Jusuf Nurkić
2015-2016,Denver Nuggets,C,32,3,547,101,242,0.417,0,3,0,101,239,0.423,0.417,61,99,0.616,65,110,175,40,24,44,55,91,263,Jusuf Nurkić
2016-2017,Total,C,65,48,1391,271,534,0.507,0,1,0,271,533,0.508,0.507,120,210,0.571,154,313,467,123,50,74,143,161,662,Jusuf Nurkić
2016-2017,Denver Nuggets,C,45,29,807,151,298,0.507,0,0,,151,298,0.507,0.507,56,113,0.496,89,171,260,60,25,36,81,88,358,Jusuf Nurkić
2016-2017,Portland Trail Blazers,C,20,19,584,120,236,0.508,0,1,0,120,235,0.511,0.508,64,97,0.66,65,142,207,63,25,38,62,73,304,Jusuf Nurkić
2017-2018,Portland Trail Blazers,C,79,79,2088,480,951,0.505,0,7,0,480,944,0.508,0.505,172,273,0.63,189,519,708,143,64,111,183,247,1132,Jusuf Nurkić
2018-2019,Portland Trail Blazers,C,72,72,1974,420,826,0.508,3,29,0.103,417,797,0.523,0.51,282,365,0.773,243,505,748,233,71,103,168,250,1125,Jusuf Nurkić
2019-2020,Portland Trail Blazers,C,8,8,253,54,109,0.495,2,10,0.2,52,99,0.525,0.505,31,35,0.886,23,59,82,32,11,16,19,39,141,Jusuf Nurkić
2020-2021,Portland Trail Blazers,C,37,37,880,171,333,0.514,12,30,0.4,159,303,0.525,0.532,70,113,0.619,86,246,332,125,38,39,73,103,424,Jusuf Nurkić
2021-2022,Portland Trail Blazers,C,56,56,1579,321,600,0.535,15,56,0.268,306,544,0.563,0.548,185,268,0.69,167,452,619,157,62,34,143,189,842,Jusuf Nurkić
2022-2023,Portland Trail Blazers,C,52,52,1391,262,505,0.519,43,119,0.361,219,386,0.567,0.561,127,192,0.661,114,357,471,149,43,44,119,185,694,Jusuf Nurkić
2023-2024,Phoenix Suns,C,76,76,2078,320,627,0.51,22,90,0.244,298,537,0.555,0.528,167,261,0.64,224,613,837,301,81,80,175,254,829,Jusuf Nurkić
2024-2025,Phoenix Suns,C,23,23,558,70,155,0.452,17,56,0.304,53,99,0.535,0.506,45,65,0.692,44,175,219,43,22,15,53,70,202,Jusuf Nurkić
2016-2017,Los Angeles Lakers,SG,20,2,397,47,81,0.58,1,5,0.2,46,76,0.605,0.586,25,39,0.641,17,46,63,14,13,7,11,36,120,David Nwaba
2017-2018,Chicago Bulls,SG,70,21,1646,202,423,0.478,18,52,0.346,184,371,0.496,0.499,133,203,0.655,89,237,326,104,59,29,77,158,555,David Nwaba
2018-2019,Cleveland Cavaliers,SF,51,14,984,126,262,0.481,24,75,0.32,102,187,0.545,0.527,58,85,0.682,41,122,163,54,36,17,29,106,334,David Nwaba
2019-2020,Brooklyn Nets,SF,20,0,268,37,71,0.521,12,28,0.429,25,43,0.581,0.606,18,27,0.667,8,37,45,8,11,12,8,32,104,David Nwaba
2020-2021,Houston Rockets,SF,30,9,679,106,218,0.486,17,63,0.27,89,155,0.574,0.525,47,68,0.691,40,78,118,31,30,21,17,60,276,David Nwaba
2021-2022,Houston Rockets,SF,46,4,609,85,176,0.483,15,49,0.306,70,127,0.551,0.526,48,67,0.716,41,110,151,35,28,20,21,55,233,David Nwaba
2020-2021,Milwaukee Bucks,SF,30,2,274,62,135,0.459,28,62,0.452,34,73,0.466,0.563,19,25,0.76,9,51,60,7,16,7,24,22,171,Jordan Nwora
2021-2022,Milwaukee Bucks,SF,62,13,1185,186,462,0.403,79,227,0.348,107,235,0.455,0.488,36,43,0.837,37,184,221,59,25,17,57,78,487,Jordan Nwora
2022-2023,Total,SF,62,14,1188,194,445,0.436,86,211,0.408,108,234,0.462,0.533,68,86,0.791,51,178,229,88,24,14,66,74,542,Jordan Nwora
2022-2023,Milwaukee Bucks,SF,38,3,597,76,197,0.386,40,102,0.392,36,95,0.379,0.487,37,43,0.86,29,88,117,38,12,7,34,34,229,Jordan Nwora
2022-2023,Indiana Pacers,SF,24,11,591,118,248,0.476,46,109,0.422,72,139,0.518,0.569,31,43,0.721,22,90,112,50,12,7,32,40,313,Jordan Nwora
2023-2024,Total,SF,52,1,712,138,299,0.462,44,131,0.336,94,168,0.56,0.535,44,53,0.83,28,121,149,62,26,13,53,48,364,Jordan Nwora
2023-2024,Indiana Pacers,SF,18,0,183,37,82,0.451,11,36,0.306,26,46,0.565,0.518,9,11,0.818,8,25,33,18,6,1,12,19,94,Jordan Nwora
2023-2024,Toronto Raptors,SF,34,1,529,101,217,0.465,33,95,0.347,68,122,0.557,0.541,35,42,0.833,20,96,116,44,20,12,41,29,270,Jordan Nwora
2017-2018,Utah Jazz,SF,69,4,1150,120,284,0.423,42,118,0.356,78,166,0.47,0.496,61,76,0.803,25,211,236,95,36,16,55,105,343,Royce O'Neale
2018-2019,Utah Jazz,SF,82,16,1671,163,343,0.475,68,176,0.386,95,167,0.569,0.574,32,42,0.762,22,263,285,124,54,24,70,172,426,Royce O'Neale
2019-2020,Utah Jazz,SF,71,62,2049,158,365,0.433,92,244,0.377,66,121,0.545,0.559,42,55,0.764,27,362,389,180,59,32,61,202,450,Royce O'Neale
2020-2021,Utah Jazz,SF,71,71,2241,175,394,0.444,107,278,0.385,68,116,0.586,0.58,39,46,0.848,88,397,485,181,57,32,83,182,496,Royce O'Neale
2021-2022,Utah Jazz,SF,77,77,2406,203,444,0.457,119,306,0.389,84,138,0.609,0.591,45,56,0.804,64,304,368,191,86,32,79,183,570,Royce O'Neale
2022-2023,Brooklyn Nets,SF,76,53,2409,229,593,0.386,163,419,0.389,66,174,0.379,0.524,50,69,0.725,55,329,384,283,65,49,114,239,671,Royce O'Neale
2023-2024,Total,SF,79,14,1954,214,539,0.397,156,422,0.37,58,117,0.496,0.542,24,35,0.686,60,317,377,219,59,44,73,174,608,Royce O'Neale
2023-2024,Brooklyn Nets,SF,49,6,1202,126,325,0.388,97,265,0.366,29,60,0.483,0.537,15,22,0.682,38,183,221,137,32,29,51,120,364,Royce O'Neale
2023-2024,Phoenix Suns,SF,30,8,752,88,214,0.411,59,157,0.376,29,57,0.509,0.549,9,13,0.692,22,134,156,82,27,15,22,54,244,Royce O'Neale
2024-2025,Phoenix Suns,SF,30,9,805,115,254,0.453,78,174,0.448,37,80,0.463,0.606,16,21,0.762,31,141,172,73,30,18,31,70,324,Royce O'Neale
2015-2016,Philadelphia 76ers,C,53,48,1591,397,781,0.508,1,6,0.167,396,775,0.511,0.509,133,194,0.686,122,251,373,65,22,61,124,140,928,Jahlil Okafor
2016-2017,Philadelphia 76ers,C,50,33,1134,242,471,0.514,0,0,,242,471,0.514,0.514,106,158,0.671,81,159,240,58,20,49,91,122,590,Jahlil Okafor
2017-2018,Total,C,28,0,353,77,138,0.558,1,4,0.25,76,134,0.567,0.562,21,29,0.724,21,64,85,12,3,18,21,51,176,Jahlil Okafor
2017-2018,Philadelphia 76ers,C,2,0,25,4,9,0.444,0,0,,4,9,0.444,0.444,2,4,0.5,4,5,9,1,0,2,3,7,10,Jahlil Okafor
2017-2018,Brooklyn Nets,C,26,0,328,73,129,0.566,1,4,0.25,72,125,0.576,0.57,19,25,0.76,17,59,76,11,3,16,18,44,166,Jahlil Okafor
2018-2019,New Orleans Pelicans,C,59,24,935,212,362,0.586,1,5,0.2,211,357,0.591,0.587,59,89,0.663,82,196,278,40,15,40,52,96,484,Jahlil Okafor
2019-2020,New Orleans Pelicans,C,30,9,467,101,162,0.623,1,3,0.333,100,159,0.629,0.627,40,62,0.645,48,79,127,37,7,22,38,67,243,Jahlil Okafor
2020-2021,Detroit Pistons,C,27,2,347,63,102,0.618,2,9,0.222,61,93,0.656,0.627,17,24,0.708,23,43,66,13,6,5,21,39,145,Jahlil Okafor
2020-2021,Orlando Magic,PF,45,19,1133,135,324,0.417,49,141,0.348,86,183,0.47,0.492,30,40,0.75,42,139,181,101,48,22,38,48,349,Chuma Okeke
2021-2022,Orlando Magic,PF,70,20,1749,216,575,0.376,118,371,0.318,98,204,0.48,0.478,55,65,0.846,47,300,347,118,97,42,57,95,605,Chuma Okeke
2022-2023,Orlando Magic,SF,27,8,518,43,122,0.352,26,86,0.302,17,36,0.472,0.459,16,21,0.762,26,70,96,37,19,11,17,40,128,Chuma Okeke
2023-2024,Orlando Magic,SF,47,8,432,40,112,0.357,23,82,0.28,17,30,0.567,0.46,4,7,0.571,18,62,80,20,9,7,16,19,107,Chuma Okeke
2018-2019,Minnesota Timberwolves,SG,74,52,1757,196,508,0.386,60,215,0.279,136,293,0.464,0.445,118,162,0.728,41,177,218,91,88,33,63,166,570,Josh Okogie
2019-2020,Minnesota Timberwolves,SG,62,28,1547,170,398,0.427,41,154,0.266,129,244,0.529,0.479,152,191,0.796,87,181,268,99,68,26,87,139,533,Josh Okogie
2020-2021,Minnesota Timberwolves,SG,59,37,1197,102,254,0.402,29,108,0.269,73,146,0.5,0.459,83,108,0.769,63,93,156,63,54,28,43,123,316,Josh Okogie
2021-2022,Minnesota Timberwolves,SG,49,6,516,42,104,0.404,14,47,0.298,28,57,0.491,0.471,35,51,0.686,29,41,70,25,26,12,23,53,133,Josh Okogie
2022-2023,Phoenix Suns,SG,72,26,1350,162,414,0.391,66,197,0.335,96,217,0.442,0.471,139,192,0.724,109,142,251,105,56,34,63,114,529,Josh Okogie
2023-2024,Phoenix Suns,SG,60,11,960,86,206,0.417,29,94,0.309,57,112,0.509,0.488,76,102,0.745,74,80,154,64,48,24,36,68,277,Josh Okogie
2024-2025,Phoenix Suns,SG,18,1,255,43,90,0.478,13,33,0.394,30,57,0.526,0.55,16,23,0.696,23,29,52,10,17,5,13,17,115,Josh Okogie
2020-2021,Atlanta Hawks,C,50,4,601,96,149,0.644,0,3,0,96,146,0.658,0.644,36,57,0.632,62,101,163,18,23,33,29,100,228,Onyeka Okongwu
2021-2022,Atlanta Hawks,C,48,6,992,156,226,0.69,0,0,,156,226,0.69,0.69,80,110,0.727,115,168,283,53,31,60,44,149,392,Onyeka Okongwu
2022-2023,Atlanta Hawks,C,80,18,1849,317,497,0.638,4,13,0.308,313,484,0.647,0.642,153,196,0.781,217,359,576,81,56,107,81,251,791,Onyeka Okongwu
2023-2024,Atlanta Hawks,C,55,8,1405,223,365,0.611,23,69,0.333,200,296,0.676,0.642,92,116,0.793,145,231,376,74,26,60,45,162,561,Onyeka Okongwu
2024-2025,Atlanta Hawks,C,25,0,594,110,203,0.542,10,41,0.244,100,162,0.617,0.567,53,68,0.779,63,103,166,35,17,17,21,55,283,Onyeka Okongwu
2020-2021,Cleveland Cavaliers,SG,67,67,2173,235,559,0.42,62,214,0.29,173,345,0.501,0.476,114,157,0.726,68,138,206,128,62,24,86,185,646,Isaac Okoro
2021-2022,Cleveland Cavaliers,SF,67,61,1981,207,431,0.48,55,157,0.35,152,274,0.555,0.544,119,155,0.768,72,129,201,121,56,22,58,164,588,Isaac Okoro
2022-2023,Cleveland Cavaliers,SF,76,46,1652,175,354,0.494,62,171,0.363,113,183,0.617,0.582,78,103,0.757,52,135,187,87,56,30,42,158,490,Isaac Okoro
2023-2024,Cleveland Cavaliers,SF,69,42,1887,235,480,0.49,84,215,0.391,151,265,0.57,0.577,93,137,0.679,67,139,206,132,57,34,54,140,647,Isaac Okoro
2024-2025,Cleveland Cavaliers,SG,23,16,483,53,107,0.495,30,61,0.492,23,46,0.5,0.636,15,21,0.714,21,31,52,40,17,10,9,47,151,Isaac Okoro
2019-2020,Miami Heat,PF,5,0,26,3,5,0.6,0,1,0,3,4,0.75,0.6,1,2,0.5,1,4,5,1,2,1,1,2,7,KZ Okpala
2020-2021,Miami Heat,PF,37,9,447,36,96,0.375,12,50,0.24,24,46,0.522,0.438,8,15,0.533,21,47,68,19,10,11,15,59,92,KZ Okpala
2021-2022,Miami Heat,PF,21,0,244,30,69,0.435,9,26,0.346,21,43,0.488,0.5,8,11,0.727,11,30,41,14,4,7,5,25,77,KZ Okpala
2022-2023,Sacramento Kings,PF,35,3,248,16,38,0.421,7,21,0.333,9,17,0.529,0.513,7,8,0.875,7,27,34,13,7,7,7,39,46,KZ Okpala
2013-2014,Orlando Magic,PG,80,44,2487,392,936,0.419,74,226,0.327,318,710,0.448,0.458,248,318,0.78,43,286,329,327,129,37,256,210,1106,Victor Oladipo
2014-2015,Orlando Magic,SG,72,71,2573,473,1086,0.436,84,248,0.339,389,838,0.464,0.474,262,320,0.819,51,251,302,295,120,19,204,187,1292,Victor Oladipo
2015-2016,Orlando Magic,SG,72,52,2379,425,970,0.438,98,282,0.348,327,688,0.475,0.489,205,247,0.83,48,297,345,282,116,54,153,174,1153,Victor Oladipo
2016-2017,Oklahoma City Thunder,SG,67,67,2222,412,932,0.442,127,352,0.361,285,580,0.491,0.51,116,154,0.753,39,252,291,176,78,21,119,155,1067,Victor Oladipo
2017-2018,Indiana Pacers,SG,75,75,2552,640,1342,0.477,161,434,0.371,479,908,0.528,0.537,294,368,0.799,47,343,390,323,177,57,219,175,1735,Victor Oladipo
2018-2019,Indiana Pacers,SG,36,36,1147,249,588,0.423,74,216,0.343,175,372,0.47,0.486,103,141,0.73,21,181,202,186,60,11,82,72,675,Victor Oladipo
2019-2020,Indiana Pacers,SG,19,16,528,97,246,0.394,33,104,0.317,64,142,0.451,0.461,48,59,0.814,9,66,75,56,17,4,47,36,275,Victor Oladipo
2020-2021,Total,SG,33,33,1080,235,576,0.408,78,239,0.326,157,337,0.466,0.476,104,138,0.754,12,148,160,151,46,14,83,81,652,Victor Oladipo
2020-2021,Indiana Pacers,SG,9,9,300,64,152,0.421,25,69,0.362,39,83,0.47,0.503,27,37,0.73,1,50,51,38,15,2,18,23,180,Victor Oladipo
2020-2021,Houston Rockets,SG,20,20,669,155,381,0.407,49,153,0.32,106,228,0.465,0.471,65,83,0.783,8,87,95,99,24,10,51,45,424,Victor Oladipo
2020-2021,Miami Heat,SG,4,4,111,16,43,0.372,4,17,0.235,12,26,0.462,0.419,12,18,0.667,3,11,14,14,7,2,14,13,48,Victor Oladipo
2021-2022,Miami Heat,SG,8,1,173,35,73,0.479,15,36,0.417,20,37,0.541,0.582,14,19,0.737,3,20,23,28,5,1,16,13,99,Victor Oladipo
2022-2023,Miami Heat,SG,42,2,1106,160,403,0.397,70,212,0.33,90,191,0.471,0.484,59,79,0.747,16,112,128,146,57,12,87,99,449,Victor Oladipo
2024-2025,Los Angeles Lakers,PG,1,0,8,1,3,0.333,1,3,0.333,0,0,0.5,0,0,0,0,0,0,0,0,1,0,3,0,,Quincy Olivari
2020-2021,Houston Rockets,SF,4,0,87,19,33,0.576,4,13,0.308,15,20,0.75,0.636,1,4,0.25,5,16,21,5,2,4,3,11,43,Cameron Oliver
2021-2022,Atlanta Hawks,SF,2,0,43,10,15,0.667,1,3,0.333,9,12,0.75,0.7,2,3,0.667,2,4,6,3,1,1,0,5,23,Cameron Oliver
2013-2014,Boston Celtics,C,70,9,1400,234,502,0.466,40,114,0.351,194,388,0.5,0.506,99,122,0.811,140,225,365,109,35,27,106,227,607,Kelly Olynyk
2014-2015,Boston Celtics,C,64,13,1423,251,528,0.475,61,175,0.349,190,353,0.538,0.533,93,136,0.684,92,211,303,109,64,39,98,213,656,Kelly Olynyk
2015-2016,Boston Celtics,C,69,8,1395,253,556,0.455,85,210,0.405,168,346,0.486,0.531,96,128,0.75,72,209,281,105,52,33,74,163,687,Kelly Olynyk
2016-2017,Boston Celtics,C,75,6,1538,260,508,0.512,68,192,0.354,192,316,0.608,0.579,90,123,0.732,73,288,361,148,43,29,96,207,678,Kelly Olynyk
2017-2018,Miami Heat,PF,76,22,1779,316,636,0.497,106,280,0.379,210,356,0.59,0.58,134,174,0.77,89,342,431,207,62,35,147,222,872,Kelly Olynyk
2018-2019,Miami Heat,PF,79,36,1812,261,564,0.463,113,319,0.354,148,245,0.604,0.563,152,185,0.822,72,303,375,140,53,37,114,183,787,Kelly Olynyk
2019-2020,Miami Heat,C,67,9,1300,184,398,0.462,95,234,0.406,89,164,0.543,0.582,86,100,0.86,44,261,305,116,45,23,71,173,549,Kelly Olynyk
2020-2021,Total,PF,70,62,1997,337,697,0.484,126,368,0.342,211,329,0.641,0.574,145,175,0.829,87,402,489,203,79,42,126,207,945,Kelly Olynyk
2020-2021,Miami Heat,C,43,38,1157,162,376,0.431,77,243,0.317,85,133,0.639,0.533,31,40,0.775,44,217,261,91,40,26,55,123,432,Kelly Olynyk
2020-2021,Houston Rockets,PF,27,24,840,175,321,0.545,49,125,0.392,126,196,0.643,0.621,114,135,0.844,43,185,228,112,39,16,71,84,513,Kelly Olynyk
2021-2022,Detroit Pistons,C,40,1,764,128,286,0.448,40,119,0.336,88,167,0.527,0.517,69,89,0.775,54,123,177,111,31,19,58,100,365,Kelly Olynyk
2022-2023,Utah Jazz,C,68,68,1942,278,557,0.499,93,236,0.394,185,321,0.576,0.583,198,232,0.853,82,338,420,252,60,37,168,232,847,Kelly Olynyk
2023-2024,Total,C,78,27,1759,276,497,0.555,60,155,0.387,216,342,0.632,0.616,150,180,0.833,108,303,411,347,74,30,152,230,762,Kelly Olynyk
2023-2024,Utah Jazz,C,50,8,1019,145,258,0.562,36,84,0.429,109,174,0.626,0.632,80,95,0.842,63,191,254,219,37,12,81,132,406,Kelly Olynyk
2023-2024,Toronto Raptors,C,28,19,740,131,239,0.548,24,71,0.338,107,168,0.637,0.598,70,85,0.824,45,112,157,128,37,18,71,98,356,Kelly Olynyk
2024-2025,Toronto Raptors,C,8,1,138,21,48,0.438,9,19,0.474,12,29,0.414,0.531,11,14,0.786,7,31,38,21,9,2,15,23,62,Kelly Olynyk
2021-2022,Dallas Mavericks,SF,4,0,18,2,5,0.4,1,2,0.5,1,3,0.333,0.5,2,4,0.5,2,5,7,2,0,0,0,2,7,Eugene Omoruyi
2022-2023,Total,SF,40,6,645,101,228,0.443,25,89,0.281,76,139,0.547,0.498,51,75,0.68,43,68,111,28,28,3,34,91,278,Eugene Omoruyi
2022-2023,Oklahoma City Thunder,SF,23,2,272,44,94,0.468,8,31,0.258,36,63,0.571,0.511,17,28,0.607,22,30,52,11,14,0,16,46,113,Eugene Omoruyi
2022-2023,Detroit Pistons,SF,17,4,373,57,134,0.425,17,58,0.293,40,76,0.526,0.489,34,47,0.723,21,38,59,17,14,3,18,45,165,Eugene Omoruyi
2023-2024,Washington Wizards,SF,43,0,393,81,167,0.485,13,46,0.283,68,121,0.562,0.524,32,49,0.653,35,50,85,35,27,5,21,62,207,Eugene Omoruyi
2019-2020,Utah Jazz,SF,10,1,109,12,32,0.375,7,19,0.368,5,13,0.385,0.484,4,5,0.8,5,12,17,4,4,2,4,9,35,Miye Oni
2020-2021,Utah Jazz,SG,54,0,519,35,99,0.354,30,88,0.341,5,11,0.455,0.505,5,6,0.833,23,61,84,28,11,8,16,61,105,Miye Oni
2021-2022,Utah Jazz,SG,16,0,44,2,9,0.222,1,8,0.125,1,1,1,0.278,0,1,0,1,6,7,5,0,0,1,7,5,Miye Oni
2017-2018,Cleveland Cavaliers,SF,61,12,672,90,186,0.484,32,87,0.368,58,99,0.586,0.57,26,46,0.565,19,101,120,41,22,3,32,78,238,Cedi Osman
2018-2019,Cleveland Cavaliers,SF,76,75,2444,360,844,0.427,130,374,0.348,230,470,0.489,0.504,141,181,0.779,45,312,357,195,60,11,114,195,991,Cedi Osman
2019-2020,Cleveland Cavaliers,SF,65,65,1910,266,609,0.437,123,321,0.383,143,288,0.497,0.538,63,94,0.67,39,192,231,154,54,16,91,160,718,Cedi Osman
2020-2021,Cleveland Cavaliers,SF,59,26,1510,219,586,0.374,99,324,0.306,120,262,0.458,0.458,76,95,0.8,38,163,201,174,53,9,80,119,613,Cedi Osman
2021-2022,Cleveland Cavaliers,SF,66,3,1462,247,572,0.432,128,359,0.357,119,213,0.559,0.544,87,131,0.664,25,121,146,135,52,10,67,127,709,Cedi Osman
2022-2023,Cleveland Cavaliers,SF,77,2,1548,239,530,0.451,116,312,0.372,123,218,0.564,0.56,75,108,0.694,25,151,176,115,35,11,52,122,669,Cedi Osman
2023-2024,San Antonio Spurs,SF,72,3,1269,184,384,0.479,86,221,0.389,98,163,0.601,0.591,35,52,0.673,25,155,180,119,36,11,47,107,489,Cedi Osman
2020-2021,Los Angeles Clippers,C,30,0,161,22,52,0.423,1,5,0.2,21,47,0.447,0.433,9,12,0.75,21,27,48,10,4,7,9,24,54,Daniel Oturu
2021-2022,Toronto Raptors,C,3,0,27,3,6,0.5,0,1,0,3,5,0.6,0.5,3,5,0.6,1,4,5,0,0,2,0,1,9,Daniel Oturu
2015-2016,Washington Wizards,SF,63,9,671,90,211,0.427,25,79,0.316,65,132,0.492,0.486,31,49,0.633,25,108,133,13,22,7,34,100,236,Kelly Oubre Jr.
2016-2017,Washington Wizards,SF,79,5,1605,186,442,0.421,54,188,0.287,132,254,0.52,0.482,75,99,0.758,61,200,261,47,58,17,50,195,501,Kelly Oubre Jr.
2017-2018,Washington Wizards,SF,81,11,2231,318,790,0.403,126,369,0.341,192,421,0.456,0.482,191,233,0.82,59,304,363,98,80,35,90,234,953,Kelly Oubre Jr.
2018-2019,Total,SF,69,19,1935,375,842,0.445,108,338,0.32,267,504,0.53,0.51,189,244,0.775,71,254,325,84,84,59,103,181,1047,Kelly Oubre Jr.
2018-2019,Washington Wizards,SF,29,7,755,132,305,0.433,41,132,0.311,91,173,0.526,0.5,68,85,0.8,24,105,129,20,27,20,30,71,373,Kelly Oubre Jr.
2018-2019,Phoenix Suns,SF,40,12,1180,243,537,0.453,67,206,0.325,176,331,0.532,0.515,121,159,0.761,47,149,196,64,57,39,73,110,674,Kelly Oubre Jr.
2019-2020,Phoenix Suns,SF,56,55,1933,373,826,0.452,108,307,0.352,265,519,0.511,0.517,192,246,0.78,67,294,361,85,71,40,83,192,1046,Kelly Oubre Jr.
2020-2021,Golden State Warriors,SF,55,50,1687,318,724,0.439,90,285,0.316,228,439,0.519,0.501,123,177,0.695,82,247,329,73,57,42,70,121,849,Kelly Oubre Jr.
2021-2022,Charlotte Hornets,SF,76,13,1999,410,932,0.44,191,553,0.345,219,379,0.578,0.542,126,189,0.667,79,223,302,84,77,31,67,189,1137,Kelly Oubre Jr.
2022-2023,Charlotte Hornets,SF,48,40,1548,353,819,0.431,108,339,0.319,245,480,0.51,0.497,158,208,0.76,65,184,249,54,68,18,64,141,972,Kelly Oubre Jr.
2023-2024,Philadelphia 76ers,SF,68,52,2055,387,878,0.441,101,325,0.311,286,553,0.517,0.498,174,232,0.75,94,247,341,101,77,47,87,194,1049,Kelly Oubre Jr.
2024-2025,Philadelphia 76ers,SF,28,25,905,138,306,0.451,37,123,0.301,101,183,0.552,0.511,46,65,0.708,44,119,163,42,33,15,35,77,359,Kelly Oubre Jr.
2021-2022,Detroit Pistons,SG,1,0,17,0,1,0,0,0,0,1,0,0,0,0,0,2,2,0,0,0,1,2,0,0,,Trayvon Palmer
2011-2012,Memphis Grizzlies,PG,44,5,424,50,150,0.333,10,38,0.263,40,112,0.357,0.367,16,27,0.593,12,25,37,55,15,0,46,46,126,Jeremy Pargo
2012-2013,Total,PG,39,11,655,99,250,0.396,25,74,0.338,74,176,0.42,0.446,42,62,0.677,8,41,49,92,13,2,50,46,265,Jeremy Pargo
2012-2013,Cleveland Cavaliers,PG,25,11,447,75,187,0.401,18,57,0.316,57,130,0.438,0.449,28,41,0.683,7,25,32,64,12,2,37,32,196,Jeremy Pargo
2012-2013,Philadelphia 76ers,SG,14,0,208,24,63,0.381,7,17,0.412,17,46,0.37,0.437,14,21,0.667,1,16,17,28,1,0,13,14,69,Jeremy Pargo
2019-2020,Golden State Warriors,PG,3,0,44,11,22,0.5,3,7,0.429,8,15,0.533,0.568,0,1,0,1,2,3,8,1,0,4,8,25,Jeremy Pargo
2019-2020,Golden State Warriors,PF,60,26,1654,318,640,0.497,37,129,0.287,281,511,0.55,0.526,164,212,0.774,82,193,275,127,32,13,94,125,837,Eric Paschall
2020-2021,Golden State Warriors,PF,40,2,695,148,298,0.497,18,54,0.333,130,244,0.533,0.527,67,94,0.713,28,100,128,51,12,7,43,68,381,Eric Paschall
2021-2022,Utah Jazz,PF,58,3,737,114,235,0.485,40,108,0.37,74,127,0.583,0.57,66,86,0.767,30,76,106,36,9,5,27,51,334,Eric Paschall
2005-2006,New Orleans Pelicans,PG,78,78,2808,407,947,0.43,50,177,0.282,357,770,0.464,0.456,394,465,0.847,61,339,400,611,175,6,183,218,1258,Chris Paul
2006-2007,New Orleans Pelicans,PG,64,64,2353,381,871,0.437,50,143,0.35,331,728,0.455,0.466,292,357,0.818,54,226,280,569,118,3,161,154,1104,Chris Paul
2007-2008,New Orleans Pelicans,PG,80,80,3006,630,1291,0.488,92,249,0.369,538,1042,0.516,0.524,332,390,0.851,62,259,321,925,217,4,201,185,1684,Chris Paul
2008-2009,New Orleans Pelicans,PG,78,78,3002,631,1255,0.503,64,176,0.364,567,1079,0.525,0.528,455,524,0.868,69,363,432,861,216,10,231,212,1781,Chris Paul
2009-2010,New Orleans Pelicans,PG,45,45,1712,314,637,0.493,52,127,0.409,262,510,0.514,0.534,161,190,0.847,20,171,191,480,96,8,112,118,841,Chris Paul
2010-2011,New Orleans Pelicans,PG,80,80,2880,430,928,0.463,71,183,0.388,359,745,0.482,0.502,337,384,0.878,38,289,327,782,188,5,177,196,1268,Chris Paul
2011-2012,Los Angeles Clippers,PG,60,60,2181,425,890,0.478,79,213,0.371,346,677,0.511,0.522,260,302,0.861,42,171,213,543,152,4,124,138,1189,Chris Paul
2012-2013,Los Angeles Clippers,PG,70,70,2335,412,856,0.481,76,232,0.328,336,624,0.538,0.526,286,323,0.885,53,209,262,678,169,10,159,143,1186,Chris Paul
2013-2014,Los Angeles Clippers,PG,62,62,2171,406,870,0.467,78,212,0.368,328,658,0.498,0.511,295,345,0.855,38,230,268,663,154,4,145,157,1185,Chris Paul
2014-2015,Los Angeles Clippers,PG,82,82,2857,568,1170,0.485,139,349,0.398,429,821,0.523,0.545,289,321,0.9,52,324,376,838,156,15,190,203,1564,Chris Paul
2015-2016,Los Angeles Clippers,PG,74,74,2420,515,1114,0.462,122,329,0.371,393,785,0.501,0.517,294,328,0.896,39,271,310,738,152,13,194,185,1446,Chris Paul
2016-2017,Los Angeles Clippers,PG,61,61,1921,374,785,0.476,124,302,0.411,250,483,0.518,0.555,232,260,0.892,40,264,304,563,119,8,147,146,1104,Chris Paul
2017-2018,Houston Rockets,PG,58,58,1847,367,798,0.46,144,379,0.38,223,419,0.532,0.55,203,221,0.919,37,276,313,457,96,14,128,141,1081,Chris Paul
2018-2019,Houston Rockets,PG,58,58,1857,302,720,0.419,127,355,0.358,175,365,0.479,0.508,175,203,0.862,36,229,265,473,114,18,152,146,906,Chris Paul
2019-2020,Oklahoma City Thunder,PG,70,70,2208,434,887,0.489,111,304,0.365,323,583,0.554,0.552,253,279,0.907,26,323,349,472,111,11,161,158,1232,Chris Paul
2020-2021,Phoenix Suns,PG,70,70,2199,439,879,0.499,102,258,0.395,337,621,0.543,0.557,169,181,0.934,25,287,312,622,99,19,156,166,1149,Chris Paul
2021-2022,Phoenix Suns,PG,65,65,2139,363,736,0.493,63,199,0.317,300,537,0.559,0.536,169,202,0.837,22,261,283,702,121,20,153,134,958,Chris Paul
2022-2023,Phoenix Suns,PG,59,59,1889,294,668,0.44,98,261,0.375,196,407,0.482,0.513,133,160,0.831,27,224,251,524,91,22,114,126,819,Chris Paul
2023-2024,Golden State Warriors,PG,58,18,1531,206,467,0.441,78,210,0.371,128,257,0.498,0.525,43,52,0.827,18,207,225,393,70,6,76,108,533,Chris Paul
2024-2025,San Antonio Spurs,PG,31,31,896,100,234,0.427,55,151,0.364,45,83,0.542,0.545,43,44,0.977,15,112,127,255,43,6,58,57,298,Chris Paul
2015-2016,Oklahoma City Thunder,PG,57,1,698,114,278,0.41,36,111,0.324,78,167,0.467,0.475,19,24,0.792,9,76,85,108,36,6,44,80,283,Cameron Payne
2016-2017,Total,PG,31,0,462,64,193,0.332,27,86,0.314,37,107,0.346,0.402,5,8,0.625,3,45,48,55,14,4,29,52,160,Cameron Payne
2016-2017,Oklahoma City Thunder,PG,20,0,320,43,130,0.331,16,52,0.308,27,78,0.346,0.392,4,4,1,2,29,31,40,10,4,16,38,106,Cameron Payne
2016-2017,Chicago Bulls,PG,11,0,142,21,63,0.333,11,34,0.324,10,29,0.345,0.421,1,4,0.25,1,16,17,15,4,0,13,14,54,Cameron Payne
2017-2018,Chicago Bulls,PG,25,14,582,87,215,0.405,35,91,0.385,52,124,0.419,0.486,12,16,0.75,18,51,69,113,26,9,36,44,221,Cameron Payne
2018-2019,Total,PG,40,13,712,96,223,0.43,25,84,0.298,71,139,0.511,0.487,33,41,0.805,13,59,72,106,28,9,45,64,250,Cameron Payne
2018-2019,Chicago Bulls,PG,31,12,536,69,168,0.411,16,59,0.271,53,109,0.486,0.458,22,25,0.88,10,43,53,83,20,6,34,49,176,Cameron Payne
2018-2019,Cleveland Cavaliers,PG,9,1,176,27,55,0.491,9,25,0.36,18,30,0.6,0.573,11,16,0.688,3,16,19,23,8,3,11,15,74,Cameron Payne
2019-2020,Phoenix Suns,SG,8,0,183,33,68,0.485,15,29,0.517,18,39,0.462,0.596,6,7,0.857,4,27,31,24,8,2,11,20,87,Cameron Payne
2020-2021,Phoenix Suns,PG,60,1,1079,191,395,0.484,73,166,0.44,118,229,0.515,0.576,50,56,0.893,16,128,144,217,36,16,60,97,505,Cameron Payne
2021-2022,Phoenix Suns,PG,58,12,1278,240,587,0.409,71,211,0.336,169,376,0.449,0.469,75,89,0.843,24,151,175,282,40,17,103,119,626,Cameron Payne
2022-2023,Phoenix Suns,PG,48,15,968,188,453,0.415,68,185,0.368,120,268,0.448,0.49,49,64,0.766,12,94,106,214,33,8,81,88,493,Cameron Payne
2023-2024,Total,PG,78,10,1304,208,481,0.432,104,267,0.39,104,214,0.486,0.541,58,67,0.866,21,96,117,205,42,11,66,126,578,Cameron Payne
2023-2024,Milwaukee Bucks,PG,47,2,702,101,222,0.455,52,131,0.397,49,91,0.538,0.572,37,44,0.841,5,57,62,109,22,3,31,73,291,Cameron Payne
2023-2024,Philadelphia 76ers,PG,31,8,602,107,259,0.413,52,136,0.382,55,123,0.447,0.514,21,23,0.913,16,39,55,96,20,8,35,53,287,Cameron Payne
2024-2025,New York Knicks,PG,25,0,396,68,155,0.439,39,96,0.406,29,59,0.492,0.565,10,12,0.833,7,34,41,70,14,8,13,48,185,Cameron Payne
2014-2015,Orlando Magic,PG,82,63,2489,301,708,0.425,11,42,0.262,290,666,0.435,0.433,118,214,0.551,107,242,349,533,142,20,203,193,731,Elfrid Payton
2015-2016,Orlando Magic,PG,73,69,2145,318,730,0.436,30,92,0.326,288,638,0.451,0.456,112,190,0.589,77,184,261,468,89,20,177,159,778,Elfrid Payton
2016-2017,Orlando Magic,PG,82,58,2412,430,912,0.471,40,146,0.274,390,766,0.509,0.493,146,211,0.692,89,298,387,529,88,40,178,177,1046,Elfrid Payton
2017-2018,Total,PG,63,63,1808,329,667,0.493,30,92,0.326,299,575,0.52,0.516,109,168,0.649,64,210,274,393,83,22,168,147,797,Elfrid Payton
2017-2018,Orlando Magic,PG,44,44,1257,238,458,0.52,25,67,0.373,213,391,0.545,0.547,72,114,0.632,47,127,174,275,64,16,114,97,573,Elfrid Payton
2017-2018,Phoenix Suns,PG,19,19,551,91,209,0.435,5,25,0.2,86,184,0.467,0.447,37,54,0.685,17,83,100,118,19,6,54,50,224,Elfrid Payton
2018-2019,New Orleans Pelicans,PG,42,42,1250,179,412,0.434,33,105,0.314,146,307,0.476,0.475,55,74,0.743,49,171,220,320,44,17,112,81,446,Elfrid Payton
2019-2020,New York Knicks,PG,45,36,1246,193,440,0.439,14,69,0.203,179,371,0.482,0.455,49,86,0.57,52,160,212,323,70,17,96,89,449,Elfrid Payton
2020-2021,New York Knicks,PG,63,63,1484,269,622,0.432,28,98,0.286,241,524,0.46,0.455,73,107,0.682,64,152,216,203,47,9,103,116,639,Elfrid Payton
2021-2022,Phoenix Suns,PG,50,1,549,67,175,0.383,4,18,0.222,63,157,0.401,0.394,12,32,0.375,21,67,88,99,25,6,47,38,150,Elfrid Payton
2024-2025,New Orleans Pelicans,PG,7,3,144,23,46,0.5,0,1,0,23,45,0.511,0.5,1,2,0.5,5,19,24,48,10,3,20,10,47,Elfrid Payton
2016-2017,Milwaukee Bucks,PG,6,0,99,8,22,0.364,1,9,0.111,7,13,0.538,0.386,3,5,0.6,0,12,12,13,3,4,10,9,20,Gary Payton II
2017-2018,Total,PG,23,6,221,30,74,0.405,6,25,0.24,24,49,0.49,0.446,3,9,0.333,13,31,44,21,7,3,7,30,69,Gary Payton II
2017-2018,Milwaukee Bucks,PG,12,6,106,13,33,0.394,2,12,0.167,11,21,0.524,0.424,2,3,0.667,4,13,17,9,3,1,3,17,30,Gary Payton II
2017-2018,Los Angeles Lakers,PG,11,0,115,17,41,0.415,4,13,0.308,13,28,0.464,0.463,1,6,0.167,9,18,27,12,4,2,4,13,39,Gary Payton II
2018-2019,Washington Wizards,PG,3,0,16,5,8,0.625,1,2,0.5,4,6,0.667,0.688,0,0,,1,1,2,4,3,1,1,2,11,Gary Payton II
2019-2020,Washington Wizards,SF,29,17,432,48,116,0.414,13,46,0.283,35,70,0.5,0.47,4,8,0.5,26,54,80,48,33,7,20,54,113,Gary Payton II
2020-2021,Golden State Warriors,PG,10,0,40,10,13,0.769,2,4,0.5,8,9,0.889,0.846,3,4,0.75,2,9,11,1,6,1,1,8,25,Gary Payton II
2021-2022,Golden State Warriors,SG,71,16,1248,212,344,0.616,43,120,0.358,169,224,0.754,0.679,35,58,0.603,72,175,247,64,96,22,40,131,502,Gary Payton II
2022-2023,Total,SG,22,1,367,41,69,0.594,13,26,0.5,28,43,0.651,0.688,6,7,0.857,24,45,69,30,22,5,16,43,101,Gary Payton II
2022-2023,Portland Trail Blazers,SG,15,1,255,24,41,0.585,9,17,0.529,15,24,0.625,0.695,4,4,1,10,29,39,22,16,1,12,29,61,Gary Payton II
2022-2023,Golden State Warriors,SG,7,0,112,17,28,0.607,4,9,0.444,13,19,0.684,0.679,2,3,0.667,14,16,30,8,6,4,4,14,40,Gary Payton II
2023-2024,Golden State Warriors,SG,44,0,680,103,183,0.563,20,55,0.364,83,128,0.648,0.617,14,23,0.609,46,67,113,48,39,18,27,77,240,Gary Payton II
2024-2025,Golden State Warriors,SG,28,4,368,58,106,0.547,5,32,0.156,53,74,0.716,0.571,9,15,0.6,33,45,78,34,20,10,14,40,130,Gary Payton II
2019-2020,Philadelphia 76ers,C,24,0,232,25,48,0.521,0,1,0,25,47,0.532,0.521,7,14,0.5,20,52,72,8,3,31,18,55,57,Norvel Pelle
2020-2021,Total,C,13,0,84,8,15,0.533,0,0,,8,15,0.533,0.533,4,6,0.667,6,13,19,2,1,9,3,14,20,Norvel Pelle
2020-2021,Brooklyn Nets,C,3,0,28,3,7,0.429,0,0,,3,7,0.429,0.429,0,0,,3,4,7,0,0,3,3,9,6,Norvel Pelle
2020-2021,Sacramento Kings,C,1,0,4,0,1,0,0,0,,0,1,0,0,3,4,0.75,1,0,1,1,0,0,0,1,3,Norvel Pelle
2020-2021,New York Knicks,C,9,0,52,5,7,0.714,0,0,,5,7,0.714,0.714,1,2,0.5,2,9,11,1,1,6,0,4,11,Norvel Pelle
2021-2022,Utah Jazz,C,3,0,19,3,5,0.6,0,0,,3,5,0.6,0.6,0,0,,3,3,6,0,0,1,2,1,6,Norvel Pelle
2023-2024,Memphis Grizzlies,SF,7,1,122,18,35,0.514,5,13,0.385,13,22,0.591,0.586,7,10,0.7,11,26,37,2,6,4,5,10,48,Mãozinha Pereira
2020-2021,Brooklyn Nets,PF,26,0,211,32,78,0.41,4,21,0.19,28,57,0.491,0.436,10,13,0.769,27,46,73,14,6,6,15,40,78,Reggie Perry
2021-2022,Total,PF,10,1,187,40,79,0.506,3,16,0.188,37,63,0.587,0.525,9,15,0.6,15,32,47,12,9,6,11,33,92,Reggie Perry
2021-2022,Portland Trail Blazers,PF,9,1,177,39,78,0.5,3,16,0.188,36,62,0.581,0.519,9,15,0.6,15,31,46,12,9,6,11,30,90,Reggie Perry
2021-2022,Indiana Pacers,PF,1,0,10,1,1,1,0,0,,1,1,1,1,0,0,,0,1,1,0,0,0,0,3,2,Reggie Perry
2023-2024,Boston Celtics,PF,3,0,23,4,6,0.667,3,5,0.6,1,1,1,0.917,0,0,,0,1,1,1,2,0,1,1,11,Drew Peterson
2024-2025,Boston Celtics,PF,8,0,89,6,16,0.375,5,14,0.357,1,2,0.5,0.531,6,7,0.857,5,13,18,5,2,2,4,10,23,Drew Peterson
2023-2024,Total,C,3,0,10,1,2,0.5,0,0,1,2,0.5,0.5,1,2,0.5,0,1,1,0,0,0,0,1,3,0,Filip Petrušev
2023-2024,Philadelphia 76ers,C,1,0,3,0,0,,0,0,0,0,,,0,0,,0,1,1,0,0,0,0,0,0,0,Filip Petrušev
2023-2024,Sacramento Kings,C,2,0,7,1,2,0.5,0,0,1,2,0.5,0.5,1,2,0.5,0,0,0,0,0,0,0,1,3,0,Filip Petrušev
2023-2024,Chicago Bulls,SF,40,0,323,32,77,0.416,12,38,0.316,20,39,0.513,0.494,13,19,0.684,12,24,36,13,7,7,10,40,89,Julian Phillips
2024-2025,Chicago Bulls,SF,30,2,429,52,123,0.423,24,75,0.32,28,48,0.583,0.52,18,28,0.643,27,37,64,15,18,8,13,48,146,Julian Phillips
2023-2024,Denver Nuggets,SG,27,0,122,15,35,0.429,9,25,0.36,6,10,0.6,0.557,3,4,0.75,1,13,14,21,4,0,9,13,42,Jalen Pickett
2024-2025,Denver Nuggets,SG,7,0,66,7,16,0.438,5,12,0.417,2,4,0.5,0.594,0,0,,1,7,8,17,1,1,4,6,19,Jalen Pickett
2021-2022,Detroit Pistons,PF,13,0,176,18,50,0.36,13,39,0.333,5,11,0.455,0.49,1,2,0.5,6,26,32,7,0,7,5,12,50,Jamorko Pickett
2018-2019,Brooklyn Nets,SG,18,0,211,25,73,0.342,12,46,0.261,13,27,0.481,0.425,19,22,0.864,4,32,36,21,6,0,18,15,81,Theo Pinson
2019-2020,Brooklyn Nets,SG,33,0,365,45,155,0.29,15,80,0.188,30,75,0.4,0.339,15,16,0.938,10,44,54,56,17,4,33,35,120,Theo Pinson
2020-2021,New York Knicks,SG,17,0,34,1,9,0.111,0,8,0,1,1,1,0.111,0,0,,0,5,5,1,0,0,1,4,2,Theo Pinson
2021-2022,Dallas Mavericks,SF,19,0,148,14,39,0.359,10,30,0.333,4,9,0.444,0.487,10,10,1,2,19,21,17,5,2,5,12,48,Theo Pinson
2022-2023,Dallas Mavericks,SG,40,1,323,31,87,0.356,22,62,0.355,9,25,0.36,0.483,11,13,0.846,10,53,63,46,6,1,12,34,95,Theo Pinson
2022-2023,Los Angeles Lakers,PG,6,0,32,4,12,0.333,1,3,0.333,3,9,0.333,0.375,5,9,0.556,2,2,4,2,2,1,2,3,14,Scotty Pippen Jr.
2023-2024,Memphis Grizzlies,PG,21,16,527,100,203,0.493,30,72,0.417,70,131,0.534,0.567,41,55,0.745,22,45,67,98,36,10,56,60,271,Scotty Pippen Jr.
2024-2025,Memphis Grizzlies,PG,32,11,719,133,280,0.475,36,99,0.364,97,181,0.536,0.539,46,68,0.676,21,91,112,161,34,11,65,79,348,Scotty Pippen Jr.
2013-2014,Brooklyn Nets,C,70,22,1275,199,302,0.659,0,3,0,199,299,0.666,0.659,122,195,0.626,99,209,308,60,49,55,77,171,520,Mason Plumlee
2014-2015,Brooklyn Nets,C,82,45,1743,280,489,0.573,0,3,0,280,486,0.576,0.573,157,317,0.495,175,337,512,74,65,63,106,207,717,Mason Plumlee
2015-2016,Portland Trail Blazers,C,82,82,2084,267,517,0.516,0,4,0,267,513,0.52,0.516,215,335,0.642,201,427,628,226,68,85,154,253,749,Mason Plumlee
2016-2017,Total,C,81,64,2148,334,623,0.536,0,6,0,334,617,0.541,0.536,174,300,0.58,170,435,605,284,69,92,134,226,842,Mason Plumlee
2016-2017,Portland Trail Blazers,C,54,54,1516,235,442,0.532,0,5,0,235,437,0.538,0.532,127,224,0.567,120,312,432,214,50,63,88,149,597,Mason Plumlee
2016-2017,Denver Nuggets,C,27,10,632,99,181,0.547,0,1,0,99,180,0.55,0.547,47,76,0.618,50,123,173,70,19,29,46,77,245,Mason Plumlee
2017-2018,Denver Nuggets,C,74,26,1439,221,368,0.601,0,1,0,221,367,0.602,0.601,82,179,0.458,132,268,400,142,49,81,103,184,524,Mason Plumlee
2018-2019,Denver Nuggets,C,82,17,1731,262,442,0.593,2,10,0.2,260,432,0.602,0.595,111,198,0.561,165,359,524,243,66,76,126,252,637,Mason Plumlee
2019-2020,Denver Nuggets,C,61,1,1057,177,288,0.615,0,5,0,177,283,0.625,0.615,83,155,0.535,98,219,317,154,33,38,82,143,437,Mason Plumlee
2020-2021,Detroit Pistons,C,56,56,1499,234,381,0.614,0,7,0,234,374,0.626,0.614,113,169,0.669,145,374,519,202,43,50,105,186,581,Mason Plumlee
2021-2022,Charlotte Hornets,C,73,73,1793,205,320,0.641,0,2,0,205,318,0.645,0.641,67,171,0.392,176,389,565,226,61,52,100,224,477,Mason Plumlee
2022-2023,Total,C,79,60,2054,329,484,0.68,0,0,,329,484,0.68,0.68,199,313,0.636,229,471,700,245,46,47,117,217,857,Mason Plumlee
2022-2023,Charlotte Hornets,C,56,56,1597,265,396,0.669,0,0,,265,396,0.669,0.669,155,256,0.605,187,354,541,205,35,35,87,161,685,Mason Plumlee
2022-2023,Los Angeles Clippers,C,23,4,457,64,88,0.727,0,0,,64,88,0.727,0.727,44,57,0.772,42,117,159,40,11,12,30,56,172,Mason Plumlee
2023-2024,Los Angeles Clippers,C,46,11,674,87,153,0.569,0,6,0,87,147,0.592,0.569,70,99,0.707,60,174,234,55,14,17,36,68,244,Mason Plumlee
2024-2025,Phoenix Suns,C,29,7,490,44,79,0.557,0,1,0,44,78,0.564,0.557,31,53,0.585,46,128,174,48,9,20,24,58,119,Mason Plumlee
2023-2024,Golden State Warriors,SG,74,28,1968,271,597,0.454,90,234,0.385,181,363,0.499,0.529,50,79,0.633,118,309,427,273,61,14,88,122,682,Brandin Podziemski
2024-2025,Golden State Warriors,SG,29,8,714,93,229,0.406,31,105,0.295,62,124,0.5,0.474,22,30,0.733,30,103,133,96,29,7,30,44,239,Brandin Podziemski
2016-2017,Toronto Raptors,C,54,4,626,67,115,0.583,0,0,,67,115,0.583,0.583,31,57,0.544,78,87,165,12,17,20,29,113,165,Jakob Poeltl
2017-2018,Toronto Raptors,C,82,0,1524,253,384,0.659,1,2,0.5,252,382,0.66,0.66,60,101,0.594,165,228,393,57,39,100,85,212,567,Jakob Poeltl
2018-2019,San Antonio Spurs,C,77,24,1273,187,290,0.645,0,0,,187,290,0.645,0.645,49,92,0.533,178,232,410,93,29,68,48,124,423,Jakob Poeltl
2019-2020,San Antonio Spurs,C,66,18,1171,166,266,0.624,0,0,,166,266,0.624,0.624,40,86,0.465,131,244,375,116,37,95,54,126,372,Jakob Poeltl
2020-2021,San Antonio Spurs,C,69,51,1845,265,430,0.616,0,0,,265,430,0.616,0.616,63,124,0.508,219,328,547,134,47,123,83,172,593,Jakob Poeltl
2021-2022,San Antonio Spurs,C,68,67,1970,410,663,0.618,1,1,1,409,662,0.618,0.619,94,190,0.495,262,372,634,189,45,118,109,212,915,Jakob Poeltl
2022-2023,Total,C,72,71,1906,389,618,0.629,0,1,0,389,617,0.63,0.629,119,201,0.592,236,417,653,197,66,86,125,195,897,Jakob Poeltl
2022-2023,San Antonio Spurs,C,46,46,1199,239,388,0.616,0,1,0,239,387,0.618,0.616,78,129,0.605,152,264,416,141,36,52,96,118,556,Jakob Poeltl
2022-2023,Toronto Raptors,C,26,25,707,150,230,0.652,0,0,,150,230,0.652,0.652,41,72,0.569,84,153,237,56,30,34,29,77,341,Jakob Poeltl
2023-2024,Toronto Raptors,C,50,50,1319,248,378,0.656,0,0,,248,378,0.656,0.656,59,107,0.551,146,283,429,127,35,76,77,149,555,Jakob Poeltl
2024-2025,Toronto Raptors,C,26,25,835,172,292,0.589,0,2,0,172,290,0.593,0.589,60,88,0.682,102,185,287,71,29,32,56,92,404,Jakob Poeltl
2020-2021,Oklahoma City Thunder,PF,45,28,1090,139,408,0.341,58,207,0.28,81,201,0.403,0.412,31,42,0.738,30,182,212,97,20,42,99,58,367,Aleksej Pokusevski
2021-2022,Oklahoma City Thunder,PF,61,12,1233,186,456,0.408,57,197,0.289,129,259,0.498,0.47,35,50,0.7,73,245,318,131,39,38,94,88,464,Aleksej Pokusevski
2022-2023,Oklahoma City Thunder,PF,34,25,701,108,249,0.434,38,104,0.365,70,145,0.483,0.51,22,35,0.629,45,114,159,64,20,43,43,58,276,Aleksej Pokusevski
2023-2024,Total,PF,28,0,405,49,121,0.405,18,55,0.327,31,66,0.47,0.479,30,41,0.732,17,72,89,35,15,13,19,22,146,Aleksej Pokusevski
2023-2024,Oklahoma City Thunder,PF,10,0,60,4,16,0.25,2,11,0.182,2,5,0.4,0.313,2,4,0.5,2,8,10,5,1,1,3,5,12,Aleksej Pokusevski
2023-2024,Charlotte Hornets,PF,18,0,345,45,105,0.429,16,44,0.364,29,61,0.475,0.505,28,37,0.757,15,64,79,30,14,12,16,17,134,Aleksej Pokusevski
2019-2020,Toronto Raptors,PG,4,0,11,3,5,0.6,1,2,0.5,2,3,0.667,0.7,2,2,1,0,1,1,2,0,1,0,2,9,Shamorie Ponds
2021-2022,Memphis Grizzlies,SF,12,0,71,5,16,0.313,3,9,0.333,2,7,0.286,0.406,0,2,0,5,7,12,1,1,4,1,6,13,Yves Pons
2019-2020,Golden State Warriors,SG,57,14,1274,167,502,0.333,74,265,0.279,93,237,0.392,0.406,95,119,0.798,9,109,118,134,35,10,74,94,503,Jordan Poole
2020-2021,Golden State Warriors,SG,51,7,988,205,474,0.432,97,276,0.351,108,198,0.545,0.535,105,119,0.882,15,77,92,99,26,9,51,86,612,Jordan Poole
2021-2022,Golden State Warriors,SG,76,51,2283,474,1058,0.448,211,580,0.364,263,478,0.55,0.548,246,266,0.925,34,226,260,304,60,23,187,206,1405,Jordan Poole
2022-2023,Golden State Warriors,PG,82,43,2458,550,1278,0.43,214,637,0.336,336,641,0.524,0.514,361,415,0.87,32,193,225,369,63,21,252,214,1675,Jordan Poole
2023-2024,Washington Wizards,SG,78,66,2346,490,1186,0.413,184,564,0.326,306,622,0.492,0.491,192,219,0.877,32,180,212,343,86,25,188,244,1356,Jordan Poole
2024-2025,Washington Wizards,SG,26,26,821,179,414,0.432,92,226,0.407,87,188,0.463,0.543,105,125,0.84,9,60,69,130,42,14,92,88,555,Jordan Poole
2023-2024,Cleveland Cavaliers,PG,51,6,649,116,228,0.509,12,34,0.353,104,194,0.536,0.535,41,56,0.732,21,88,109,118,21,15,45,40,285,Craig Porter Jr.
2024-2025,Cleveland Cavaliers,PG,18,0,164,19,34,0.559,5,11,0.455,14,23,0.609,0.632,3,5,0.6,2,14,16,24,5,6,9,8,46,Craig Porter Jr.
2020-2021,Memphis Grizzlies,PF,11,0,54,8,15,0.533,3,8,0.375,5,7,0.714,0.633,3,5,0.6,4,10,14,1,3,1,7,12,22,Jontay Porter
2023-2024,Toronto Raptors,PF,26,5,360,40,104,0.385,20,60,0.333,20,44,0.455,0.481,15,18,0.833,26,56,82,60,20,20,21,35,115,Jontay Porter
2019-2020,Cleveland Cavaliers,SF,50,3,1162,186,421,0.442,53,158,0.335,133,263,0.506,0.505,73,101,0.723,22,140,162,109,46,14,93,135,498,Kevin Porter Jr.
2020-2021,Houston Rockets,SG,26,23,835,156,367,0.425,50,161,0.311,106,206,0.515,0.493,69,94,0.734,20,79,99,164,19,8,91,61,431,Kevin Porter Jr.
2021-2022,Houston Rockets,PG,61,61,1907,335,808,0.415,155,413,0.375,180,395,0.456,0.511,124,193,0.642,43,224,267,376,69,22,192,156,949,Kevin Porter Jr.
2022-2023,Houston Rockets,PG,59,59,2024,391,884,0.442,141,385,0.366,250,499,0.501,0.522,207,264,0.784,76,238,314,338,82,17,188,156,1130,Kevin Porter Jr.
2024-2025,Los Angeles Clippers,SG,27,1,547,110,261,0.421,18,72,0.25,92,189,0.487,0.456,33,51,0.647,19,80,99,81,28,7,62,46,271,Kevin Porter Jr.
2019-2020,Denver Nuggets,SF,55,8,903,195,383,0.509,62,147,0.422,133,236,0.564,0.59,60,72,0.833,66,193,259,46,27,25,49,100,512,Michael Porter Jr.
2020-2021,Denver Nuggets,SF,61,54,1912,443,817,0.542,170,382,0.445,273,435,0.628,0.646,106,134,0.791,91,354,445,70,40,54,77,126,1162,Michael Porter Jr.
2021-2022,Denver Nuggets,SF,9,9,265,37,103,0.359,10,48,0.208,27,55,0.491,0.408,5,9,0.556,9,50,59,17,10,2,12,16,89,Michael Porter Jr.
2022-2023,Denver Nuggets,SF,62,62,1798,398,817,0.487,188,454,0.414,210,363,0.579,0.602,96,120,0.8,64,277,341,65,37,29,68,119,1080,Michael Porter Jr.
2023-2024,Denver Nuggets,SF,81,81,2565,522,1079,0.484,220,554,0.397,302,525,0.575,0.586,92,110,0.836,106,459,565,122,42,53,92,148,1356,Michael Porter Jr.
2024-2025,Denver Nuggets,SF,29,29,998,205,396,0.518,70,176,0.398,135,220,0.614,0.606,53,76,0.697,44,151,195,81,22,12,44,64,533,Michael Porter Jr.
2013-2014,Washington Wizards,SF,37,0,319,33,91,0.363,4,21,0.19,29,70,0.414,0.385,8,12,0.667,21,36,57,10,8,1,14,26,78,Otto Porter Jr.
2014-2015,Washington Wizards,SF,74,13,1432,176,391,0.45,35,104,0.337,141,287,0.491,0.495,58,79,0.734,70,151,221,65,44,30,52,97,445,Otto Porter Jr.
2015-2016,Washington Wizards,SF,75,73,2276,339,717,0.473,98,267,0.367,241,450,0.536,0.541,95,126,0.754,97,294,391,120,105,32,70,163,871,Otto Porter Jr.
2016-2017,Washington Wizards,SF,80,80,2605,414,803,0.516,148,341,0.434,266,462,0.576,0.608,99,119,0.832,118,396,514,121,116,42,44,193,1075,Otto Porter Jr.
2017-2018,Washington Wizards,SF,77,77,2432,445,885,0.503,138,313,0.441,307,572,0.537,0.581,106,128,0.828,103,389,492,157,116,41,75,151,1134,Otto Porter Jr.
2018-2019,Total,SF,56,43,1683,299,643,0.465,104,256,0.406,195,387,0.504,0.546,78,96,0.813,54,260,314,120,82,31,65,108,780,Otto Porter Jr.
2018-2019,Washington Wizards,SF,41,28,1191,202,442,0.457,65,176,0.369,137,266,0.515,0.531,49,64,0.766,40,191,231,80,64,22,40,79,518,Otto Porter Jr.
2018-2019,Chicago Bulls,SF,15,15,492,97,201,0.483,39,80,0.488,58,121,0.479,0.58,29,32,0.906,14,69,83,40,18,9,25,29,262,Otto Porter Jr.
2019-2020,Chicago Bulls,SF,14,9,331,62,140,0.443,24,62,0.387,38,78,0.487,0.529,19,27,0.704,13,35,48,25,15,6,11,31,167,Otto Porter Jr.
2020-2021,Total,SF,28,6,606,98,227,0.432,39,104,0.375,59,123,0.48,0.518,36,42,0.857,28,124,152,55,16,4,25,41,271,Otto Porter Jr.
2020-2021,Chicago Bulls,SF,25,6,540,89,202,0.441,38,95,0.4,51,107,0.477,0.535,31,37,0.838,28,110,138,50,12,4,25,37,247,Otto Porter Jr.
2020-2021,Orlando Magic,PF,3,0,66,9,25,0.36,1,9,0.111,8,16,0.5,0.38,5,5,1,0,14,14,5,4,0,0,4,24,Otto Porter Jr.
2021-2022,Golden State Warriors,PF,63,15,1396,193,416,0.464,80,216,0.37,113,200,0.565,0.56,49,61,0.803,86,276,362,94,68,29,37,83,515,Otto Porter Jr.
2022-2023,Toronto Raptors,SF,8,2,146,15,30,0.5,6,17,0.353,9,13,0.692,0.6,8,8,1,6,13,19,8,11,0,4,7,44,Otto Porter Jr.
2023-2024,Toronto Raptors,SF,15,1,174,14,33,0.424,8,23,0.348,6,10,0.6,0.545,3,3,1,6,23,29,8,5,5,2,19,39,Otto Porter Jr.
2015-2016,Chicago Bulls,PF,62,4,1102,186,436,0.427,16,52,0.308,170,384,0.443,0.445,48,66,0.727,123,214,337,52,25,22,54,100,436,Bobby Portis
2016-2017,Chicago Bulls,PF,64,13,1000,183,375,0.488,32,96,0.333,151,279,0.541,0.531,39,59,0.661,75,221,296,35,16,11,37,94,437,Bobby Portis
2017-2018,Chicago Bulls,PF,73,4,1643,382,811,0.471,80,223,0.359,302,588,0.514,0.52,120,156,0.769,159,339,498,123,50,23,103,130,964,Bobby Portis
2018-2019,Total,PF,50,28,1299,279,628,0.444,75,191,0.393,204,437,0.467,0.504,77,97,0.794,109,294,403,72,35,20,74,145,710,Bobby Portis
2018-2019,Chicago Bulls,PF,22,6,531,122,271,0.45,27,72,0.375,95,199,0.477,0.5,39,50,0.78,46,115,161,29,11,8,29,61,310,Bobby Portis
2018-2019,Washington Wizards,PF,28,22,768,157,357,0.44,48,119,0.403,109,238,0.458,0.507,38,47,0.809,63,179,242,43,24,12,45,84,400,Bobby Portis
2019-2020,New York Knicks,PF,66,5,1393,265,589,0.45,67,187,0.358,198,402,0.493,0.507,71,93,0.763,80,258,338,98,32,18,73,110,668,Bobby Portis
2020-2021,Milwaukee Bucks,C,66,7,1372,313,598,0.523,74,157,0.471,239,441,0.542,0.585,54,73,0.74,124,342,466,71,52,26,56,115,754,Bobby Portis
2021-2022,Milwaukee Bucks,C,72,59,2028,417,871,0.479,133,338,0.393,284,533,0.533,0.555,85,113,0.752,180,477,657,86,53,51,90,174,1052,Bobby Portis
2022-2023,Milwaukee Bucks,PF,70,22,1818,398,803,0.496,95,257,0.37,303,546,0.555,0.555,96,125,0.768,154,518,672,105,29,16,81,115,987,Bobby Portis
2023-2024,Milwaukee Bucks,PF,82,4,2008,466,918,0.508,100,246,0.407,366,672,0.545,0.562,98,124,0.79,142,465,607,104,68,34,91,189,1130,Bobby Portis
2024-2025,Milwaukee Bucks,PF,28,4,698,164,340,0.482,38,100,0.38,126,240,0.525,0.538,28,37,0.757,49,169,218,60,19,16,36,47,394,Bobby Portis
2015-2016,New York Knicks,PF,72,72,2047,373,886,0.421,81,243,0.333,292,643,0.454,0.467,201,240,0.838,132,394,526,94,53,134,121,205,1028,Kristaps Porziņģis
2016-2017,New York Knicks,PF,66,65,2164,443,985,0.45,112,314,0.357,331,671,0.493,0.507,198,252,0.786,111,364,475,97,47,129,118,244,1196,Kristaps Porziņģis
2017-2018,New York Knicks,PF,48,48,1553,390,889,0.439,90,228,0.395,300,661,0.454,0.489,218,275,0.793,62,254,316,57,36,115,93,141,1088,Kristaps Porziņģis
2019-2020,Dallas Mavericks,C,57,57,1814,398,932,0.427,142,403,0.352,256,529,0.484,0.503,226,283,0.799,100,440,540,102,41,115,92,185,1164,Kristaps Porziņģis
2020-2021,Dallas Mavericks,C,43,43,1327,325,683,0.476,97,258,0.376,228,425,0.536,0.547,118,138,0.855,82,299,381,68,20,58,51,115,865,Kristaps Porziņģis
2021-2022,Total,PF,51,51,1481,352,767,0.459,78,252,0.31,274,515,0.532,0.51,248,286,0.867,102,309,411,119,37,84,81,137,1030,Kristaps Porziņģis
2021-2022,Dallas Mavericks,PF,34,34,1002,229,508,0.451,49,173,0.283,180,335,0.537,0.499,147,170,0.865,64,197,261,69,25,59,53,88,654,Kristaps Porziņģis
2021-2022,Washington Wizards,PF,17,17,479,123,259,0.475,29,79,0.367,94,180,0.522,0.531,101,116,0.871,38,112,150,50,12,25,28,49,376,Kristaps Porziņģis
2022-2023,Washington Wizards,C,65,65,2120,507,1018,0.498,137,356,0.385,370,662,0.559,0.565,354,416,0.851,114,432,546,174,58,100,137,196,1505,Kristaps Porziņģis
2023-2024,Boston Celtics,C,57,57,1690,388,752,0.516,110,293,0.375,278,459,0.606,0.589,259,302,0.858,97,312,409,115,42,111,89,156,1145,Kristaps Porziņģis
2024-2025,Boston Celtics,C,11,11,299,67,148,0.453,22,67,0.328,45,81,0.556,0.527,45,53,0.849,15,55,70,18,8,16,8,24,201,Kristaps Porziņģis
2021-2022,Detroit Pistons,C,3,0,31,5,11,0.455,0,2,0,5,9,0.556,0.455,2,2,1,4,5,9,0,1,1,1,4,12,Micah Potter
2022-2023,Utah Jazz,PF,7,0,52,10,15,0.667,4,7,0.571,6,8,0.75,0.8,0,0,,3,13,16,4,1,0,2,5,24,Micah Potter
2023-2024,Utah Jazz,PF,16,0,186,19,40,0.475,9,21,0.429,10,19,0.526,0.588,6,8,0.75,10,33,43,6,4,6,5,14,53,Micah Potter
2024-2025,Utah Jazz,C,8,2,147,13,28,0.464,10,23,0.435,3,5,0.6,0.643,0,0,,14,32,46,9,2,4,6,8,36,Micah Potter
2014-2015,Total,PF,29,0,236,31,67,0.463,3,11,0.273,28,56,0.5,0.485,25,33,0.758,18,32,50,9,9,6,11,40,90,Dwight Powell
2014-2015,Boston Celtics,PF,5,0,9,4,5,0.8,0,0,,4,5,0.8,0.8,1,2,0.5,0,1,1,0,2,0,2,1,9,Dwight Powell
2014-2015,Dallas Mavericks,PF,24,0,227,27,62,0.435,3,11,0.273,24,51,0.471,0.46,24,31,0.774,18,31,49,9,7,6,9,39,81,Dwight Powell
2015-2016,Dallas Mavericks,PF,69,2,992,146,296,0.493,2,16,0.125,144,280,0.514,0.497,105,142,0.739,84,189,273,44,36,24,40,118,399,Dwight Powell
2016-2017,Dallas Mavericks,C,77,3,1333,194,377,0.515,21,74,0.284,173,303,0.571,0.542,107,141,0.759,93,213,306,49,61,39,34,135,516,Dwight Powell
2017-2018,Dallas Mavericks,C,79,24,1672,255,430,0.593,28,84,0.333,227,346,0.656,0.626,133,185,0.719,135,309,444,91,67,32,59,186,671,Dwight Powell
2018-2019,Dallas Mavericks,C,77,22,1662,290,486,0.597,39,127,0.307,251,359,0.699,0.637,196,254,0.772,140,271,411,112,44,50,67,201,815,Dwight Powell
2019-2020,Dallas Mavericks,C,40,37,1061,146,229,0.638,10,39,0.256,136,190,0.716,0.659,74,111,0.667,75,152,227,59,34,22,36,102,376,Dwight Powell
2020-2021,Dallas Mavericks,C,58,19,966,120,194,0.619,5,21,0.238,115,173,0.665,0.631,97,124,0.782,80,154,234,63,36,30,40,135,342,Dwight Powell
2021-2022,Dallas Mavericks,C,82,71,1798,269,401,0.671,13,37,0.351,256,364,0.703,0.687,166,212,0.783,173,231,404,97,37,39,64,220,717,Dwight Powell
2022-2023,Dallas Mavericks,C,76,64,1458,197,269,0.732,0,5,0,197,264,0.746,0.732,112,168,0.667,149,165,314,69,48,26,65,209,506,Dwight Powell
2023-2024,Dallas Mavericks,C,63,9,836,72,106,0.679,1,3,0.333,71,103,0.689,0.684,63,89,0.708,97,117,214,84,26,20,32,113,208,Dwight Powell
2024-2025,Dallas Mavericks,C,24,0,184,11,13,0.846,1,1,1,10,12,0.833,0.885,17,26,0.654,15,26,41,16,8,10,5,30,40,Dwight Powell
2015-2016,Toronto Raptors,SG,49,24,725,97,229,0.424,36,89,0.404,61,140,0.436,0.502,43,53,0.811,16,95,111,47,29,10,32,59,273,Norman Powell
2016-2017,Toronto Raptors,SG,76,18,1368,227,506,0.449,56,173,0.324,171,333,0.514,0.504,126,159,0.792,26,143,169,82,52,14,70,127,636,Norman Powell
2017-2018,Toronto Raptors,SG,70,18,1062,150,374,0.401,53,186,0.285,97,188,0.516,0.472,32,39,0.821,14,105,119,89,37,16,66,111,385,Norman Powell
2018-2019,Toronto Raptors,SG,60,3,1126,193,400,0.483,68,170,0.4,125,230,0.543,0.568,62,75,0.827,16,123,139,91,39,13,65,96,516,Norman Powell
2019-2020,Toronto Raptors,SG,52,26,1479,296,598,0.495,109,273,0.399,187,325,0.575,0.586,129,153,0.843,26,164,190,91,60,21,77,108,830,Norman Powell
2020-2021,Total,SG,69,58,2205,438,918,0.477,171,416,0.411,267,502,0.532,0.57,236,271,0.871,42,173,215,129,82,18,119,160,1283,Norman Powell
2020-2021,Toronto Raptors,SG,42,31,1277,282,566,0.498,118,269,0.439,164,297,0.552,0.602,141,163,0.865,19,107,126,77,47,8,77,98,823,Norman Powell
2020-2021,Portland Trail Blazers,SF,27,27,928,156,352,0.443,53,147,0.361,103,205,0.502,0.518,95,108,0.88,23,66,89,52,35,10,42,62,460,Norman Powell
2021-2022,Total,SG,45,41,1458,279,605,0.461,106,253,0.419,173,352,0.491,0.549,189,233,0.811,20,125,145,96,42,21,69,106,853,Norman Powell
2021-2022,Portland Trail Blazers,SF,40,39,1333,247,542,0.456,93,229,0.406,154,313,0.492,0.542,159,198,0.803,17,114,131,82,40,17,62,92,746,Norman Powell
2021-2022,Los Angeles Clippers,SG,5,2,125,32,63,0.508,13,24,0.542,19,39,0.487,0.611,30,35,0.857,3,11,14,14,2,4,7,14,107,Norman Powell
2022-2023,Los Angeles Clippers,SG,60,8,1567,340,710,0.479,114,287,0.397,226,423,0.534,0.559,225,277,0.812,24,151,175,109,50,18,101,125,1019,Norman Powell
2023-2024,Los Angeles Clippers,SG,76,3,1990,373,768,0.486,167,384,0.435,206,384,0.536,0.594,143,172,0.831,16,179,195,82,43,22,66,137,1056,Norman Powell
2024-2025,Los Angeles Clippers,SG,24,24,801,202,408,0.495,90,193,0.466,112,215,0.521,0.605,87,103,0.845,7,72,79,60,29,5,51,52,581,Norman Powell
2022-2023,Los Angeles Clippers,PG,14,0,124,18,41,0.439,5,18,0.278,13,23,0.565,0.5,0,2,0,2,20,22,27,2,0,10,7,41,Jason Preston
2023-2024,Utah Jazz,PG,7,0,71,6,19,0.316,0,3,0,6,16,0.375,0.316,0,0,,6,11,17,16,2,1,2,3,12,Jason Preston
2021-2022,San Antonio Spurs,SF,50,16,965,101,270,0.374,42,137,0.307,59,133,0.444,0.452,44,59,0.746,32,81,113,81,20,23,57,79,288,Joshua Primo
2022-2023,San Antonio Spurs,SG,4,0,93,9,26,0.346,3,12,0.25,6,14,0.429,0.404,7,9,0.778,2,11,13,18,1,2,11,8,28,Joshua Primo
2023-2024,Los Angeles Clippers,SG,2,0,10,1,3,0.333,0,1,0,1,2,0.5,0.333,0,0,,1,0,1,0,0,1,4,0,2,Joshua Primo
2016-2017,Atlanta Hawks,SF,59,10,981,114,285,0.4,33,102,0.324,81,183,0.443,0.458,74,94,0.787,25,132,157,55,43,27,61,96,335,Taurean Prince
2017-2018,Atlanta Hawks,SF,82,82,2464,415,975,0.426,176,457,0.385,239,518,0.461,0.516,152,180,0.844,50,339,389,214,85,42,191,168,1158,Taurean Prince
2018-2019,Atlanta Hawks,SF,55,47,1552,262,594,0.441,123,315,0.39,139,279,0.498,0.545,95,116,0.819,22,177,199,118,53,19,100,141,742,Taurean Prince
2019-2020,Brooklyn Nets,PF,64,61,1857,278,739,0.376,146,431,0.339,132,308,0.429,0.475,71,89,0.798,50,331,381,116,57,25,127,159,773,Taurean Prince
2020-2021,Total,PF,41,10,905,131,327,0.401,62,155,0.4,69,172,0.401,0.495,65,76,0.855,19,123,142,76,28,23,47,75,389,Taurean Prince
2020-2021,Brooklyn Nets,PF,12,4,218,30,74,0.405,13,37,0.351,17,37,0.459,0.493,24,27,0.889,2,32,34,7,8,8,11,21,97,Taurean Prince
2020-2021,Cleveland Cavaliers,PF,29,6,687,101,253,0.399,49,118,0.415,52,135,0.385,0.496,41,49,0.837,17,91,108,69,20,15,36,54,292,Taurean Prince
2021-2022,Minnesota Timberwolves,PF,69,8,1177,177,390,0.454,86,229,0.376,91,161,0.565,0.564,62,82,0.756,26,148,174,68,47,23,53,116,502,Taurean Prince
2022-2023,Minnesota Timberwolves,PF,54,4,1192,177,379,0.467,74,194,0.381,103,185,0.557,0.565,65,77,0.844,15,117,132,84,28,15,69,123,493,Taurean Prince
2023-2024,Los Angeles Lakers,PF,78,49,2108,253,572,0.442,141,356,0.396,112,216,0.519,0.566,50,68,0.735,21,209,230,119,58,35,73,146,697,Taurean Prince
2024-2025,Milwaukee Bucks,SF,29,26,759,77,170,0.453,51,107,0.477,26,63,0.413,0.603,13,17,0.765,18,100,118,50,25,5,36,59,218,Taurean Prince
2020-2021,Boston Celtics,SG,66,4,1268,184,418,0.44,102,248,0.411,82,170,0.482,0.562,40,45,0.889,33,125,158,120,37,9,53,104,510,Payton Pritchard
2021-2022,Boston Celtics,PG,71,2,1001,160,373,0.429,101,245,0.412,59,128,0.461,0.564,21,21,1,32,102,134,139,25,6,41,61,442,Payton Pritchard
2022-2023,Boston Celtics,PG,48,3,643,101,245,0.412,56,154,0.364,45,91,0.495,0.527,12,16,0.75,25,63,88,64,14,1,40,37,270,Payton Pritchard
2023-2024,Boston Celtics,PG,82,5,1825,297,635,0.468,147,382,0.385,150,253,0.593,0.583,46,56,0.821,70,195,265,281,39,6,61,106,787,Payton Pritchard
2024-2025,Boston Celtics,PG,31,0,893,163,350,0.466,112,271,0.413,51,79,0.646,0.626,39,46,0.848,46,72,118,106,29,4,32,54,477,Payton Pritchard
2023-2024,Dallas Mavericks,PF,40,1,336,40,104,0.385,13,45,0.289,27,59,0.458,0.447,28,41,0.683,25,54,79,22,7,4,8,20,121,Olivier-Maxence Prosper
2024-2025,Dallas Mavericks,PF,20,0,138,15,40,0.375,4,14,0.286,11,26,0.423,0.425,9,13,0.692,13,22,35,8,4,2,2,7,43,Olivier-Maxence Prosper
2021-2022,Houston Rockets,SG,10,0,74,15,33,0.455,9,24,0.375,6,9,0.667,0.591,4,4,1,7,9,16,4,5,1,7,6,43,Trevelin Queen
2022-2023,Indiana Pacers,SG,7,0,70,7,29,0.241,2,15,0.133,5,14,0.357,0.276,5,5,1,8,9,17,6,2,5,7,4,21,Trevelin Queen
2023-2024,Orlando Magic,SG,14,0,165,14,38,0.368,3,17,0.176,11,21,0.524,0.408,9,12,0.75,3,17,20,18,7,5,7,15,40,Trevelin Queen
2024-2025,Orlando Magic,SG,7,2,122,16,31,0.516,8,16,0.5,8,15,0.533,0.645,4,4,1,2,5,7,10,8,3,7,14,44,Trevelin Queen
2021-2022,Sacramento Kings,C,15,0,120,17,38,0.447,0,0,,17,38,0.447,0.447,11,17,0.647,14,17,31,6,1,8,6,18,45,Neemias Queta
2022-2023,Sacramento Kings,C,5,0,29,6,9,0.667,0,0,,6,9,0.667,0.667,0,2,0,5,6,11,1,0,2,1,7,12,Neemias Queta
2023-2024,Boston Celtics,C,28,0,333,67,104,0.644,0,0,,67,104,0.644,0.644,20,28,0.714,53,69,122,20,13,21,13,50,154,Neemias Queta
2024-2025,Boston Celtics,C,25,5,403,56,89,0.629,0,2,0,56,87,0.644,0.629,20,27,0.741,41,74,115,17,7,23,18,50,132,Neemias Queta
2020-2021,New York Knicks,PG,64,3,1243,229,580,0.395,118,303,0.389,111,277,0.401,0.497,155,174,0.891,25,112,137,127,30,12,58,114,731,Immanuel Quickley
2021-2022,New York Knicks,PG,78,3,1802,284,724,0.392,137,396,0.346,147,328,0.448,0.487,177,201,0.881,31,216,247,275,54,3,99,167,882,Immanuel Quickley
2022-2023,New York Knicks,SG,81,21,2344,419,936,0.448,168,454,0.37,251,482,0.521,0.537,203,248,0.819,58,279,337,279,80,14,100,166,1209,Immanuel Quickley
2023-2024,Total,SG,68,38,1985,388,894,0.434,171,433,0.395,217,461,0.471,0.53,209,245,0.853,17,242,259,331,50,10,101,119,1156,Immanuel Quickley
2023-2024,New York Knicks,SG,30,0,720,152,335,0.454,64,162,0.395,88,173,0.509,0.549,82,94,0.872,5,72,77,74,16,3,31,44,450,Immanuel Quickley
2023-2024,Toronto Raptors,PG,38,38,1265,236,559,0.422,107,271,0.395,129,288,0.448,0.518,127,151,0.841,12,170,182,257,34,7,70,75,706,Immanuel Quickley
2024-2025,Toronto Raptors,PG,3,3,68,16,42,0.381,6,16,0.375,10,26,0.385,0.452,8,9,0.889,1,5,6,12,2,0,4,7,46,Immanuel Quickley
2022-2023,Golden State Warriors,SG,4,0,18,2,5,0.4,2,4,0.5,0,1,0,0.6,4,6,0.667,1,2,3,2,1,0,5,0,10,Lester Quiñones
2023-2024,Golden State Warriors,SG,37,0,394,56,141,0.397,32,88,0.364,24,53,0.453,0.511,20,29,0.69,21,51,72,36,6,2,17,44,164,Lester Quiñones
2024-2025,Philadelphia 76ers,SG,4,0,17,4,8,0.5,0,3,0,4,5,0.8,0.5,1,1,1,3,1,4,1,0,0,4,0,9,Lester Quiñones
2020-2021,Sacramento Kings,SG,13,0,94,15,38,0.395,5,19,0.263,10,19,0.526,0.461,5,5,1,2,8,10,6,4,1,3,8,40,Jahmi'us Ramsey
2021-2022,Sacramento Kings,SG,19,0,134,24,58,0.414,5,18,0.278,19,40,0.475,0.457,7,14,0.5,4,9,13,7,1,1,5,10,60,Jahmi'us Ramsey
2023-2024,Toronto Raptors,SG,7,1,121,18,41,0.439,6,22,0.273,12,19,0.632,0.512,5,6,0.833,4,18,22,8,7,0,7,10,47,Jahmi'us Ramsey
2016-2017,Total,PG,26,0,299,40,98,0.408,16,47,0.34,24,51,0.471,0.49,41,43,0.953,6,26,32,34,9,2,19,39,137,Chasson Randle
2016-2017,Philadelphia 76ers,PG,8,0,74,12,26,0.462,6,15,0.4,6,11,0.545,0.577,12,12,1,0,5,5,6,3,1,3,11,42,Chasson Randle
2016-2017,New York Knicks,PG,18,0,225,28,72,0.389,10,32,0.313,18,40,0.45,0.458,29,31,0.935,6,21,27,28,6,1,16,28,95,Chasson Randle
2018-2019,Washington Wizards,PG,49,2,743,91,217,0.419,46,115,0.4,45,102,0.441,0.525,43,62,0.694,10,46,56,97,25,3,43,91,271,Chasson Randle
2019-2020,Golden State Warriors,PG,3,0,40,0,4,0,0,2,0,0,2,0,0,5,6,0.833,0,2,2,5,2,0,0,3,5,Chasson Randle
2020-2021,Orlando Magic,PG,41,5,837,92,237,0.388,44,130,0.338,48,107,0.449,0.481,38,48,0.792,7,75,82,74,22,5,46,64,266,Chasson Randle
2014-2015,Los Angeles Lakers,PF,1,0,14,1,3,0.333,0,0,,1,3,0.333,0.333,0,2,0,0,0,0,0,0,0,1,1,2,Julius Randle
2015-2016,Los Angeles Lakers,PF,81,60,2286,358,835,0.429,10,36,0.278,348,799,0.436,0.435,193,270,0.715,172,657,829,144,53,29,149,242,919,Julius Randle
2016-2017,Los Angeles Lakers,PF,74,73,2132,377,773,0.488,17,63,0.27,360,710,0.507,0.499,204,282,0.723,150,486,636,264,49,37,173,248,975,Julius Randle
2017-2018,Los Angeles Lakers,C,82,49,2190,504,904,0.558,10,45,0.222,494,859,0.575,0.563,305,425,0.718,181,473,654,210,43,45,213,274,1323,Julius Randle
2018-2019,New Orleans Pelicans,PF,73,49,2232,571,1089,0.524,67,195,0.344,504,894,0.564,0.555,356,487,0.731,162,472,634,229,52,45,208,246,1565,Julius Randle
2019-2020,New York Knicks,PF,64,64,2080,463,1006,0.46,64,231,0.277,399,775,0.515,0.492,258,352,0.733,151,471,622,198,51,22,193,178,1248,Julius Randle
2020-2021,New York Knicks,PF,71,71,2667,602,1321,0.456,160,389,0.411,442,932,0.474,0.516,348,429,0.811,84,639,723,427,64,18,241,225,1712,Julius Randle
2021-2022,New York Knicks,PF,72,72,2544,512,1246,0.411,120,390,0.308,392,856,0.458,0.459,303,401,0.756,125,591,716,370,53,39,245,205,1447,Julius Randle
2022-2023,New York Knicks,PF,77,77,2737,658,1432,0.459,218,636,0.343,440,796,0.553,0.536,402,531,0.757,141,626,767,316,49,21,216,233,1936,Julius Randle
2023-2024,New York Knicks,PF,46,46,1630,395,836,0.472,76,244,0.311,319,592,0.539,0.518,236,302,0.781,99,324,423,229,25,12,159,125,1102,Julius Randle
2024-2025,Minnesota Timberwolves,PF,30,30,993,206,430,0.479,55,144,0.382,151,286,0.528,0.543,144,176,0.818,56,156,212,131,21,6,90,76,611,Julius Randle
2023-2024,Portland Trail Blazers,C,68,20,1214,230,499,0.461,88,245,0.359,142,254,0.559,0.549,69,93,0.742,93,157,250,67,33,38,52,161,617,Duop Reath
2024-2025,Portland Trail Blazers,C,14,0,86,11,29,0.379,8,22,0.364,3,7,0.429,0.517,0,0,,6,7,13,4,0,2,1,10,30,Duop Reath
2021-2022,Los Angeles Lakers,SG,61,19,1418,146,318,0.459,53,167,0.317,93,151,0.616,0.542,99,118,0.839,45,148,193,110,29,20,40,87,444,Austin Reaves
2022-2023,Los Angeles Lakers,SG,64,22,1843,259,490,0.529,86,216,0.398,173,274,0.631,0.616,229,265,0.864,33,160,193,215,33,19,99,108,833,Austin Reaves
2023-2024,Los Angeles Lakers,SG,82,57,2629,457,940,0.486,154,420,0.367,303,520,0.583,0.568,232,272,0.853,57,295,352,450,66,25,174,153,1300,Austin Reaves
2024-2025,Los Angeles Lakers,SG,25,25,851,148,338,0.438,66,186,0.355,82,152,0.539,0.536,72,89,0.809,21,81,102,128,27,4,58,53,434,Austin Reaves
2019-2020,Dallas Mavericks,SF,4,0,28,3,9,0.333,0,2,0,3,7,0.429,0.333,2,2,1,1,2,3,3,0,0,0,5,8,Josh Reaves
2019-2020,Atlanta Hawks,SF,58,34,1551,213,554,0.384,83,250,0.332,130,304,0.428,0.459,101,126,0.802,35,181,216,87,62,28,96,132,610,Cam Reddish
2020-2021,Atlanta Hawks,SF,26,21,750,96,263,0.365,33,126,0.262,63,137,0.46,0.428,67,82,0.817,22,82,104,35,33,9,34,68,292,Cam Reddish
2021-2022,Total,SF,49,7,1012,165,408,0.404,66,184,0.359,99,224,0.442,0.485,101,112,0.902,25,80,105,48,47,15,57,60,497,Cam Reddish
2021-2022,Atlanta Hawks,SF,34,7,797,138,343,0.402,58,153,0.379,80,190,0.421,0.487,72,80,0.9,20,64,84,38,35,11,44,45,406,Cam Reddish
2021-2022,New York Knicks,SF,15,0,215,27,65,0.415,8,31,0.258,19,34,0.559,0.477,29,32,0.906,5,16,21,10,12,4,13,15,91,Cam Reddish
2022-2023,Total,SF,40,20,990,139,312,0.446,45,144,0.313,94,168,0.56,0.518,64,75,0.853,18,70,88,57,39,14,47,72,387,Cam Reddish
2022-2023,New York Knicks,SF,20,8,438,61,136,0.449,17,56,0.304,44,80,0.55,0.511,29,33,0.879,7,24,31,20,15,8,15,32,168,Cam Reddish
2022-2023,Portland Trail Blazers,SF,20,12,552,78,176,0.443,28,88,0.318,50,88,0.568,0.523,35,42,0.833,11,46,57,37,24,6,32,40,219,Cam Reddish
2023-2024,Los Angeles Lakers,SF,48,26,984,91,234,0.389,37,110,0.336,54,124,0.435,0.468,41,54,0.759,27,72,99,48,47,14,31,64,260,Cam Reddish
2024-2025,Los Angeles Lakers,SF,23,8,450,32,67,0.478,11,35,0.314,21,32,0.656,0.56,13,19,0.684,12,36,48,18,27,9,12,39,88,Cam Reddish
2017-2018,Phoenix Suns,SG,21,1,242,22,76,0.289,11,38,0.289,11,38,0.289,0.362,8,12,0.667,2,37,39,13,10,2,10,17,63,Davon Reed
2018-2019,Indiana Pacers,SG,10,0,47,5,12,0.417,2,4,0.5,3,8,0.375,0.5,0,0,,2,4,6,3,1,0,1,3,12,Davon Reed
2021-2022,Denver Nuggets,SG,48,5,668,81,161,0.503,37,86,0.43,44,75,0.587,0.618,10,15,0.667,14,94,108,53,24,9,16,63,209,Davon Reed
2022-2023,Total,SG,43,1,342,28,84,0.333,17,46,0.37,11,38,0.289,0.435,16,24,0.667,10,49,59,23,15,4,20,39,89,Davon Reed
2022-2023,Denver Nuggets,SG,35,1,315,25,80,0.313,16,44,0.364,9,36,0.25,0.413,15,20,0.75,9,46,55,19,13,4,20,36,81,Davon Reed
2022-2023,Los Angeles Lakers,SG,8,0,27,3,4,0.75,1,2,0.5,2,2,1,0.875,1,4,0.25,1,3,4,4,2,0,0,3,8,Davon Reed
2020-2021,Philadelphia 76ers,PF,26,0,177,42,78,0.538,0,6,0,42,72,0.583,0.538,4,8,0.5,30,31,61,12,10,13,12,29,88,Paul Reed
2021-2022,Philadelphia 76ers,C,38,2,302,54,96,0.563,2,8,0.25,52,88,0.591,0.573,6,14,0.429,44,48,92,16,33,14,10,57,116,Paul Reed
2022-2023,Philadelphia 76ers,C,69,2,755,124,209,0.593,1,6,0.167,123,203,0.606,0.596,38,51,0.745,112,150,262,27,46,51,45,123,287,Paul Reed
2023-2024,Philadelphia 76ers,C,82,24,1590,259,480,0.54,21,57,0.368,238,423,0.563,0.561,61,85,0.718,193,295,488,109,67,84,67,198,600,Paul Reed
2024-2025,Detroit Pistons,C,17,0,201,35,60,0.583,5,13,0.385,30,47,0.638,0.625,14,17,0.824,15,28,43,18,19,12,11,31,89,Paul Reed
2024-2025,Oklahoma City Thunder,PF,1,0,2,1,1,1,0,0,1,1,1,1,0,0,1,0,1,0,0,0,0,0,2,0,,Alex Reese
2024-2025,New Orleans Pelicans,SG,16,0,149,28,70,0.4,9,34,0.265,19,36,0.528,0.464,6,7,0.857,6,12,18,10,5,0,5,7,71,Antonio Reeves
2019-2020,Minnesota Timberwolves,C,30,11,495,100,243,0.412,32,97,0.33,68,146,0.466,0.477,37,53,0.698,34,90,124,35,19,22,22,83,269,Naz Reid
2020-2021,Minnesota Timberwolves,C,70,15,1347,304,581,0.523,61,174,0.351,243,407,0.597,0.576,115,166,0.693,82,240,322,72,34,76,69,179,784,Naz Reid
2021-2022,Minnesota Timberwolves,C,77,6,1215,233,476,0.489,57,166,0.343,176,310,0.568,0.549,114,149,0.765,102,199,301,71,40,71,82,172,637,Naz Reid
2022-2023,Minnesota Timberwolves,C,68,11,1251,310,577,0.537,75,217,0.346,235,360,0.653,0.602,86,127,0.677,73,260,333,77,42,53,92,176,781,Naz Reid
2023-2024,Minnesota Timberwolves,PF,81,14,1964,406,851,0.477,169,408,0.414,237,443,0.535,0.576,109,148,0.736,73,350,423,106,63,73,111,172,1090,Naz Reid
2024-2025,Minnesota Timberwolves,C,30,0,736,136,299,0.455,52,149,0.349,84,150,0.56,0.542,43,51,0.843,20,126,146,50,22,23,38,71,367,Naz Reid
2022-2023,Detroit Pistons,SG,14,0,198,17,44,0.386,5,20,0.25,12,24,0.5,0.443,6,6,1,11,26,37,4,4,1,3,23,45,Jared Rhoden
2023-2024,Detroit Pistons,SG,17,0,245,33,66,0.5,12,31,0.387,21,35,0.6,0.591,5,8,0.625,3,30,33,14,3,13,7,28,83,Jared Rhoden
2024-2025,Charlotte Hornets,SG,4,0,12,2,8,0.25,0,2,0,2,6,0.333,0.25,0,0,,2,2,4,2,1,0,1,1,4,Jared Rhoden
2020-2021,Charlotte Hornets,PF,18,0,63,4,9,0.444,0,1,0,4,8,0.5,0.444,7,11,0.636,4,7,11,2,0,0,3,7,15,Nick Richards
2021-2022,Charlotte Hornets,C,50,5,367,60,90,0.667,0,0,,60,90,0.667,0.667,30,43,0.698,34,52,86,13,9,21,24,51,150,Nick Richards
2022-2023,Charlotte Hornets,C,65,9,1217,197,313,0.629,1,1,1,196,312,0.628,0.631,137,183,0.749,147,269,416,38,11,71,59,154,532,Nick Richards
2023-2024,Charlotte Hornets,C,67,51,1759,260,376,0.691,0,1,0,260,375,0.693,0.691,132,179,0.737,172,367,539,54,26,74,73,176,652,Nick Richards
2024-2025,Charlotte Hornets,C,15,9,347,53,92,0.576,0,1,0,53,91,0.582,0.576,49,72,0.681,37,87,124,21,6,19,26,42,155,Nick Richards
2015-2016,Miami Heat,SG,52,2,1107,123,272,0.452,53,115,0.461,70,157,0.446,0.55,42,63,0.667,21,86,107,73,36,25,35,107,341,Josh Richardson
2016-2017,Miami Heat,SG,53,34,1614,202,513,0.394,75,227,0.33,127,286,0.444,0.467,60,77,0.779,35,133,168,140,60,39,65,132,539,Josh Richardson
2017-2018,Miami Heat,SF,81,81,2689,399,885,0.451,127,336,0.378,272,549,0.495,0.523,120,142,0.845,69,216,285,231,121,75,140,199,1045,Josh Richardson
2018-2019,Miami Heat,SG,73,73,2539,423,1026,0.412,164,460,0.357,259,566,0.458,0.492,199,231,0.861,54,209,263,298,79,34,113,200,1209,Josh Richardson
2019-2020,Philadelphia 76ers,SG,55,53,1693,278,646,0.43,85,249,0.341,193,397,0.486,0.496,114,141,0.809,41,133,174,162,52,36,104,136,755,Josh Richardson
2020-2021,Dallas Mavericks,SG,59,56,1790,264,618,0.427,88,267,0.33,176,351,0.501,0.498,99,108,0.917,51,144,195,153,61,24,79,130,715,Josh Richardson
2021-2022,Total,SG,65,7,1600,234,534,0.438,102,246,0.415,132,288,0.458,0.534,96,108,0.889,42,143,185,115,56,29,66,116,666,Josh Richardson
2021-2022,Boston Celtics,SG,44,0,1087,152,343,0.443,62,156,0.397,90,187,0.481,0.534,61,71,0.859,26,99,125,66,34,23,39,82,427,Josh Richardson
2021-2022,San Antonio Spurs,SG,21,7,513,82,191,0.429,40,90,0.444,42,101,0.416,0.534,35,37,0.946,16,44,60,49,22,6,27,34,239,Josh Richardson
2022-2023,Total,SG,65,10,1530,239,554,0.431,107,293,0.365,132,261,0.506,0.528,69,81,0.852,41,134,175,174,69,20,86,117,654,Josh Richardson
2022-2023,San Antonio Spurs,SG,42,6,997,177,406,0.436,74,207,0.357,103,199,0.518,0.527,53,60,0.883,30,89,119,137,40,11,63,70,481,Josh Richardson
2022-2023,New Orleans Pelicans,SG,23,4,533,62,148,0.419,33,86,0.384,29,62,0.468,0.53,16,21,0.762,11,45,56,37,29,9,23,47,173,Josh Richardson
2023-2024,Miami Heat,SG,43,6,1103,154,347,0.444,66,190,0.347,88,157,0.561,0.539,51,54,0.944,18,103,121,105,24,14,36,76,425,Josh Richardson
2024-2025,Miami Heat,SG,8,0,150,11,38,0.289,6,22,0.273,5,16,0.313,0.368,4,4,1,6,6,12,12,8,1,8,17,32,Josh Richardson
2020-2021,Charlotte Hornets,PG,7,0,27,8,12,0.667,2,4,0.5,6,8,0.75,0.75,0,0,0,1,1,3,1,0,1,0,18,0,Grant Riller
2024-2025,Atlanta Hawks,SF,31,29,727,122,308,0.396,38,135,0.281,84,173,0.486,0.458,51,74,0.689,34,67,101,37,25,19,37,65,333,Zaccharie Risacher
2012-2013,New Orleans Pelicans,SG,61,26,1418,145,390,0.372,28,86,0.326,117,304,0.385,0.408,59,108,0.546,16,93,109,127,26,9,74,122,377,Austin Rivers
2013-2014,New Orleans Pelicans,PG,69,4,1339,192,474,0.405,36,99,0.364,156,375,0.416,0.443,110,173,0.636,26,103,129,160,45,9,77,134,530,Austin Rivers
2014-2015,Total,SG,76,5,1563,203,496,0.409,39,131,0.298,164,365,0.449,0.449,85,126,0.675,27,125,152,155,48,14,65,146,530,Austin Rivers
2014-2015,New Orleans Pelicans,SG,35,3,772,86,222,0.387,14,50,0.28,72,172,0.419,0.419,53,71,0.746,12,56,68,87,18,7,30,65,239,Austin Rivers
2014-2015,Los Angeles Clippers,SG,41,2,791,117,274,0.427,25,81,0.309,92,193,0.477,0.473,32,55,0.582,15,69,84,68,30,7,35,81,291,Austin Rivers
2015-2016,Los Angeles Clippers,SG,67,7,1464,226,516,0.438,62,185,0.335,164,331,0.495,0.498,79,116,0.681,22,108,130,99,48,9,61,137,593,Austin Rivers
2016-2017,Los Angeles Clippers,SG,74,29,2054,323,731,0.442,111,299,0.371,212,432,0.491,0.518,132,191,0.691,20,141,161,204,48,10,115,187,889,Austin Rivers
2017-2018,Los Angeles Clippers,SG,61,59,2057,341,805,0.424,136,360,0.378,205,445,0.461,0.508,102,159,0.642,27,118,145,242,74,16,109,152,920,Austin Rivers
2018-2019,Total,SG,76,15,2028,232,572,0.406,104,327,0.318,128,245,0.522,0.497,50,95,0.526,25,137,162,167,47,23,68,207,618,Austin Rivers
2018-2019,Washington Wizards,SG,29,2,683,76,194,0.392,33,106,0.311,43,88,0.489,0.477,25,46,0.543,10,61,71,58,18,10,36,72,210,Austin Rivers
2018-2019,Houston Rockets,SG,47,13,1345,156,378,0.413,71,221,0.321,85,157,0.541,0.507,25,49,0.51,15,76,91,109,29,13,32,135,408,Austin Rivers
2019-2020,Houston Rockets,SG,68,4,1594,211,501,0.421,96,270,0.356,115,231,0.498,0.517,78,111,0.703,27,148,175,113,49,10,50,129,596,Austin Rivers
2020-2021,Total,SG,36,7,845,104,245,0.424,55,149,0.369,49,96,0.51,0.537,22,31,0.71,8,74,82,81,30,2,36,64,285,Austin Rivers
2020-2021,New York Knicks,SG,21,2,442,58,135,0.43,28,77,0.364,30,58,0.517,0.533,10,14,0.714,5,42,47,42,12,0,22,32,154,Austin Rivers
2020-2021,Denver Nuggets,SG,15,5,403,46,110,0.418,27,72,0.375,19,38,0.5,0.541,12,17,0.706,3,32,35,39,18,2,14,32,131,Austin Rivers
2021-2022,Denver Nuggets,SG,67,18,1480,146,350,0.417,79,231,0.342,67,119,0.563,0.53,32,44,0.727,19,95,114,90,51,6,54,121,403,Austin Rivers
2022-2023,Minnesota Timberwolves,SG,52,10,1016,91,209,0.435,43,123,0.35,48,86,0.558,0.538,30,39,0.769,5,78,83,75,28,4,23,80,255,Austin Rivers
2024-2025,Milwaukee Bucks,C,7,0,33,2,4,0.5,0,1,0,2,3,0.667,0.5,1,4,0.25,4,3,7,1,1,1,1,4,5,Liam Robbins
2018-2019,Miami Heat,SF,15,1,161,18,46,0.391,10,35,0.286,8,11,0.727,0.5,4,6,0.667,2,17,19,5,5,0,4,11,50,Duncan Robinson
2019-2020,Miami Heat,SG,73,68,2166,323,687,0.47,270,606,0.446,53,81,0.654,0.667,67,72,0.931,10,222,232,102,35,19,70,193,983,Duncan Robinson
2020-2021,Miami Heat,SF,72,72,2262,315,717,0.439,250,613,0.408,65,104,0.625,0.614,62,75,0.827,7,243,250,127,43,20,81,181,942,Duncan Robinson
2021-2022,Miami Heat,SG,79,68,2043,290,726,0.399,232,624,0.372,58,102,0.569,0.559,51,61,0.836,24,179,203,129,42,14,60,201,863,Duncan Robinson
2022-2023,Miami Heat,SF,42,1,691,88,237,0.371,63,192,0.328,25,45,0.556,0.504,29,32,0.906,8,61,69,46,14,0,28,77,268,Duncan Robinson
2023-2024,Miami Heat,SF,68,36,1905,304,675,0.45,187,473,0.395,117,202,0.579,0.589,80,90,0.889,15,158,173,192,46,16,95,163,875,Duncan Robinson
2024-2025,Miami Heat,SF,27,16,620,105,253,0.415,67,178,0.376,38,75,0.507,0.547,19,22,0.864,10,51,61,65,13,3,25,58,296,Duncan Robinson
2018-2019,Los Angeles Clippers,SG,33,0,320,44,110,0.4,18,57,0.316,26,53,0.491,0.482,6,9,0.667,3,38,41,19,11,3,13,46,112,Jerome Robinson
2019-2020,Total,SG,63,6,979,115,310,0.371,49,153,0.32,66,157,0.42,0.45,40,57,0.702,13,116,129,87,28,17,49,112,319,Jerome Robinson
2019-2020,Los Angeles Clippers,SG,42,1,476,46,136,0.338,19,67,0.284,27,69,0.391,0.408,11,19,0.579,5,55,60,46,13,8,26,55,122,Jerome Robinson
2019-2020,Washington Wizards,SG,21,5,503,69,174,0.397,30,86,0.349,39,88,0.443,0.483,29,38,0.763,8,61,69,41,15,9,23,57,197,Jerome Robinson
2020-2021,Washington Wizards,SG,17,6,305,28,95,0.295,11,42,0.262,17,53,0.321,0.353,16,20,0.8,4,34,38,25,12,6,19,31,83,Jerome Robinson
2023-2024,Golden State Warriors,SG,22,0,81,11,33,0.333,2,17,0.118,9,16,0.563,0.364,7,11,0.636,1,5,6,5,1,3,2,5,31,Jerome Robinson
2019-2020,Washington Wizards,PG,9,0,49,5,12,0.417,3,5,0.6,2,7,0.286,0.542,0,0,,1,4,5,7,0,1,3,2,13,Justin Robinson
2020-2021,Oklahoma City Thunder,PG,9,0,88,7,21,0.333,4,14,0.286,3,7,0.429,0.429,3,5,0.6,1,6,7,9,3,0,2,10,21,Justin Robinson
2021-2022,Total,PG,25,0,304,28,93,0.301,18,61,0.295,10,32,0.313,0.398,4,8,0.5,4,17,21,32,9,1,17,27,78,Justin Robinson
2021-2022,Milwaukee Bucks,PG,17,0,198,18,57,0.316,10,37,0.27,8,20,0.4,0.404,2,2,1,2,11,13,21,8,0,11,17,48,Justin Robinson
2021-2022,Sacramento Kings,PG,3,0,15,1,8,0.125,0,3,0,1,5,0.2,0.125,0,0,,0,1,1,2,0,0,1,2,2,Justin Robinson
2021-2022,Detroit Pistons,PG,5,0,91,9,28,0.321,8,21,0.381,1,7,0.143,0.464,2,6,0.333,2,5,7,9,1,1,5,8,28,Justin Robinson
2018-2019,New York Knicks,C,66,19,1360,202,291,0.694,0,0,202,291,0.694,0.694,81,135,0.6,177,246,423,37,52,161,35,217,485,0,Mitchell Robinson
2019-2020,New York Knicks,C,61,7,1412,253,341,0.742,0,0,253,341,0.742,0.742,84,148,0.568,186,242,428,36,52,119,37,194,590,0,Mitchell Robinson
2020-2021,New York Knicks,C,31,29,853,115,176,0.653,0,0,115,176,0.653,0.653,26,53,0.491,113,139,252,17,35,45,26,86,256,0,Mitchell Robinson
2021-2022,New York Knicks,C,72,62,1848,261,343,0.761,0,0,261,343,0.761,0.761,88,181,0.486,295,322,617,38,58,133,60,195,610,0,Mitchell Robinson
2022-2023,New York Knicks,C,59,58,1591,188,280,0.671,0,0,188,280,0.671,0.671,59,122,0.484,267,288,555,53,56,109,41,160,435,0,Mitchell Robinson
2023-2024,New York Knicks,C,31,21,768,73,127,0.575,0,0,73,127,0.575,0.575,27,66,0.409,142,121,263,18,37,35,25,55,173,0,Mitchell Robinson
2022-2023,Miami Heat,C,31,1,425,47,89,0.528,0,6,0,47,83,0.566,0.528,22,31,0.71,48,78,126,25,12,12,16,53,116,Orlando Robinson
2023-2024,Miami Heat,C,36,7,304,36,72,0.5,8,15,0.533,28,57,0.491,0.556,19,25,0.76,28,56,84,34,7,8,18,35,99,Orlando Robinson
2024-2025,Sacramento Kings,C,8,0,50,6,15,0.4,1,5,0.2,5,10,0.5,0.433,3,6,0.5,3,9,12,9,2,1,3,6,16,Orlando Robinson
2021-2022,Oklahoma City Thunder,C,49,36,1087,134,324,0.414,58,165,0.352,76,159,0.478,0.503,40,54,0.741,75,199,274,49,29,15,39,75,366,Jeremiah Robinson-Earl
2022-2023,Oklahoma City Thunder,PF,43,20,814,110,248,0.444,37,111,0.333,73,137,0.533,0.518,35,42,0.833,71,109,180,43,24,11,19,71,292,Jeremiah Robinson-Earl
2023-2024,New Orleans Pelicans,PF,39,1,334,45,95,0.474,13,39,0.333,32,56,0.571,0.542,12,16,0.75,23,53,76,21,10,4,16,24,115,Jeremiah Robinson-Earl
2024-2025,New Orleans Pelicans,PF,29,4,563,74,168,0.44,23,75,0.307,51,93,0.548,0.509,25,29,0.862,59,81,140,35,22,3,24,38,196,Jeremiah Robinson-Earl
2019-2020,Oklahoma City Thunder,PF,3,0,11,0,1,0,0,0,,0,1,0,0,0,0,,0,2,2,0,0,0,1,1,0,Isaiah Roby
2020-2021,Oklahoma City Thunder,PF,61,34,1425,207,429,0.483,32,109,0.294,175,320,0.547,0.52,87,117,0.744,89,252,341,107,52,37,113,162,533,Isaiah Roby
2021-2022,Oklahoma City Thunder,PF,45,28,948,166,323,0.514,44,99,0.444,122,224,0.545,0.582,78,116,0.672,75,142,217,71,36,34,43,109,454,Isaiah Roby
2022-2023,San Antonio Spurs,PF,42,2,474,67,155,0.432,18,60,0.3,49,95,0.516,0.49,20,41,0.488,21,86,107,38,18,7,31,53,172,Isaiah Roby
2022-2023,Memphis Grizzlies,PF,70,4,1258,180,420,0.429,65,212,0.307,115,208,0.553,0.506,41,65,0.631,50,143,193,59,29,19,57,107,466,David Roddy
2023-2024,Total,PF,65,13,1177,165,409,0.403,48,164,0.293,117,245,0.478,0.462,47,68,0.691,53,158,211,80,27,11,57,72,425,David Roddy
2023-2024,Memphis Grizzlies,PF,48,13,1114,155,386,0.402,47,156,0.301,108,230,0.47,0.462,46,67,0.687,51,149,200,76,25,11,54,68,403,David Roddy
2023-2024,Phoenix Suns,PF,17,0,63,10,23,0.435,1,8,0.125,9,15,0.6,0.457,1,1,1,2,9,11,4,2,0,3,4,22,David Roddy
2024-2025,Atlanta Hawks,PF,16,1,215,29,51,0.569,11,26,0.423,18,25,0.72,0.676,11,13,0.846,4,38,42,19,6,3,14,11,80,David Roddy
2022-2023,Golden State Warriors,PG,12,0,62,7,20,0.35,3,9,0.333,4,11,0.364,0.425,6,6,1,3,9,12,6,1,1,16,10,23,Ryan Rollins
2023-2024,Total,PG,13,0,78,14,27,0.519,3,4,0.75,11,23,0.478,0.574,13,17,0.765,2,11,13,14,10,3,8,8,44,Ryan Rollins
2023-2024,Washington Wizards,PG,10,0,66,13,25,0.52,2,3,0.667,11,22,0.5,0.56,13,17,0.765,2,9,11,11,8,3,7,7,41,Ryan Rollins
2023-2024,Milwaukee Bucks,PG,3,0,12,1,2,0.5,1,1,1,0,1,0,0.75,0,0,,0,2,2,3,2,0,1,1,3,Ryan Rollins
2024-2025,Milwaukee Bucks,PG,15,4,166,25,55,0.455,12,27,0.444,13,28,0.464,0.564,7,9,0.778,5,18,23,17,16,6,16,17,69,Ryan Rollins
2015-2016,Boston Celtics,PG,39,0,311,29,106,0.274,6,27,0.222,23,79,0.291,0.302,8,10,0.8,24,39,63,37,6,1,19,23,72,Terry Rozier
2016-2017,Boston Celtics,PG,74,0,1263,151,411,0.367,57,179,0.318,94,232,0.405,0.437,51,66,0.773,40,187,227,131,46,11,47,69,410,Terry Rozier
2017-2018,Boston Celtics,PG,80,16,2068,316,800,0.395,153,402,0.381,163,398,0.41,0.491,115,149,0.772,63,313,376,232,80,19,80,123,900,Terry Rozier
2018-2019,Boston Celtics,PG,79,14,1791,258,666,0.387,119,337,0.353,139,329,0.422,0.477,73,93,0.785,32,275,307,231,68,21,68,101,708,Terry Rozier
2019-2020,Charlotte Hornets,PG,63,63,2164,398,941,0.423,172,423,0.407,226,518,0.436,0.514,166,190,0.874,50,226,276,259,61,10,141,126,1134,Terry Rozier
2020-2021,Charlotte Hornets,SG,69,69,2383,510,1134,0.45,222,571,0.389,288,563,0.512,0.548,165,202,0.817,47,255,302,293,87,26,128,119,1407,Terry Rozier
2021-2022,Charlotte Hornets,SG,73,73,2458,518,1167,0.444,222,593,0.374,296,574,0.516,0.539,150,176,0.852,56,259,315,326,93,25,96,119,1408,Terry Rozier
2022-2023,Charlotte Hornets,SG,63,63,2221,493,1188,0.415,165,505,0.327,328,683,0.48,0.484,178,220,0.809,51,208,259,319,74,16,134,119,1329,Terry Rozier
2023-2024,Total,SG,61,60,2040,442,998,0.443,149,410,0.363,293,588,0.498,0.518,172,198,0.869,35,212,247,342,63,21,106,101,1205,Terry Rozier
2023-2024,Charlotte Hornets,SG,30,30,1065,252,549,0.459,83,232,0.358,169,317,0.533,0.535,109,129,0.845,17,100,117,198,32,12,65,52,696,Terry Rozier
2023-2024,Miami Heat,PG,31,30,975,190,449,0.423,66,178,0.371,124,271,0.458,0.497,63,69,0.913,18,112,130,144,31,9,41,49,509,Terry Rozier
2024-2025,Miami Heat,PG,25,12,716,107,265,0.404,45,130,0.346,62,135,0.459,0.489,43,49,0.878,19,80,99,73,16,9,37,37,302,Terry Rozier
2023-2024,Portland Trail Blazers,SG,39,12,633,54,161,0.335,28,78,0.359,26,83,0.313,0.422,19,25,0.76,24,68,92,62,12,3,31,56,155,Rayan Rupert
2024-2025,Portland Trail Blazers,SG,23,0,235,29,67,0.433,9,30,0.3,20,37,0.541,0.5,12,16,0.75,17,18,35,11,7,2,13,16,79,Rayan Rupert
2015-2016,Los Angeles Lakers,PG,80,48,2259,392,956,0.41,130,370,0.351,262,586,0.447,0.478,140,190,0.737,47,227,274,266,93,13,196,142,1054,D'Angelo Russell
2016-2017,Los Angeles Lakers,PG,63,60,1811,351,867,0.405,135,384,0.352,216,483,0.447,0.483,147,188,0.782,31,190,221,303,87,16,176,130,984,D'Angelo Russell
2017-2018,Brooklyn Nets,PG,48,35,1234,278,672,0.414,90,278,0.324,188,394,0.477,0.481,97,131,0.74,30,159,189,249,36,17,147,93,743,D'Angelo Russell
2018-2019,Brooklyn Nets,PG,81,81,2448,659,1517,0.434,234,635,0.369,425,882,0.482,0.512,160,205,0.78,53,262,315,563,100,20,253,141,1712,D'Angelo Russell
2019-2020,Total,PG,45,45,1452,360,846,0.426,158,431,0.367,202,415,0.487,0.519,161,199,0.809,17,160,177,285,48,13,147,86,1039,D'Angelo Russell
2019-2020,Golden State Warriors,PG,33,33,1060,273,635,0.43,120,321,0.374,153,314,0.487,0.524,113,144,0.785,14,108,122,206,31,9,101,64,779,D'Angelo Russell
2019-2020,Minnesota Timberwolves,PG,12,12,392,87,211,0.412,38,110,0.345,49,101,0.485,0.502,48,55,0.873,3,52,55,79,17,4,46,22,260,D'Angelo Russell
2020-2021,Minnesota Timberwolves,PG,42,26,1196,281,652,0.431,120,310,0.387,161,342,0.471,0.523,114,149,0.765,16,95,111,244,45,18,112,68,796,D'Angelo Russell
2021-2022,Minnesota Timberwolves,PG,65,65,2077,401,975,0.411,176,518,0.34,225,457,0.492,0.502,198,240,0.825,25,191,216,460,62,22,165,130,1176,D'Angelo Russell
2022-2023,Total,PG,71,71,2304,445,948,0.469,194,490,0.396,251,458,0.548,0.572,179,216,0.829,35,180,215,437,70,29,186,140,1263,D'Angelo Russell
2022-2023,Minnesota Timberwolves,PG,54,54,1778,338,727,0.465,148,379,0.391,190,348,0.546,0.567,143,167,0.856,28,137,165,334,60,21,147,117,967,D'Angelo Russell
2022-2023,Los Angeles Lakers,PG,17,17,526,107,221,0.484,46,111,0.414,61,110,0.555,0.588,36,49,0.735,7,43,50,103,10,8,39,23,296,D'Angelo Russell
2023-2024,Los Angeles Lakers,PG,76,69,2484,492,1080,0.456,226,545,0.415,266,535,0.497,0.56,159,192,0.828,28,208,236,482,69,36,156,156,1369,D'Angelo Russell
2024-2025,Los Angeles Lakers,PG,28,10,735,125,301,0.415,55,164,0.335,70,137,0.511,0.507,45,53,0.849,8,70,78,132,23,4,49,52,350,D'Angelo Russell
2021-2022,Boston Celtics,SF,1,0,5,1,5,0.2,1,5,0.2,0,0,,0.3,0,0,,0,0,0,0,1,0,0,0,3,Matt Ryan
2022-2023,Total,SF,34,0,310,40,108,0.37,32,84,0.381,8,24,0.333,0.519,10,12,0.833,4,22,26,16,5,1,7,27,122,Matt Ryan
2022-2023,Los Angeles Lakers,SF,12,0,129,15,49,0.306,13,35,0.371,2,14,0.143,0.439,4,5,0.8,2,12,14,4,2,0,3,14,47,Matt Ryan
2022-2023,Minnesota Timberwolves,SF,22,0,181,25,59,0.424,19,49,0.388,6,10,0.6,0.585,6,7,0.857,2,10,12,12,3,1,4,13,75,Matt Ryan
2023-2024,New Orleans Pelicans,SF,28,1,390,49,113,0.434,41,91,0.451,8,22,0.364,0.615,13,14,0.929,6,34,40,18,6,1,19,32,152,Matt Ryan
2024-2025,New York Knicks,SF,9,0,45,6,21,0.286,3,14,0.214,3,7,0.429,0.357,0,0,,0,2,2,0,1,0,3,0,15,Matt Ryan
2016-2017,Oklahoma City Thunder,PF,81,66,1632,192,481,0.399,51,159,0.321,141,322,0.438,0.452,44,67,0.657,46,242,288,82,39,32,83,200,479,Domantas Sabonis
2017-2018,Indiana Pacers,C,74,19,1810,340,661,0.514,13,37,0.351,327,624,0.524,0.524,168,224,0.75,165,407,572,151,40,32,137,220,861,Domantas Sabonis
2018-2019,Indiana Pacers,C,74,5,1838,413,700,0.59,9,17,0.529,404,683,0.592,0.596,208,291,0.715,186,504,690,212,48,30,160,239,1043,Domantas Sabonis
2019-2020,Indiana Pacers,PF,62,62,2159,458,848,0.54,17,67,0.254,441,781,0.565,0.55,214,296,0.723,189,582,771,310,47,30,170,195,1147,Domantas Sabonis
2020-2021,Indiana Pacers,PF,62,62,2231,484,904,0.535,52,162,0.321,432,742,0.582,0.564,240,328,0.732,150,592,742,415,76,33,213,203,1260,Domantas Sabonis
2021-2022,Total,PF,62,61,2136,443,773,0.573,39,125,0.312,404,648,0.623,0.598,246,332,0.741,201,551,752,323,59,27,195,203,1171,Domantas Sabonis
2021-2022,Indiana Pacers,PF,47,46,1632,331,571,0.58,35,108,0.324,296,463,0.639,0.61,191,258,0.74,155,412,567,236,46,22,143,146,888,Domantas Sabonis
2021-2022,Sacramento Kings,PF,15,15,504,112,202,0.554,4,17,0.235,108,185,0.584,0.564,55,74,0.743,46,139,185,87,13,5,52,57,283,Domantas Sabonis
2022-2023,Sacramento Kings,C,79,79,2736,577,938,0.615,31,83,0.373,546,855,0.639,0.632,325,438,0.742,251,722,973,573,65,39,230,279,1510,Domantas Sabonis
2023-2024,Sacramento Kings,C,82,82,2928,634,1068,0.594,33,87,0.379,601,981,0.613,0.609,292,415,0.704,294,826,1120,673,74,48,272,250,1593,Domantas Sabonis
2024-2025,Sacramento Kings,C,28,28,1007,231,383,0.603,28,67,0.418,203,316,0.642,0.64,102,129,0.791,99,280,379,169,23,12,81,96,592,Domantas Sabonis
2024-2025,Charlotte Hornets,PF,26,8,490,42,130,0.323,26,86,0.302,16,44,0.364,0.423,15,22,0.682,28,80,108,29,15,5,21,34,125,Tidjane Salaün
2019-2020,San Antonio Spurs,PF,3,1,48,5,16,0.313,3,8,0.375,2,8,0.25,0.406,3,4,0.75,1,9,10,6,0,2,2,6,16,Luka Šamanić
2020-2021,San Antonio Spurs,PF,33,4,308,47,105,0.448,12,43,0.279,35,62,0.565,0.505,16,29,0.552,16,52,68,15,8,8,20,43,122,Luka Šamanić
2022-2023,Utah Jazz,PF,7,4,161,26,57,0.456,8,31,0.258,18,26,0.692,0.526,9,13,0.692,0,30,30,15,6,2,10,17,69,Luka Šamanić
2023-2024,Utah Jazz,PF,43,7,404,60,158,0.38,13,64,0.203,47,94,0.5,0.421,44,56,0.786,22,80,102,19,5,7,28,32,177,Luka Šamanić
2018-2019,Chicago Bulls,SG,14,2,214,28,60,0.467,11,29,0.379,17,31,0.548,0.558,4,6,0.667,3,13,16,10,8,3,12,19,71,Brandon Sampson
2023-2024,Houston Rockets,SF,14,0,60,9,14,0.643,0,2,0,9,12,0.75,0.643,2,2,1,3,10,13,3,1,2,0,5,20,Jermaine Samuels
2023-2024,Chicago Bulls,PF,9,0,66,14,27,0.519,0,0,14,27,0.519,0.519,8,12,0.667,19,17,36,0,1,0,5,5,36,0,Adama Sanogo
2024-2025,Chicago Bulls,C,4,0,21,4,7,0.571,0,0,4,7,0.571,0.571,0,0,,5,1,6,1,0,0,1,1,8,0,Adama Sanogo
2023-2024,Golden State Warriors,PF,23,0,192,28,55,0.509,10,27,0.37,18,28,0.643,0.6,16,17,0.941,17,32,49,14,4,2,7,23,82,Gui Santos
2024-2025,Golden State Warriors,PF,8,0,35,2,6,0.333,1,4,0.25,1,2,0.5,0.417,1,2,0.5,2,6,8,3,0,1,3,6,6,Gui Santos
2016-2017,Philadelphia 76ers,PF,81,36,2129,381,927,0.411,106,341,0.311,275,586,0.469,0.468,172,220,0.782,112,401,513,182,57,30,183,162,1040,Dario Šarić
2017-2018,Philadelphia 76ers,PF,78,73,2310,403,890,0.453,157,399,0.393,246,491,0.501,0.541,178,207,0.86,154,366,520,202,51,20,148,160,1141,Dario Šarić
2018-2019,Total,PF,81,41,2023,304,696,0.437,118,323,0.365,186,373,0.499,0.522,132,150,0.88,126,331,457,127,45,9,97,182,858,Dario Šarić
2018-2019,Philadelphia 76ers,PF,13,13,396,48,132,0.364,21,70,0.3,27,62,0.435,0.443,27,30,0.9,21,65,86,26,4,3,25,39,144,Dario Šarić
2018-2019,Minnesota Timberwolves,PF,68,28,1627,256,564,0.454,97,253,0.383,159,311,0.511,0.54,105,120,0.875,105,266,371,101,41,6,72,143,714,Dario Šarić
2019-2020,Phoenix Suns,PF,66,51,1632,256,538,0.476,84,235,0.357,172,303,0.568,0.554,108,128,0.844,100,306,406,123,37,16,88,156,704,Dario Šarić
2020-2021,Phoenix Suns,C,50,4,871,153,342,0.447,47,135,0.348,106,207,0.512,0.516,84,99,0.848,46,144,190,65,30,4,57,95,437,Dario Šarić
2022-2023,Total,C,57,12,806,127,277,0.458,45,115,0.391,82,162,0.506,0.54,63,76,0.829,53,154,207,74,20,7,55,99,362,Dario Šarić
2022-2023,Phoenix Suns,PF,37,12,533,76,178,0.427,27,69,0.391,49,109,0.45,0.503,36,44,0.818,39,103,142,57,13,5,36,69,215,Dario Šarić
2022-2023,Oklahoma City Thunder,C,20,0,273,51,99,0.515,18,46,0.391,33,53,0.623,0.606,27,32,0.844,14,51,65,17,7,2,19,30,147,Dario Šarić
2023-2024,Golden State Warriors,C,64,9,1098,181,388,0.466,74,197,0.376,107,191,0.56,0.562,79,93,0.849,73,210,283,144,31,10,78,112,515,Dario Šarić
2024-2025,Denver Nuggets,C,10,3,136,12,40,0.3,5,19,0.263,7,21,0.333,0.363,5,6,0.833,9,26,35,11,6,0,11,14,34,Dario Šarić
2024-2025,Washington Wizards,C,25,25,680,108,268,0.403,35,116,0.302,73,152,0.48,0.468,33,54,0.611,49,107,156,52,19,46,37,67,284,Alex Sarr
2021-2022,Oklahoma City Thunder,C,22,2,421,58,101,0.574,13,29,0.448,45,72,0.625,0.639,24,29,0.828,34,59,93,19,6,15,22,52,153,Olivier Sarr
2022-2023,Oklahoma City Thunder,C,9,1,114,15,30,0.5,1,8,0.125,14,22,0.636,0.517,5,7,0.714,12,19,31,4,1,5,4,17,36,Olivier Sarr
2023-2024,Oklahoma City Thunder,C,15,0,98,11,19,0.579,2,6,0.333,9,13,0.692,0.632,10,15,0.667,10,26,36,2,0,7,3,18,34,Olivier Sarr
2023-2024,Detroit Pistons,PG,71,11,1351,219,512,0.428,90,240,0.375,129,272,0.474,0.516,58,66,0.879,11,114,125,236,44,12,90,103,586,Marcus Sasser
2024-2025,Detroit Pistons,PG,20,0,267,50,94,0.532,18,44,0.409,32,50,0.64,0.628,6,6,1,7,12,19,36,17,3,15,22,124,Marcus Sasser
2021-2022,Washington Wizards,SG,4,0,30,1,11,0.091,1,6,0.167,0,5,0,0.136,2,2,1,2,6,8,0,1,0,1,0,5,Jordan Schakel
2022-2023,Washington Wizards,SF,2,0,6,1,2,0.5,1,1,1,0,1,0,0.75,0,0,,0,0,0,1,1,0,0,1,3,Jordan Schakel
2024-2025,Boston Celtics,SG,5,0,34,1,10,0.1,0,6,0,1,4,0.25,0.1,2,2,1,2,5,7,2,1,0,0,3,4,Baylor Scheierman
2019-2020,Washington Wizards,PF,33,2,368,35,92,0.38,19,61,0.311,16,31,0.516,0.484,10,15,0.667,7,40,47,15,8,4,7,50,99,Admiral Schofield
2021-2022,Orlando Magic,SF,38,1,469,54,129,0.419,26,79,0.329,28,50,0.56,0.519,12,15,0.8,17,72,89,25,4,5,21,58,146,Admiral Schofield
2022-2023,Orlando Magic,PF,37,0,451,55,122,0.451,24,74,0.324,31,48,0.646,0.549,21,23,0.913,23,39,62,31,8,5,16,61,155,Admiral Schofield
2023-2024,Orlando Magic,PF,23,0,84,10,26,0.385,6,16,0.375,4,10,0.4,0.5,0,2,0,3,14,17,7,1,0,5,9,26,Admiral Schofield
2013-2014,Atlanta Hawks,PG,49,0,641,72,188,0.383,10,42,0.238,62,146,0.425,0.41,29,43,0.674,5,55,60,93,17,0,61,54,183,Dennis Schröder
2014-2015,Atlanta Hawks,PG,77,10,1516,284,665,0.427,52,148,0.351,232,517,0.449,0.466,148,179,0.827,29,135,164,317,49,4,150,127,768,Dennis Schröder
2015-2016,Atlanta Hawks,PG,80,6,1621,329,781,0.421,77,239,0.322,252,542,0.465,0.471,144,182,0.791,25,179,204,349,70,9,183,138,879,Dennis Schröder
2016-2017,Atlanta Hawks,PG,79,78,2485,548,1214,0.451,100,294,0.34,448,920,0.487,0.493,218,255,0.855,42,206,248,499,74,16,258,149,1414,Dennis Schröder
2017-2018,Atlanta Hawks,PG,67,67,2078,500,1146,0.436,76,262,0.29,424,884,0.48,0.469,225,265,0.849,44,164,208,417,72,6,183,147,1301,Dennis Schröder
2018-2019,Oklahoma City Thunder,PG,79,14,2314,457,1104,0.414,124,364,0.341,333,740,0.45,0.47,186,227,0.819,38,246,284,323,65,12,172,189,1224,Dennis Schröder
2019-2020,Oklahoma City Thunder,PG,65,2,1999,453,965,0.469,125,325,0.385,328,640,0.513,0.534,198,236,0.839,19,217,236,262,45,14,166,146,1229,Dennis Schröder
2020-2021,Los Angeles Lakers,SG,61,61,1956,332,760,0.437,71,212,0.335,261,548,0.476,0.484,206,243,0.848,30,181,211,351,70,13,163,159,941,Dennis Schröder
2021-2022,Total,PG,64,29,1837,312,724,0.431,86,250,0.344,226,474,0.477,0.49,157,184,0.853,34,180,214,296,53,8,143,154,867,Dennis Schröder
2021-2022,Boston Celtics,PG,49,25,1433,257,584,0.44,67,192,0.349,190,392,0.485,0.497,123,145,0.848,28,136,164,208,41,5,104,116,704,Dennis Schröder
2021-2022,Houston Rockets,PG,15,4,404,55,140,0.393,19,58,0.328,36,82,0.439,0.461,34,39,0.872,6,44,50,88,12,3,39,38,163,Dennis Schröder
2022-2023,Los Angeles Lakers,PG,66,50,1986,270,650,0.415,74,225,0.329,196,425,0.461,0.472,216,252,0.857,21,144,165,298,50,10,112,145,830,Dennis Schröder
2023-2024,Total,PG,80,58,2486,403,927,0.435,138,368,0.375,265,559,0.474,0.509,178,213,0.836,39,203,242,488,63,17,153,164,1122,Dennis Schröder
2023-2024,Toronto Raptors,PG,51,33,1559,247,559,0.442,77,220,0.35,170,339,0.501,0.511,127,149,0.852,22,118,140,313,46,8,83,105,698,Dennis Schröder
2023-2024,Brooklyn Nets,PG,29,25,927,156,368,0.424,61,148,0.412,95,220,0.432,0.507,51,64,0.797,17,85,102,175,17,9,70,59,424,Dennis Schröder
2024-2025,Total,PG,28,28,904,161,375,0.429,62,173,0.358,99,202,0.49,0.512,81,93,0.871,4,71,75,173,29,5,70,71,465,Dennis Schröder
2024-2025,Brooklyn Nets,PG,23,23,772,147,325,0.452,58,150,0.387,89,175,0.509,0.542,72,81,0.889,4,64,68,152,26,4,59,56,424,Dennis Schröder
2024-2025,Golden State Warriors,PG,5,5,132,14,50,0.28,4,23,0.174,10,27,0.37,0.32,9,12,0.75,0,7,7,21,3,1,11,15,41,Dennis Schröder
2020-2021,Los Angeles Clippers,SG,4,1,84,14,36,0.389,2,9,0.222,12,27,0.444,0.417,5,5,1,2,12,14,1,4,0,7,5,35,Jay Scrubb
2021-2022,Los Angeles Clippers,SG,18,0,121,18,46,0.391,6,21,0.286,12,25,0.48,0.457,7,10,0.7,2,14,16,8,4,3,7,9,49,Jay Scrubb
2022-2023,Orlando Magic,SG,2,0,30,5,7,0.714,2,2,1,3,5,0.6,0.857,1,2,0.5,0,6,6,1,2,0,3,2,13,Jay Scrubb
2022-2023,New Orleans Pelicans,SG,5,0,12,2,5,0.4,0,0,,2,5,0.4,0.4,0,0,,1,0,1,0,0,0,0,1,4,Dereon Seabron
2023-2024,New Orleans Pelicans,SG,6,0,55,4,13,0.308,1,2,0.5,3,11,0.273,0.346,5,6,0.833,1,6,7,5,2,1,0,4,14,Dereon Seabron
2021-2022,Houston Rockets,C,72,13,1489,249,525,0.474,29,117,0.248,220,408,0.539,0.502,165,232,0.711,138,255,393,185,59,68,145,214,692,Alperen Sengun
2022-2023,Houston Rockets,C,75,72,2171,442,799,0.553,19,57,0.333,423,742,0.57,0.565,206,288,0.715,242,436,678,291,70,70,193,258,1109,Alperen Sengun
2023-2024,Houston Rockets,C,63,63,2046,527,982,0.537,33,111,0.297,494,871,0.567,0.553,244,352,0.693,183,406,589,312,76,46,162,211,1331,Alperen Sengun
2024-2025,Houston Rockets,C,31,31,968,231,473,0.488,11,47,0.234,220,426,0.516,0.5,115,152,0.757,108,220,328,158,36,30,71,84,588,Alperen Sengun
2023-2024,Utah Jazz,SF,32,11,584,85,218,0.39,34,115,0.296,51,103,0.495,0.468,37,41,0.902,16,86,102,55,13,6,47,43,241,Brice Sensabaugh
2024-2025,Utah Jazz,SF,23,0,379,62,141,0.44,34,88,0.386,28,53,0.528,0.56,16,18,0.889,15,41,56,30,15,2,33,25,174,Brice Sensabaugh
2018-2019,Cleveland Cavaliers,PG,82,72,2605,519,1206,0.43,119,296,0.402,400,910,0.44,0.48,214,255,0.839,57,179,236,243,44,6,185,186,1371,Collin Sexton
2019-2020,Cleveland Cavaliers,PG,65,65,2143,513,1086,0.472,97,255,0.38,416,831,0.501,0.517,226,267,0.846,61,143,204,192,65,7,158,142,1349,Collin Sexton
2020-2021,Cleveland Cavaliers,SG,60,60,2115,525,1105,0.475,98,264,0.371,427,841,0.508,0.519,312,383,0.815,58,129,187,262,62,10,167,157,1460,Collin Sexton
2021-2022,Cleveland Cavaliers,SG,11,11,316,68,151,0.45,11,45,0.244,57,106,0.538,0.487,29,39,0.744,13,23,36,23,10,0,31,25,176,Collin Sexton
2022-2023,Utah Jazz,PG,48,15,1145,237,468,0.506,48,122,0.393,189,346,0.546,0.558,163,199,0.819,37,68,105,138,27,6,85,112,685,Collin Sexton
2023-2024,Utah Jazz,SG,78,51,2075,506,1038,0.487,128,325,0.394,378,713,0.53,0.549,318,370,0.859,71,134,205,383,62,18,165,154,1458,Collin Sexton
2024-2025,Utah Jazz,SG,29,27,820,176,366,0.481,56,129,0.434,120,237,0.506,0.557,90,101,0.891,23,50,73,106,23,3,76,68,498,Collin Sexton
2018-2019,Total,SG,79,27,1802,240,557,0.431,167,396,0.422,73,161,0.453,0.581,75,93,0.806,21,113,134,117,37,10,45,155,722,Landry Shamet
2018-2019,Philadelphia 76ers,SG,54,4,1108,153,347,0.441,99,245,0.404,54,102,0.529,0.584,44,54,0.815,14,64,78,59,24,8,26,106,449,Landry Shamet
2018-2019,Los Angeles Clippers,SG,25,23,694,87,210,0.414,68,151,0.45,19,59,0.322,0.576,31,39,0.795,7,49,56,58,13,2,19,49,273,Landry Shamet
2019-2020,Los Angeles Clippers,SG,53,30,1452,158,391,0.404,111,296,0.375,47,95,0.495,0.546,65,76,0.855,6,94,100,99,20,10,42,142,492,Landry Shamet
2020-2021,Brooklyn Nets,SG,61,12,1403,186,456,0.408,129,333,0.387,57,123,0.463,0.549,66,78,0.846,11,101,112,99,31,10,48,93,567,Landry Shamet
2021-2022,Phoenix Suns,SG,69,14,1437,191,485,0.394,123,334,0.368,68,151,0.45,0.521,68,81,0.84,16,110,126,108,28,9,41,92,573,Landry Shamet
2022-2023,Phoenix Suns,SG,40,9,807,113,300,0.377,75,199,0.377,38,101,0.376,0.502,45,51,0.882,11,56,67,93,26,5,36,61,346,Landry Shamet
2023-2024,Washington Wizards,SG,46,5,726,118,274,0.431,53,157,0.338,65,117,0.556,0.527,38,46,0.826,16,46,62,54,25,10,30,76,327,Landry Shamet
2024-2025,New York Knicks,SG,2,0,12,4,5,0.8,1,1,1,3,4,0.75,0.9,0,0,,0,1,1,0,2,0,0,0,9,Landry Shamet
2024-2025,Minnesota Timberwolves,SG,10,0,45,7,13,0.538,1,3,0.333,6,10,0.6,0.577,0,0,0,2,2,5,2,1,3,1,15,0,Terrence Shannon Jr.
2021-2022,Brooklyn Nets,PF,32,8,391,86,149,0.577,2,7,0.286,84,142,0.592,0.584,24,41,0.585,81,79,160,17,10,15,30,60,198,Day'Ron Sharpe
2022-2023,Brooklyn Nets,C,48,3,552,93,171,0.544,6,11,0.545,87,160,0.544,0.561,35,55,0.636,99,101,200,37,15,32,42,89,227,Day'Ron Sharpe
2023-2024,Brooklyn Nets,C,61,1,921,168,294,0.571,4,15,0.267,164,279,0.588,0.578,75,123,0.61,161,228,389,85,24,44,70,131,415,Day'Ron Sharpe
2024-2025,Brooklyn Nets,C,10,0,150,23,57,0.404,2,11,0.182,21,46,0.457,0.421,15,17,0.882,25,28,53,8,9,4,11,17,63,Day'Ron Sharpe
2022-2023,Portland Trail Blazers,SG,80,15,1779,306,648,0.472,102,283,0.36,204,365,0.559,0.551,75,105,0.714,63,173,236,94,38,24,83,136,789,Shaedon Sharpe
2023-2024,Portland Trail Blazers,SG,32,25,1059,176,434,0.406,60,180,0.333,116,254,0.457,0.475,98,119,0.824,42,118,160,94,28,12,72,88,510,Shaedon Sharpe
2024-2025,Portland Trail Blazers,SG,22,20,668,146,320,0.456,41,139,0.295,105,181,0.58,0.52,60,75,0.8,15,63,78,55,18,6,36,36,393,Shaedon Sharpe
2019-2020,Philadelphia 76ers,SG,4,0,28,3,12,0.25,2,6,0.333,1,6,0.167,0.333,3,4,0.75,1,6,7,1,0,1,3,4,11,Marial Shayok
2024-2025,Toronto Raptors,PG,27,0,409,54,131,0.412,18,55,0.327,36,76,0.474,0.481,9,12,0.75,5,27,32,86,15,3,37,51,135,Jamal Shead
2023-2024,Indiana Pacers,SG,57,1,814,90,229,0.393,49,156,0.314,41,73,0.562,0.5,23,26,0.885,15,74,89,53,33,2,15,88,252,Ben Sheppard
2024-2025,Indiana Pacers,SG,18,6,358,37,87,0.425,24,62,0.387,13,25,0.52,0.563,0,0,,8,31,39,20,7,5,7,43,98,Ben Sheppard
2024-2025,Houston Rockets,PG,29,0,344,38,118,0.322,19,68,0.279,19,50,0.38,0.403,5,6,0.833,10,28,38,35,15,10,17,28,100,Reed Sheppard
2016-2017,Toronto Raptors,PF,55,38,859,103,205,0.502,1,7,0.143,102,198,0.515,0.505,22,32,0.688,64,121,185,17,26,45,33,109,229,Pascal Siakam
2017-2018,Toronto Raptors,PF,81,5,1679,253,498,0.508,29,132,0.22,224,366,0.612,0.537,54,87,0.621,79,285,364,159,62,42,67,166,589,Pascal Siakam
2018-2019,Toronto Raptors,PF,80,79,2548,519,945,0.549,79,214,0.369,440,731,0.602,0.591,237,302,0.785,124,425,549,248,73,52,154,241,1354,Pascal Siakam
2019-2020,Toronto Raptors,PF,60,60,2110,500,1104,0.453,131,365,0.359,369,739,0.499,0.512,240,303,0.792,64,375,439,207,61,53,148,170,1371,Pascal Siakam
2020-2021,Toronto Raptors,PF,56,56,2006,437,961,0.455,73,246,0.297,364,715,0.509,0.493,249,301,0.827,95,310,405,250,64,37,130,174,1196,Pascal Siakam
2021-2022,Toronto Raptors,PF,68,68,2578,596,1207,0.494,75,218,0.344,521,989,0.527,0.525,284,379,0.749,128,452,580,360,85,42,181,225,1551,Pascal Siakam
2022-2023,Toronto Raptors,PF,71,71,2652,630,1313,0.48,93,287,0.324,537,1026,0.523,0.515,367,474,0.774,131,425,556,415,65,36,169,228,1720,Pascal Siakam
2023-2024,Total,PF,80,80,2657,681,1271,0.536,85,246,0.346,596,1025,0.581,0.569,290,396,0.732,139,426,565,342,63,25,141,193,1737,Pascal Siakam
2023-2024,Toronto Raptors,PF,39,39,1354,325,623,0.522,46,145,0.317,279,478,0.584,0.559,169,223,0.758,54,192,246,190,32,10,83,87,865,Pascal Siakam
2023-2024,Indiana Pacers,PF,41,41,1303,356,648,0.549,39,101,0.386,317,547,0.58,0.579,121,173,0.699,85,234,319,152,31,15,58,106,872,Pascal Siakam
2024-2025,Indiana Pacers,PF,32,32,1084,243,466,0.521,63,144,0.438,180,322,0.559,0.589,89,115,0.774,54,175,229,105,29,9,44,94,638,Pascal Siakam
2019-2020,Miami Heat,PF,44,0,346,48,78,0.615,0,3,0,48,75,0.64,0.615,37,55,0.673,60,66,126,23,9,21,32,85,133,Chris Silva
2020-2021,Total,PF,15,0,92,10,16,0.625,1,1,1,9,15,0.6,0.656,11,15,0.733,7,20,27,6,1,6,10,24,32,Chris Silva
2020-2021,Miami Heat,PF,11,0,83,9,13,0.692,1,1,1,8,12,0.667,0.731,11,15,0.733,7,18,25,6,1,5,9,20,30,Chris Silva
2020-2021,Sacramento Kings,PF,4,0,9,1,3,0.333,0,0,,1,3,0.333,0.333,0,0,,0,2,2,0,0,1,1,4,2,Chris Silva
2021-2022,Total,PF,10,0,91,8,15,0.533,0,0,,8,15,0.533,0.533,10,12,0.833,13,23,36,7,0,1,8,20,26,Chris Silva
2021-2022,Minnesota Timberwolves,PF,1,0,3,0,0,,0,0,,0,0,,,0,0,,0,1,1,0,0,0,0,0,0,Chris Silva
2021-2022,Miami Heat,PF,9,0,88,8,15,0.533,0,0,,8,15,0.533,0.533,10,12,0.833,13,22,35,7,0,1,8,20,26,Chris Silva
2022-2023,Dallas Mavericks,PF,1,0,3,1,1,1,0,0,,1,1,1,1,0,0,,0,0,0,0,0,0,1,2,2,Chris Silva
2017-2018,Philadelphia 76ers,PG,81,81,2732,544,998,0.545,0,11,0,544,987,0.551,0.545,191,341,0.56,145,514,659,661,140,70,278,211,1279,Ben Simmons
2018-2019,Philadelphia 76ers,PG,79,79,2700,540,960,0.563,0,6,0,540,954,0.566,0.563,257,428,0.6,172,525,697,610,112,61,274,209,1337,Ben Simmons
2019-2020,Philadelphia 76ers,PG,57,57,2017,375,647,0.58,2,7,0.286,373,640,0.583,0.581,185,298,0.621,113,331,444,455,119,33,200,186,937,Ben Simmons
2020-2021,Philadelphia 76ers,PG,58,58,1877,325,583,0.557,3,10,0.3,322,573,0.562,0.56,176,287,0.613,93,324,417,401,93,35,173,171,829,Ben Simmons
2022-2023,Brooklyn Nets,PG,42,33,1105,133,235,0.566,0,2,0,133,233,0.571,0.566,25,57,0.439,40,223,263,256,54,24,97,139,291,Ben Simmons
2023-2024,Brooklyn Nets,PG,15,12,359,43,74,0.581,0,0,,43,74,0.581,0.581,6,15,0.4,31,88,119,86,12,9,27,36,92,Ben Simmons
2024-2025,Brooklyn Nets,PG,24,18,598,65,115,0.565,0,0,,65,115,0.565,0.565,15,21,0.714,22,105,127,166,21,12,70,55,145,Ben Simmons
2017-2018,Memphis Grizzlies,PG,32,12,643,80,189,0.423,11,39,0.282,69,150,0.46,0.452,25,25,1,14,36,50,68,18,5,44,61,196,Kobi Simmons
2018-2019,Cleveland Cavaliers,PG,1,0,2,0,0,,0,0,,0,0,,,0,0,,0,0,0,0,0,0,0,0,0,Kobi Simmons
2022-2023,Charlotte Hornets,SG,5,0,28,1,6,0.167,1,5,0.2,0,1,0,0.25,2,2,1,1,3,4,5,0,2,1,0,5,Kobi Simmons
2023-2024,Toronto Raptors,PG,4,0,67,9,21,0.429,2,8,0.25,7,13,0.538,0.476,0,0,,1,6,7,12,6,2,1,5,20,Kobi Simmons
2021-2022,Chicago Bulls,C,9,0,35,4,15,0.267,1,5,0.2,3,10,0.3,0.3,8,11,0.727,5,5,10,0,1,1,2,6,17,Marko Simonovic
2022-2023,Chicago Bulls,C,7,0,20,2,7,0.286,1,4,0.25,1,3,0.333,0.357,1,2,0.5,1,1,2,0,0,0,0,5,6,Marko Simonovic
2018-2019,Portland Trail Blazers,SG,20,1,141,28,63,0.444,10,29,0.345,18,34,0.529,0.524,9,16,0.563,3,10,13,13,1,0,11,9,75,Anfernee Simons
2019-2020,Portland Trail Blazers,SG,70,4,1449,214,536,0.399,75,226,0.332,139,310,0.448,0.469,76,92,0.826,25,127,152,97,26,10,61,135,579,Anfernee Simons
2020-2021,Portland Trail Blazers,SG,64,0,1104,168,401,0.419,120,282,0.426,48,119,0.403,0.569,46,57,0.807,14,126,140,89,18,8,43,96,502,Anfernee Simons
2021-2022,Portland Trail Blazers,SG,57,30,1681,353,797,0.443,179,442,0.405,174,355,0.49,0.555,103,116,0.888,26,125,151,221,30,6,115,110,988,Anfernee Simons
2022-2023,Portland Trail Blazers,SG,62,62,2171,467,1045,0.447,212,562,0.377,255,483,0.528,0.548,160,179,0.894,18,143,161,253,42,14,128,142,1306,Anfernee Simons
2023-2024,Portland Trail Blazers,SG,46,46,1582,360,837,0.43,156,405,0.385,204,432,0.472,0.523,163,178,0.916,22,145,167,255,23,5,126,98,1039,Anfernee Simons
2024-2025,Portland Trail Blazers,SG,27,27,836,163,400,0.408,66,206,0.32,97,194,0.5,0.49,68,75,0.907,9,60,69,129,28,2,64,52,460,Anfernee Simons
2024-2025,Charlotte Hornets,PG,9,0,120,12,40,0.3,3,20,0.15,9,20,0.45,0.338,8,10,0.8,9,6,15,18,5,2,9,13,35,KJ Simpson
2021-2022,Oklahoma City Thunder,PG,4,4,174,19,52,0.365,1,8,0.125,18,44,0.409,0.375,5,5,1,2,19,21,30,5,4,10,15,44,Zavier Simpson
2023-2024,Memphis Grizzlies,PG,7,0,161,17,54,0.315,5,17,0.294,12,37,0.324,0.361,3,4,0.75,4,16,20,25,7,3,10,11,42,Zavier Simpson
2021-2022,New York Knicks,PF,41,5,555,39,54,0.722,0,0,,39,54,0.722,0.722,12,29,0.414,61,108,169,21,11,22,20,66,90,Jericho Sims
2022-2023,New York Knicks,C,52,16,812,83,107,0.776,0,1,0,83,106,0.783,0.776,12,16,0.75,99,143,242,25,15,28,27,96,178,Jericho Sims
2023-2024,New York Knicks,C,45,11,585,38,55,0.691,0,0,,38,55,0.691,0.691,16,24,0.667,56,91,147,25,8,19,16,45,92,Jericho Sims
2024-2025,New York Knicks,C,28,2,335,22,34,0.647,0,0,,22,34,0.647,0.647,6,9,0.667,38,64,102,17,7,9,15,39,50,Jericho Sims
2020-2021,Detroit Pistons,SG,20,0,133,14,40,0.35,10,28,0.357,4,12,0.333,0.475,3,6,0.5,0,29,29,5,2,0,5,9,41,Deividas Sirvydis
2021-2022,Detroit Pistons,SG,3,0,27,1,10,0.1,1,7,0.143,0,3,0,0.15,0,0,,0,6,6,1,3,1,0,4,3,Deividas Sirvydis
2023-2024,New York Knicks,C,2,0,2,0,1,0,0,0,0,1,0,0,0,0,0,0,0,0,0,0,0,0,0,0,,Dmytro Skapintsev
2023-2024,Sacramento Kings,SF,12,0,37,4,6,0.667,0,2,0,4,4,1,0.667,0,0,1,6,7,2,1,1,2,8,8,0,Jalen Slawson
2019-2020,Golden State Warriors,C,14,0,139,20,40,0.5,3,13,0.231,17,27,0.63,0.538,16,19,0.842,10,17,27,13,3,4,11,14,59,Alen Smailagić
2020-2021,Golden State Warriors,PF,15,1,84,11,27,0.407,4,10,0.4,7,17,0.412,0.481,2,6,0.333,6,10,16,4,3,5,5,11,28,Alen Smailagić
2021-2022,Total,PG,17,1,200,19,60,0.317,8,27,0.296,11,33,0.333,0.383,5,6,0.833,5,19,24,16,6,3,11,12,51,Javonte Smart
2021-2022,Milwaukee Bucks,PG,13,1,160,11,43,0.256,4,18,0.222,7,25,0.28,0.302,5,6,0.833,4,15,19,14,4,2,9,11,31,Javonte Smart
2021-2022,Miami Heat,PG,4,0,40,8,17,0.471,4,9,0.444,4,8,0.5,0.588,0,0,,1,4,5,2,2,1,2,1,20,Javonte Smart
2023-2024,Philadelphia 76ers,PG,1,0,1,0,0,,0,0,,0,0,,,0,0,,0,0,0,0,0,0,0,0,0,Javonte Smart
2014-2015,Boston Celtics,PG,67,38,1808,175,477,0.367,91,272,0.335,84,205,0.41,0.462,82,127,0.646,61,161,222,208,99,18,90,176,523,Marcus Smart
2015-2016,Boston Celtics,PG,61,10,1667,184,529,0.348,61,241,0.253,123,288,0.427,0.405,129,166,0.777,76,179,255,185,91,18,80,183,558,Marcus Smart
2016-2017,Boston Celtics,SG,79,24,2399,269,749,0.359,94,332,0.283,175,417,0.42,0.422,203,250,0.812,78,227,305,364,125,34,159,192,835,Marcus Smart
2017-2018,Boston Celtics,SG,54,11,1614,189,515,0.367,75,249,0.301,114,266,0.429,0.44,97,133,0.729,43,146,189,259,71,23,129,133,550,Marcus Smart
2018-2019,Boston Celtics,SG,80,60,2200,239,567,0.422,126,346,0.364,113,221,0.511,0.533,104,129,0.806,57,177,234,321,143,28,123,201,708,Marcus Smart
2019-2020,Boston Celtics,SG,60,40,1919,256,682,0.375,137,395,0.347,119,287,0.415,0.476,127,152,0.836,42,183,225,291,101,29,103,162,776,Marcus Smart
2020-2021,Boston Celtics,PG,48,45,1581,203,510,0.398,93,282,0.33,110,228,0.482,0.489,128,162,0.79,36,131,167,273,72,23,96,126,627,Marcus Smart
2021-2022,Boston Celtics,PG,71,71,2296,300,718,0.418,119,360,0.331,181,358,0.506,0.501,142,179,0.793,42,228,270,417,119,18,159,160,861,Marcus Smart
2022-2023,Boston Celtics,PG,61,61,1957,250,602,0.415,115,342,0.336,135,260,0.519,0.511,88,118,0.746,46,145,191,382,93,23,143,172,703,Marcus Smart
2023-2024,Memphis Grizzlies,PG,20,20,605,102,237,0.43,42,134,0.313,60,103,0.583,0.519,43,56,0.768,6,47,53,86,41,5,62,53,289,Marcus Smart
2024-2025,Memphis Grizzlies,PG,18,6,382,53,142,0.373,29,87,0.333,24,55,0.436,0.475,30,36,0.833,14,28,42,69,23,6,34,30,165,Marcus Smart
2017-2018,Dallas Mavericks,PG,69,69,2049,404,1024,0.395,106,339,0.313,298,685,0.435,0.446,134,193,0.694,50,210,260,358,71,18,194,152,1048,Dennis Smith Jr.
2018-2019,Total,PG,53,50,1508,278,650,0.428,67,208,0.322,211,442,0.477,0.479,99,156,0.635,32,123,155,252,67,20,154,129,722,Dennis Smith Jr.
2018-2019,Dallas Mavericks,PG,32,32,908,157,357,0.44,43,125,0.344,114,232,0.491,0.5,57,82,0.695,18,79,97,138,40,11,100,82,414,Dennis Smith Jr.
2018-2019,New York Knicks,PG,21,18,600,121,293,0.413,24,83,0.289,97,210,0.462,0.454,42,74,0.568,14,44,58,114,27,9,54,47,308,Dennis Smith Jr.
2019-2020,New York Knicks,PG,34,3,537,72,211,0.341,16,54,0.296,56,157,0.357,0.379,27,53,0.509,21,57,78,98,28,8,58,65,187,Dennis Smith Jr.
2020-2021,Total,PG,23,9,420,58,145,0.4,19,58,0.328,39,87,0.448,0.466,19,26,0.731,12,43,55,77,23,14,26,37,154,Dennis Smith Jr.
2020-2021,New York Knicks,PG,3,0,28,2,10,0.2,0,4,0,2,6,0.333,0.2,5,6,0.833,0,2,2,3,3,0,1,4,9,Dennis Smith Jr.
2020-2021,Detroit Pistons,PG,20,9,392,56,135,0.415,19,54,0.352,37,81,0.457,0.485,14,20,0.7,12,41,53,74,20,14,25,33,145,Dennis Smith Jr.
2021-2022,Portland Trail Blazers,PG,37,4,638,79,189,0.418,6,27,0.222,73,162,0.451,0.434,42,64,0.656,20,68,88,132,45,12,51,52,206,Dennis Smith Jr.
2022-2023,Charlotte Hornets,PG,54,15,1390,186,452,0.412,24,111,0.216,162,341,0.475,0.438,78,106,0.736,27,140,167,261,75,25,82,122,474,Dennis Smith Jr.
2023-2024,Brooklyn Nets,PG,56,2,1059,147,338,0.435,32,109,0.294,115,229,0.502,0.482,43,58,0.741,50,114,164,203,68,12,68,121,369,Dennis Smith Jr.
2022-2023,Total,SG,15,1,158,18,45,0.4,5,19,0.263,13,26,0.5,0.456,3,3,1,2,22,24,22,10,4,3,23,44,Dru Smith
2022-2023,Miami Heat,SG,5,1,67,5,14,0.357,1,6,0.167,4,8,0.5,0.393,0,0,,1,8,9,5,4,3,1,10,11,Dru Smith
2022-2023,Brooklyn Nets,SG,10,0,91,13,31,0.419,4,13,0.308,9,18,0.5,0.484,3,3,1,1,14,15,17,6,1,2,13,33,Dru Smith
2023-2024,Miami Heat,SG,9,0,131,15,33,0.455,7,17,0.412,8,16,0.5,0.561,2,2,1,6,8,14,14,9,3,5,12,39,Dru Smith
2024-2025,Miami Heat,SG,14,1,268,31,61,0.508,16,30,0.533,15,31,0.484,0.639,10,13,0.769,12,24,36,23,21,6,17,30,88,Dru Smith
2010-2011,Total,PG,43,3,442,43,115,0.374,3,10,0.3,40,105,0.381,0.387,12,21,0.571,7,40,47,79,18,2,34,37,101,Ish Smith
2010-2011,Houston Rockets,PG,28,3,329,32,83,0.386,3,8,0.375,29,75,0.387,0.404,7,10,0.7,6,36,42,64,13,2,26,26,74,Ish Smith
2010-2011,Memphis Grizzlies,PG,15,0,113,11,32,0.344,0,2,0,11,30,0.367,0.344,5,11,0.455,1,4,5,15,5,0,8,11,27,Ish Smith
2011-2012,Total,PG,26,1,234,31,81,0.383,3,9,0.333,28,72,0.389,0.401,7,10,0.7,7,28,35,41,15,2,13,15,72,Ish Smith
2011-2012,Golden State Warriors,PG,6,1,63,12,30,0.4,2,5,0.4,10,25,0.4,0.433,1,2,0.5,2,7,9,9,4,0,1,4,27,Ish Smith
2011-2012,Orlando Magic,PG,20,0,171,19,51,0.373,1,4,0.25,18,47,0.383,0.382,6,8,0.75,5,21,26,32,11,2,12,11,45,Ish Smith
2012-2013,Total,PG,52,3,516,56,159,0.352,8,27,0.296,48,132,0.364,0.377,3,7,0.429,12,49,61,87,21,9,37,26,123,Ish Smith
2012-2013,Orlando Magic,PG,36,3,378,39,116,0.336,4,17,0.235,35,99,0.354,0.353,3,7,0.429,11,35,46,57,13,6,27,14,85,Ish Smith
2012-2013,Milwaukee Bucks,PG,16,0,138,17,43,0.395,4,10,0.4,13,33,0.394,0.442,0,0,,1,14,15,30,8,3,10,12,38,Ish Smith
2013-2014,Phoenix Suns,PG,70,1,1006,119,281,0.423,1,23,0.043,118,258,0.457,0.425,22,39,0.564,31,98,129,179,49,13,65,66,261,Ish Smith
2014-2015,Total,PG,55,14,832,143,367,0.39,18,60,0.3,125,307,0.407,0.414,34,57,0.596,15,85,100,180,36,6,78,50,338,Ish Smith
2014-2015,Oklahoma City Thunder,PG,30,0,155,15,45,0.333,1,5,0.2,14,40,0.35,0.344,6,9,0.667,5,22,27,28,4,1,9,12,37,Ish Smith
2014-2015,Philadelphia 76ers,PG,25,14,677,128,322,0.398,17,55,0.309,111,267,0.416,0.424,28,48,0.583,10,63,73,152,32,5,69,38,301,Ish Smith
2015-2016,Total,PG,77,53,2239,397,967,0.411,56,170,0.329,341,797,0.428,0.44,122,176,0.693,43,262,305,502,88,24,175,133,972,Ish Smith
2015-2016,New Orleans Pelicans,PG,27,3,617,98,228,0.43,10,33,0.303,88,195,0.451,0.452,33,43,0.767,14,78,92,154,24,6,45,38,239,Ish Smith
2015-2016,Philadelphia 76ers,PG,50,50,1622,299,739,0.405,46,137,0.336,253,602,0.42,0.436,89,133,0.669,29,184,213,348,64,18,130,95,733,Ish Smith
2016-2017,Detroit Pistons,PG,81,32,1955,329,749,0.439,28,105,0.267,301,644,0.467,0.458,72,102,0.706,21,214,235,418,61,33,112,127,758,Ish Smith
2017-2018,Detroit Pistons,PG,82,35,2043,389,801,0.486,35,101,0.347,354,700,0.506,0.507,81,116,0.698,27,197,224,360,64,20,108,140,894,Ish Smith
2018-2019,Detroit Pistons,PG,56,0,1251,205,489,0.419,44,135,0.326,161,354,0.455,0.464,47,62,0.758,23,122,145,203,28,11,61,109,501,Ish Smith
2019-2020,Washington Wizards,PG,68,23,1787,308,689,0.447,62,169,0.367,246,520,0.473,0.492,62,86,0.721,30,189,219,334,59,30,95,106,740,Ish Smith
2020-2021,Washington Wizards,PG,44,1,924,129,297,0.434,18,49,0.367,111,248,0.448,0.465,19,33,0.576,22,128,150,172,32,13,41,62,295,Ish Smith
2021-2022,Total,PG,65,1,1126,185,430,0.43,25,67,0.373,160,363,0.441,0.459,15,24,0.625,25,115,140,244,47,23,78,78,410,Ish Smith
2021-2022,Charlotte Hornets,PG,37,1,511,73,185,0.395,10,25,0.4,63,160,0.394,0.422,12,19,0.632,11,46,57,98,20,10,36,34,168,Ish Smith
2021-2022,Washington Wizards,PG,28,0,615,112,245,0.457,15,42,0.357,97,203,0.478,0.488,3,5,0.6,14,69,83,146,27,13,42,44,242,Ish Smith
2022-2023,Denver Nuggets,PG,43,0,398,52,131,0.397,2,12,0.167,50,119,0.42,0.405,2,4,0.5,5,49,54,100,8,7,44,33,108,Ish Smith
2023-2024,Charlotte Hornets,PG,43,5,741,66,158,0.418,4,8,0.5,62,150,0.413,0.43,3,4,0.75,11,65,76,145,17,4,47,49,139,Ish Smith
2022-2023,Houston Rockets,PF,79,79,2451,364,892,0.408,120,391,0.307,244,501,0.487,0.475,162,206,0.786,122,447,569,101,43,74,104,227,1010,Jabari Smith Jr.
2023-2024,Houston Rockets,PF,76,76,2424,378,833,0.454,138,380,0.363,240,453,0.53,0.537,150,185,0.811,139,477,616,121,52,61,89,200,1044,Jabari Smith Jr.
2024-2025,Houston Rockets,PF,31,31,972,129,297,0.434,53,151,0.351,76,146,0.521,0.524,63,72,0.875,57,154,211,33,10,31,27,72,374,Jabari Smith Jr.
2020-2021,Phoenix Suns,PF,27,1,156,22,50,0.44,4,17,0.235,18,33,0.545,0.48,5,7,0.714,7,30,37,4,1,5,7,16,53,Jalen Smith
2021-2022,Total,PF,51,8,925,176,350,0.503,40,122,0.328,136,228,0.596,0.56,78,102,0.765,101,206,307,24,15,41,42,96,470,Jalen Smith
2021-2022,Phoenix Suns,PF,29,4,382,63,137,0.46,9,39,0.231,54,98,0.551,0.493,40,52,0.769,55,84,139,6,6,18,22,52,175,Jalen Smith
2021-2022,Indiana Pacers,PF,22,4,543,113,213,0.531,31,83,0.373,82,130,0.631,0.603,38,50,0.76,46,122,168,18,9,23,20,44,295,Jalen Smith
2022-2023,Indiana Pacers,C,68,31,1279,242,508,0.476,54,191,0.283,188,317,0.593,0.53,104,137,0.759,129,265,394,66,21,60,72,153,642,Jalen Smith
2023-2024,Indiana Pacers,C,61,14,1047,234,395,0.592,61,144,0.424,173,251,0.689,0.67,72,104,0.692,112,225,337,63,17,38,44,124,601,Jalen Smith
2024-2025,Chicago Bulls,C,28,1,430,78,166,0.47,31,88,0.352,47,78,0.603,0.563,34,43,0.791,39,116,155,22,9,20,17,44,221,Jalen Smith
2023-2024,Charlotte Hornets,SG,51,0,729,113,289,0.391,63,146,0.432,50,143,0.35,0.5,13,15,0.867,18,54,72,59,10,7,39,55,302,Nick Smith Jr.
2024-2025,Charlotte Hornets,SG,14,0,125,17,49,0.347,9,27,0.333,8,22,0.364,0.439,1,2,0.5,1,10,11,10,4,1,3,8,44,Nick Smith Jr.
2023-2024,Philadelphia 76ers,PG,16,0,84,18,46,0.391,13,35,0.371,5,11,0.455,0.533,3,5,0.6,0,4,4,12,8,0,7,8,52,Terquavion Smith
2024-2025,Milwaukee Bucks,PF,11,0,38,9,14,0.643,3,8,0.375,6,6,1,0.75,1,2,0.5,1,9,10,1,0,3,3,4,22,Tyler Smith
2018-2019,Philadelphia 76ers,SG,6,2,111,14,34,0.412,6,16,0.375,8,18,0.444,0.5,6,8,0.75,3,10,13,10,2,2,6,8,40,Zhaire Smith
2019-2020,Philadelphia 76ers,SF,7,0,32,3,11,0.273,0,3,0,3,8,0.375,0.273,2,4,0.5,0,2,2,2,3,0,2,4,8,Zhaire Smith
2021-2022,Total,SF,9,0,39,2,10,0.2,1,8,0.125,1,2,0.5,0.25,0,0,,2,4,6,1,0,0,0,2,5,Xavier Sneed
2021-2022,Memphis Grizzlies,SF,2,0,8,0,2,0,0,2,0,0,0,,0,0,0,,1,1,2,0,0,0,0,2,0,Xavier Sneed
2021-2022,Utah Jazz,SF,7,0,31,2,8,0.25,1,6,0.167,1,2,0.5,0.313,0,0,,1,3,4,1,0,0,0,0,5,Xavier Sneed
2022-2023,Charlotte Hornets,SF,4,0,48,5,10,0.5,3,6,0.5,2,4,0.5,0.65,4,4,1,0,5,5,5,0,1,3,7,17,Xavier Sneed
2022-2023,San Antonio Spurs,PF,56,53,1458,250,552,0.453,33,134,0.246,217,418,0.519,0.483,81,116,0.698,95,200,295,142,43,23,97,138,614,Jeremy Sochan
2023-2024,San Antonio Spurs,PF,74,73,2193,340,776,0.438,70,227,0.308,270,549,0.492,0.483,111,144,0.771,137,339,476,249,62,40,140,168,861,Jeremy Sochan
2024-2025,San Antonio Spurs,PF,18,15,532,105,195,0.538,8,31,0.258,97,164,0.591,0.559,51,70,0.729,51,105,156,52,17,12,34,44,269,Jeremy Sochan
2018-2019,Total,PF,14,3,148,25,47,0.532,0,3,0,25,44,0.568,0.532,4,12,0.333,15,33,48,5,9,8,9,23,54,Ray Spalding
2018-2019,Dallas Mavericks,PF,1,0,1,0,0,,0,0,,0,0,,,0,0,,0,0,0,0,0,0,0,0,0,Ray Spalding
2018-2019,Phoenix Suns,PF,13,3,147,25,47,0.532,0,3,0,25,44,0.568,0.532,4,12,0.333,15,33,48,5,9,8,9,23,54,Ray Spalding
2020-2021,Houston Rockets,C,2,0,19,2,4,0.5,0,1,0,2,3,0.667,0.5,0,2,0,2,2,4,0,0,2,3,3,4,Ray Spalding
2018-2019,Atlanta Hawks,PF,46,11,805,98,244,0.402,44,128,0.344,54,116,0.466,0.492,32,45,0.711,72,122,194,47,26,25,31,67,272,Omari Spellman
2019-2020,Golden State Warriors,C,49,3,886,127,295,0.431,43,110,0.391,84,185,0.454,0.503,73,92,0.793,77,142,219,47,33,24,54,63,370,Omari Spellman
2024-2025,Memphis Grizzlies,SG,6,0,59,7,14,0.5,3,6,0.5,4,8,0.5,0.607,4,4,1,1,6,7,7,1,1,3,6,21,Cam Spencer
2023-2024,Golden State Warriors,PG,6,0,26,2,4,0.5,0,2,0,2,2,1,0.5,0,0,,2,2,4,5,0,0,1,1,4,Pat Spencer
2024-2025,Golden State Warriors,PG,9,0,45,6,16,0.375,0,3,0,6,13,0.462,0.375,2,2,1,4,3,7,12,5,0,4,4,14,Pat Spencer
2021-2022,Philadelphia 76ers,SG,2,0,6,1,1,1,0,0,,1,1,1,1,0,0,,1,1,2,0,0,2,1,0,2,Jaden Springer
2022-2023,Philadelphia 76ers,SG,16,2,89,17,35,0.486,2,5,0.4,15,30,0.5,0.514,6,8,0.75,6,8,14,8,7,3,3,15,42,Jaden Springer
2023-2024,Total,SG,49,2,507,59,148,0.399,10,48,0.208,49,100,0.49,0.432,35,42,0.833,33,45,78,44,36,15,34,66,163,Jaden Springer
2023-2024,Philadelphia 76ers,SG,32,1,377,46,118,0.39,8,37,0.216,38,81,0.469,0.424,28,34,0.824,25,33,58,35,25,11,26,49,128,Jaden Springer
2023-2024,Boston Celtics,SG,17,1,130,13,30,0.433,2,11,0.182,11,19,0.579,0.467,7,8,0.875,8,12,20,9,11,4,8,17,35,Jaden Springer
2024-2025,Boston Celtics,SG,11,0,51,3,11,0.273,0,3,0,3,8,0.375,0.273,10,13,0.769,4,9,13,3,3,0,1,6,16,Jaden Springer
2020-2021,Indiana Pacers,SG,24,0,93,13,43,0.302,3,13,0.231,10,30,0.333,0.337,7,9,0.778,8,12,20,1,1,2,1,14,36,Cassius Stanley
2021-2022,Detroit Pistons,SG,9,1,155,19,46,0.413,4,17,0.235,15,29,0.517,0.457,10,10,1,5,14,19,4,5,2,6,17,52,Cassius Stanley
2014-2015,Sacramento Kings,SG,73,1,1127,108,296,0.365,48,149,0.322,60,147,0.408,0.446,55,64,0.859,11,77,88,67,20,17,40,92,319,Nik Stauskas
2015-2016,Philadelphia 76ers,SG,73,35,1809,210,545,0.385,106,325,0.326,104,220,0.473,0.483,91,118,0.771,23,160,183,138,44,20,94,115,617,Nik Stauskas
2016-2017,Philadelphia 76ers,SG,80,27,2188,251,634,0.396,132,359,0.368,119,275,0.433,0.5,122,150,0.813,21,205,226,188,45,32,128,144,756,Nik Stauskas
2017-2018,Total,SG,41,0,523,60,154,0.39,40,100,0.4,20,54,0.37,0.519,21,29,0.724,4,60,64,39,9,4,26,24,181,Nik Stauskas
2017-2018,Philadelphia 76ers,SG,6,0,45,1,4,0.25,0,1,0,1,3,0.333,0.25,2,2,1,0,1,1,1,4,0,4,3,4,Nik Stauskas
2017-2018,Brooklyn Nets,SG,35,0,478,59,150,0.393,40,99,0.404,19,51,0.373,0.527,19,27,0.704,4,59,63,38,5,4,22,21,177,Nik Stauskas
2018-2019,Total,SG,68,0,1015,136,338,0.402,70,188,0.372,66,150,0.44,0.506,57,64,0.891,18,109,127,81,21,7,51,50,399,Nik Stauskas
2018-2019,Portland Trail Blazers,SG,44,0,673,96,229,0.419,43,125,0.344,53,104,0.51,0.513,32,36,0.889,10,70,80,62,14,4,40,31,267,Nik Stauskas
2018-2019,Cleveland Cavaliers,SG,24,0,342,40,109,0.367,27,63,0.429,13,46,0.283,0.491,25,28,0.893,8,39,47,19,7,3,11,19,132,Nik Stauskas
2021-2022,Total,SG,8,0,39,5,14,0.357,4,10,0.4,1,4,0.25,0.5,4,6,0.667,1,2,3,2,0,0,1,1,18,Nik Stauskas
2021-2022,Miami Heat,SG,2,0,24,3,8,0.375,2,4,0.5,1,4,0.25,0.5,3,4,0.75,1,2,3,1,0,0,0,1,11,Nik Stauskas
2021-2022,Boston Celtics,SG,6,0,15,2,6,0.333,2,6,0.333,0,0,,0.5,1,2,0.5,0,0,0,1,0,0,1,0,7,Nik Stauskas
2020-2021,Cleveland Cavaliers,PF,40,0,499,62,136,0.456,4,25,0.16,58,111,0.523,0.471,37,51,0.725,24,72,96,25,17,13,23,53,165,Lamar Stevens
2021-2022,Cleveland Cavaliers,PF,63,13,1015,156,319,0.489,18,65,0.277,138,254,0.543,0.517,53,75,0.707,47,117,164,44,31,18,41,106,383,Lamar Stevens
2022-2023,Cleveland Cavaliers,SF,62,25,1120,129,288,0.448,30,95,0.316,99,193,0.513,0.5,40,57,0.702,48,159,207,33,27,19,27,79,328,Lamar Stevens
2023-2024,Total,PF,38,3,559,108,240,0.45,14,46,0.304,94,194,0.485,0.479,42,54,0.778,36,91,127,28,23,22,24,45,272,Lamar Stevens
2023-2024,Boston Celtics,PF,19,1,122,21,45,0.467,3,8,0.375,18,37,0.486,0.5,8,11,0.727,12,19,31,8,6,5,9,14,53,Lamar Stevens
2023-2024,Memphis Grizzlies,PF,19,2,437,87,195,0.446,11,38,0.289,76,157,0.484,0.474,34,43,0.791,24,72,96,20,17,17,15,31,219,Lamar Stevens
2020-2021,Detroit Pistons,C,68,14,1455,226,409,0.553,21,63,0.333,205,346,0.592,0.578,64,92,0.696,159,294,453,59,39,86,67,184,537,Isaiah Stewart
2021-2022,Detroit Pistons,C,71,71,1816,250,490,0.51,15,46,0.326,235,444,0.529,0.526,74,103,0.718,226,391,617,82,22,78,85,211,589,Isaiah Stewart
2022-2023,Detroit Pistons,C,50,47,1414,195,441,0.442,67,205,0.327,128,236,0.542,0.518,110,149,0.738,115,288,403,70,20,34,68,133,567,Isaiah Stewart
2023-2024,Detroit Pistons,PF,46,45,1423,186,382,0.487,67,175,0.383,119,207,0.575,0.575,64,85,0.753,74,231,305,73,17,38,66,99,503,Isaiah Stewart
2024-2025,Detroit Pistons,C,27,3,579,64,116,0.552,5,21,0.238,59,95,0.621,0.573,29,33,0.879,60,101,161,47,13,34,29,73,162,Isaiah Stewart
2023-2024,Denver Nuggets,SF,50,0,545,82,222,0.369,41,138,0.297,41,84,0.488,0.462,22,31,0.71,5,56,61,47,17,7,23,54,227,Julian Strawther
2024-2025,Denver Nuggets,SG,29,0,595,93,199,0.467,40,102,0.392,53,97,0.546,0.568,41,49,0.837,9,50,59,38,19,11,24,69,267,Julian Strawther
2019-2020,Chicago Bulls,SF,2,0,6,2,3,0.667,0,1,0,2,2,1,0.667,1,1,1,1,0,1,0,0,0,0,1,5,Max Strus
2020-2021,Miami Heat,SF,39,0,507,85,187,0.455,50,148,0.338,35,39,0.897,0.588,16,24,0.667,5,36,41,24,11,2,8,43,236,Max Strus
2021-2022,Miami Heat,SF,68,16,1587,249,564,0.441,181,442,0.41,68,122,0.557,0.602,42,53,0.792,24,178,202,92,28,16,57,116,721,Max Strus
2022-2023,Miami Heat,SF,80,33,2272,324,790,0.41,197,563,0.35,127,227,0.559,0.535,78,89,0.876,49,209,258,171,42,12,70,166,923,Max Strus
2023-2024,Cleveland Cavaliers,SF,70,70,2239,304,728,0.418,168,479,0.351,136,249,0.546,0.533,77,97,0.794,66,272,338,283,64,29,112,170,853,Max Strus
2024-2025,Cleveland Cavaliers,SF,3,0,65,6,17,0.353,4,14,0.286,2,3,0.667,0.471,0,0,,3,8,11,5,1,0,1,9,16,Max Strus
2021-2022,Orlando Magic,PG,48,45,1307,198,548,0.361,42,196,0.214,156,352,0.443,0.4,126,163,0.773,26,145,171,209,59,19,143,142,564,Jalen Suggs
2022-2023,Orlando Magic,SG,53,19,1246,186,444,0.419,66,202,0.327,120,242,0.496,0.493,86,119,0.723,55,106,161,155,67,27,94,120,524,Jalen Suggs
2023-2024,Orlando Magic,SG,75,75,2025,336,714,0.471,153,385,0.397,183,329,0.556,0.578,118,156,0.756,48,181,229,205,106,47,132,205,943,Jalen Suggs
2024-2025,Orlando Magic,PG,31,31,926,181,439,0.412,69,222,0.311,112,217,0.516,0.491,90,98,0.918,21,110,131,120,46,31,95,87,521,Jalen Suggs
2017-2018,Indiana Pacers,PG,1,0,2,1,1,1,0,0,,1,1,1,1,0,0,,0,1,1,0,0,0,0,1,2,Edmond Sumner
2018-2019,Indiana Pacers,PG,23,2,210,22,64,0.344,7,27,0.259,15,37,0.405,0.398,15,24,0.625,9,15,24,10,12,5,10,26,66,Edmond Sumner
2019-2020,Indiana Pacers,SG,31,3,447,61,142,0.43,14,53,0.264,47,89,0.528,0.479,16,29,0.552,11,35,46,55,15,9,22,44,152,Edmond Sumner
2020-2021,Indiana Pacers,SG,53,24,861,148,282,0.525,35,88,0.398,113,194,0.582,0.587,68,83,0.819,18,76,94,49,33,10,51,88,399,Edmond Sumner
2022-2023,Brooklyn Nets,SG,53,12,736,124,269,0.461,31,87,0.356,93,182,0.511,0.519,99,108,0.917,13,66,79,68,31,10,50,83,378,Edmond Sumner
2022-2023,Los Angeles Lakers,SF,7,0,41,3,9,0.333,3,8,0.375,0,1,0,0.5,0,0,,1,6,7,4,0,0,0,3,9,Cole Swider
2023-2024,Miami Heat,SF,18,0,87,15,38,0.395,10,30,0.333,5,8,0.625,0.526,2,2,1,1,6,7,5,1,1,8,4,42,Cole Swider
2024-2025,Detroit Pistons,SF,2,0,13,0,5,0,0,5,0,0,0,,0,0,0,,0,2,2,1,0,0,0,1,0,Cole Swider
2021-2022,Washington Wizards,SG,3,0,19,3,4,0.75,0,1,0,3,3,1,0.75,0,0,0,0,0,1,4,0,1,7,6,0,Craig Sword
2021-2022,Indiana Pacers,PG,32,11,566,69,190,0.363,27,90,0.3,42,100,0.42,0.434,15,17,0.882,8,37,45,62,12,4,33,51,180,Keifer Sykes
2020-2021,Houston Rockets,SF,70,58,2043,316,625,0.506,60,195,0.308,256,430,0.595,0.554,102,147,0.694,132,242,374,178,85,36,98,222,794,Jae'Sean Tate
2021-2022,Houston Rockets,PF,78,77,2056,363,729,0.498,63,202,0.312,300,527,0.569,0.541,130,184,0.707,135,285,420,222,72,41,139,286,919,Jae'Sean Tate
2022-2023,Houston Rockets,SF,31,7,677,110,229,0.48,13,46,0.283,97,183,0.53,0.509,50,69,0.725,41,77,118,84,21,7,47,106,283,Jae'Sean Tate
2023-2024,Houston Rockets,SF,65,9,1031,108,229,0.472,23,77,0.299,85,152,0.559,0.522,26,39,0.667,61,136,197,64,42,15,37,137,265,Jae'Sean Tate
2024-2025,Houston Rockets,SF,15,0,125,20,37,0.541,1,7,0.143,19,30,0.633,0.554,12,17,0.706,8,25,33,10,9,0,8,23,53,Jae'Sean Tate
2017-2018,Boston Celtics,SF,80,80,2443,397,835,0.475,105,242,0.434,292,593,0.492,0.538,213,258,0.826,50,352,402,128,83,58,114,170,1112,Jayson Tatum
2018-2019,Boston Celtics,SF,79,79,2455,466,1036,0.45,116,311,0.373,350,725,0.483,0.506,195,228,0.855,70,407,477,168,84,57,122,168,1243,Jayson Tatum
2019-2020,Boston Celtics,PF,66,66,2265,552,1226,0.45,189,469,0.403,363,757,0.48,0.527,254,313,0.812,64,396,460,200,93,57,155,136,1547,Jayson Tatum
2020-2021,Boston Celtics,SF,64,64,2290,605,1318,0.459,187,485,0.386,418,833,0.502,0.53,295,340,0.868,50,422,472,276,75,31,171,122,1692,Jayson Tatum
2021-2022,Boston Celtics,SF,76,76,2731,708,1564,0.453,230,651,0.353,478,913,0.524,0.526,400,469,0.853,85,524,609,334,75,49,217,174,2046,Jayson Tatum
2022-2023,Boston Celtics,SF,74,74,2732,727,1559,0.466,240,686,0.35,487,873,0.558,0.543,531,622,0.854,78,571,649,342,78,51,213,160,2225,Jayson Tatum
2023-2024,Boston Celtics,PF,74,74,2645,672,1426,0.471,229,609,0.376,443,817,0.542,0.552,414,497,0.833,67,534,601,364,75,43,188,145,1987,Jayson Tatum
2024-2025,Boston Celtics,PF,28,28,1020,266,571,0.466,110,295,0.373,156,276,0.565,0.562,162,201,0.806,17,252,269,156,34,13,77,71,804,Jayson Tatum
2021-2022,Indiana Pacers,PF,33,7,714,135,220,0.614,12,38,0.316,123,182,0.676,0.641,36,51,0.706,95,77,172,41,14,8,23,61,318,Terry Taylor
2022-2023,Total,PF,31,2,264,39,75,0.52,5,19,0.263,34,56,0.607,0.553,6,11,0.545,27,20,47,10,3,6,9,26,89,Terry Taylor
2022-2023,Indiana Pacers,PF,26,2,228,30,65,0.462,4,18,0.222,26,47,0.553,0.492,5,7,0.714,22,17,39,10,3,5,9,24,69,Terry Taylor
2022-2023,Chicago Bulls,PF,5,0,36,9,10,0.9,1,1,1,8,9,0.889,0.95,1,4,0.25,5,3,8,0,0,1,0,2,20,Terry Taylor
2023-2024,Chicago Bulls,PF,31,0,188,20,39,0.513,2,9,0.222,18,30,0.6,0.538,4,5,0.8,17,20,37,10,5,2,7,17,46,Terry Taylor
2009-2010,Total,SG,27,4,334,44,101,0.436,13,37,0.351,31,64,0.484,0.5,35,50,0.7,6,25,31,21,13,6,27,42,136,Garrett Temple
2009-2010,Houston Rockets,SG,9,0,118,13,29,0.448,3,12,0.25,10,17,0.588,0.5,16,24,0.667,2,12,14,7,4,4,14,16,45,Garrett Temple
2009-2010,Sacramento Kings,SG,5,0,23,3,8,0.375,0,2,0,3,6,0.5,0.375,5,5,1,1,2,3,2,1,0,2,1,11,Garrett Temple
2009-2010,San Antonio Spurs,SG,13,4,193,28,64,0.438,10,23,0.435,18,41,0.439,0.516,14,21,0.667,3,11,14,12,8,2,11,25,80,Garrett Temple
2010-2011,Total,PG,24,0,230,20,68,0.294,10,37,0.27,10,31,0.323,0.368,7,17,0.412,1,22,23,32,11,6,23,24,57,Garrett Temple
2010-2011,San Antonio Spurs,SG,3,0,21,1,5,0.2,0,1,0,1,4,0.25,0.2,0,2,0,1,1,2,2,1,1,1,2,2,Garrett Temple
2010-2011,Milwaukee Bucks,SG,9,0,83,7,21,0.333,3,10,0.3,4,11,0.364,0.405,0,4,0,0,6,6,6,1,1,2,8,17,Garrett Temple
2010-2011,Charlotte Hornets,PG,12,0,126,12,42,0.286,7,26,0.269,5,16,0.313,0.369,7,11,0.636,0,15,15,24,9,4,20,14,38,Garrett Temple
2012-2013,Washington Wizards,SG,51,36,1156,105,258,0.407,26,80,0.325,79,178,0.444,0.457,26,37,0.703,29,94,123,115,50,17,61,94,262,Garrett Temple
2013-2014,Washington Wizards,SG,75,0,638,51,141,0.362,6,29,0.207,45,112,0.402,0.383,30,43,0.698,21,47,68,72,35,11,42,72,138,Garrett Temple
2014-2015,Washington Wizards,SG,52,18,735,68,170,0.4,33,88,0.375,35,82,0.427,0.497,35,48,0.729,24,66,90,56,42,9,34,76,204,Garrett Temple
2015-2016,Washington Wizards,SF,80,43,1951,201,505,0.398,89,258,0.345,112,247,0.453,0.486,91,125,0.728,36,176,212,140,69,18,64,195,582,Garrett Temple
2016-2017,Sacramento Kings,SG,65,20,1728,183,432,0.424,82,220,0.373,101,212,0.476,0.519,58,74,0.784,32,152,184,168,84,28,78,141,506,Garrett Temple
2017-2018,Sacramento Kings,SG,65,35,1615,199,476,0.418,89,227,0.392,110,249,0.442,0.512,60,78,0.769,22,130,152,124,57,27,79,135,547,Garrett Temple
2018-2019,Total,SG,75,55,2040,208,493,0.422,90,264,0.341,118,229,0.515,0.513,80,107,0.748,28,188,216,106,76,30,70,204,586,Garrett Temple
2018-2019,Memphis Grizzlies,SG,49,49,1530,166,387,0.429,74,210,0.352,92,177,0.52,0.525,57,76,0.75,18,134,152,69,50,25,54,134,463,Garrett Temple
2018-2019,Los Angeles Clippers,SG,26,6,510,42,106,0.396,16,54,0.296,26,52,0.5,0.472,23,31,0.742,10,54,64,37,26,5,16,70,123,Garrett Temple
2019-2020,Brooklyn Nets,SG,62,35,1730,222,587,0.378,127,386,0.329,95,201,0.473,0.486,70,87,0.805,29,189,218,156,49,29,62,108,641,Garrett Temple
2020-2021,Chicago Bulls,SG,56,25,1528,158,381,0.415,67,200,0.335,91,181,0.503,0.503,40,50,0.8,29,131,160,124,43,30,58,126,423,Garrett Temple
2021-2022,New Orleans Pelicans,SG,59,16,1098,111,295,0.376,59,185,0.319,52,110,0.473,0.476,28,41,0.683,29,114,143,74,43,23,42,81,309,Garrett Temple
2022-2023,New Orleans Pelicans,SG,25,0,162,18,45,0.4,11,26,0.423,7,19,0.368,0.522,3,4,0.75,5,12,17,13,9,2,4,15,50,Garrett Temple
2023-2024,Toronto Raptors,SG,27,2,289,29,78,0.372,12,40,0.3,17,38,0.447,0.449,18,22,0.818,18,27,45,28,12,3,14,28,88,Garrett Temple
2024-2025,Toronto Raptors,SG,10,0,40,2,10,0.2,1,5,0.2,1,5,0.2,0.25,0,0,,1,5,6,6,4,1,3,6,5,Garrett Temple
2022-2023,Chicago Bulls,SG,38,0,214,32,72,0.444,7,27,0.259,25,45,0.556,0.493,14,21,0.667,12,25,37,22,11,5,8,24,85,Dalen Terry
2023-2024,Chicago Bulls,SG,59,2,681,69,157,0.439,17,74,0.23,52,83,0.627,0.494,25,43,0.581,29,84,113,81,27,18,32,81,180,Dalen Terry
2024-2025,Chicago Bulls,SG,28,1,374,42,87,0.483,11,32,0.344,31,55,0.564,0.546,22,28,0.786,18,21,39,26,16,8,24,43,117,Dalen Terry
2020-2021,Dallas Mavericks,PG,11,0,56,5,16,0.313,0,7,0,5,9,0.556,0.313,1,3,0.333,0,6,6,6,5,0,2,2,11,Tyrell Terry
2021-2022,Memphis Grizzlies,PG,2,0,3,1,1,1,0,0,,1,1,1,1,0,0,,0,0,0,0,0,0,0,1,2,Tyrell Terry
2017-2018,Boston Celtics,C,63,3,936,126,233,0.541,18,58,0.31,108,175,0.617,0.579,61,81,0.753,90,184,274,56,30,48,56,157,331,Daniel Theis
2018-2019,Boston Celtics,C,66,2,908,146,266,0.549,26,67,0.388,120,199,0.603,0.598,56,76,0.737,87,138,225,68,21,42,33,161,374,Daniel Theis
2019-2020,Boston Celtics,C,65,64,1566,241,426,0.566,32,96,0.333,209,330,0.633,0.603,87,114,0.763,140,286,426,111,37,84,54,219,601,Daniel Theis
2020-2021,Total,C,65,51,1601,252,466,0.541,49,152,0.322,203,314,0.646,0.593,74,110,0.673,93,263,356,108,41,57,66,167,627,Daniel Theis
2020-2021,Boston Celtics,C,42,37,1027,159,288,0.552,33,95,0.347,126,193,0.653,0.609,46,67,0.687,54,166,220,67,25,43,41,120,397,Daniel Theis
2020-2021,Chicago Bulls,C,23,14,574,93,178,0.522,16,57,0.281,77,121,0.636,0.567,28,43,0.651,39,97,136,41,16,14,25,47,230,Daniel Theis
2021-2022,Total,C,47,27,977,151,291,0.519,33,107,0.308,118,184,0.641,0.576,49,72,0.681,59,169,228,41,20,31,46,111,384,Daniel Theis
2021-2022,Houston Rockets,C,26,21,584,84,179,0.469,23,79,0.291,61,100,0.61,0.534,27,40,0.675,32,98,130,20,11,17,31,62,218,Daniel Theis
2021-2022,Boston Celtics,C,21,6,393,67,112,0.598,10,28,0.357,57,84,0.679,0.643,22,32,0.688,27,71,98,21,9,14,15,49,166,Daniel Theis
2022-2023,Indiana Pacers,C,7,1,109,21,44,0.477,2,11,0.182,19,33,0.576,0.5,5,12,0.417,7,15,22,9,2,6,3,7,49,Daniel Theis
2023-2024,Total,C,60,3,1015,156,293,0.532,26,71,0.366,130,222,0.586,0.577,38,50,0.76,85,159,244,61,21,51,42,127,376,Daniel Theis
2023-2024,Indiana Pacers,C,1,0,8,1,4,0.25,0,1,0,1,3,0.333,0.25,0,0,,0,0,0,0,0,0,0,1,2,Daniel Theis
2023-2024,Los Angeles Clippers,C,59,3,1007,155,289,0.536,26,70,0.371,129,219,0.589,0.581,38,50,0.76,85,159,244,61,21,51,42,126,374,Daniel Theis
2024-2025,New Orleans Pelicans,C,22,7,323,30,70,0.429,5,22,0.227,25,48,0.521,0.464,18,20,0.9,20,63,83,34,9,13,14,41,83,Daniel Theis
2020-2021,Total,SG,32,1,399,39,108,0.361,16,59,0.271,23,49,0.469,0.435,31,46,0.674,8,45,53,30,15,10,22,40,125,Brodric Thomas
2020-2021,Houston Rockets,SG,4,0,24,2,7,0.286,1,6,0.167,1,1,1,0.357,5,7,0.714,1,3,4,4,1,1,4,5,10,Brodric Thomas
2020-2021,Cleveland Cavaliers,SG,28,1,375,37,101,0.366,15,53,0.283,22,48,0.458,0.441,26,39,0.667,7,42,49,26,14,9,18,35,115,Brodric Thomas
2021-2022,Boston Celtics,SG,12,0,60,8,18,0.444,2,9,0.222,6,9,0.667,0.5,3,5,0.6,2,8,10,11,1,1,6,7,21,Brodric Thomas
2021-2022,Brooklyn Nets,SG,67,2,1176,218,503,0.433,47,174,0.27,171,329,0.52,0.48,87,105,0.829,16,145,161,78,33,8,55,66,570,Cam Thomas
2022-2023,Brooklyn Nets,SG,57,4,948,201,456,0.441,51,133,0.383,150,323,0.464,0.497,151,174,0.868,8,87,95,78,20,7,63,55,604,Cam Thomas
2023-2024,Brooklyn Nets,SG,66,51,2075,526,1190,0.442,144,396,0.364,382,794,0.481,0.503,286,334,0.856,28,186,214,192,45,16,124,138,1482,Cam Thomas
2024-2025,Brooklyn Nets,SG,17,17,568,137,297,0.461,49,126,0.389,88,171,0.515,0.544,97,112,0.866,6,49,55,57,12,1,48,34,420,Cam Thomas
2011-2012,Sacramento Kings,PG,65,37,1656,256,571,0.448,83,219,0.379,173,352,0.491,0.521,154,185,0.832,48,120,168,266,53,8,105,121,749,Isaiah Thomas
2012-2013,Sacramento Kings,PG,79,62,2122,366,832,0.44,115,321,0.358,251,511,0.491,0.509,253,287,0.882,29,132,161,316,67,3,140,167,1100,Isaiah Thomas
2013-2014,Sacramento Kings,PG,72,54,2497,496,1096,0.453,127,364,0.349,369,732,0.504,0.51,346,407,0.85,47,163,210,454,93,8,213,185,1465,Isaiah Thomas
2014-2015,Total,PG,67,1,1726,335,797,0.42,129,346,0.373,206,451,0.457,0.501,302,348,0.868,33,120,153,284,57,5,143,150,1101,Isaiah Thomas
2014-2015,Phoenix Suns,PG,46,1,1181,218,512,0.426,81,207,0.391,137,305,0.449,0.505,184,211,0.872,26,83,109,171,45,5,89,105,701,Isaiah Thomas
2014-2015,Boston Celtics,PG,21,0,545,117,285,0.411,48,139,0.345,69,146,0.473,0.495,118,137,0.861,7,37,44,113,12,0,54,45,400,Isaiah Thomas
2015-2016,Boston Celtics,PG,82,79,2644,591,1382,0.428,167,465,0.359,424,917,0.462,0.488,474,544,0.871,46,197,243,509,91,9,220,167,1823,Isaiah Thomas
2016-2017,Boston Celtics,PG,76,76,2569,682,1473,0.463,245,646,0.379,437,827,0.528,0.546,590,649,0.909,43,162,205,448,70,13,210,167,2199,Isaiah Thomas
2017-2018,Total,PG,32,15,862,157,421,0.373,55,188,0.293,102,233,0.438,0.438,117,131,0.893,17,50,67,153,15,3,95,58,486,Isaiah Thomas
2017-2018,Cleveland Cavaliers,PG,15,14,406,70,194,0.361,22,87,0.253,48,107,0.449,0.418,59,68,0.868,7,24,31,68,9,2,41,25,221,Isaiah Thomas
2017-2018,Los Angeles Lakers,PG,17,1,456,87,227,0.383,33,101,0.327,54,126,0.429,0.456,58,63,0.921,10,26,36,85,6,1,54,33,265,Isaiah Thomas
2018-2019,Denver Nuggets,SG,12,0,181,34,99,0.343,12,43,0.279,22,56,0.393,0.404,17,27,0.63,5,8,13,23,5,1,18,17,97,Isaiah Thomas
2019-2020,Washington Wizards,PG,40,37,925,174,426,0.408,78,189,0.413,96,237,0.405,0.5,62,76,0.816,11,57,68,146,13,6,77,77,488,Isaiah Thomas
2020-2021,New Orleans Pelicans,PG,3,0,48,9,27,0.333,3,12,0.25,6,15,0.4,0.389,2,2,1,1,3,4,5,1,0,6,3,23,Isaiah Thomas
2021-2022,Total,PG,22,1,333,67,167,0.401,28,83,0.337,39,84,0.464,0.485,22,26,0.846,4,25,29,34,7,5,15,34,184,Isaiah Thomas
2021-2022,Los Angeles Lakers,PG,4,1,101,12,39,0.308,5,22,0.227,7,17,0.412,0.372,8,11,0.727,1,7,8,6,0,2,5,12,37,Isaiah Thomas
2021-2022,Dallas Mavericks,PG,1,0,13,3,8,0.375,0,3,0,3,5,0.6,0.375,0,0,,0,0,0,4,0,0,0,0,6,Isaiah Thomas
2021-2022,Charlotte Hornets,PG,17,0,219,52,120,0.433,23,58,0.397,29,62,0.468,0.529,14,15,0.933,3,18,21,24,7,3,10,22,141,Isaiah Thomas
2023-2024,Phoenix Suns,PG,6,0,19,3,10,0.3,2,4,0.5,1,6,0.167,0.4,0,0,,0,0,0,3,0,0,0,0,8,Isaiah Thomas
2018-2019,Detroit Pistons,SG,26,0,195,22,69,0.319,10,35,0.286,12,34,0.353,0.391,7,11,0.636,4,16,20,8,7,5,4,22,61,Khyri Thomas
2019-2020,Detroit Pistons,SG,8,0,61,5,17,0.294,5,14,0.357,0,3,0,0.441,2,4,0.5,1,0,1,3,3,0,3,9,17,Khyri Thomas
2020-2021,Houston Rockets,SG,5,2,153,32,66,0.485,9,27,0.333,23,39,0.59,0.553,9,9,1,7,11,18,25,9,6,6,8,82,Khyri Thomas
2023-2024,Houston Rockets,SF,62,23,1388,239,446,0.536,8,58,0.138,231,388,0.595,0.545,106,155,0.684,148,261,409,163,78,38,90,141,592,Amen Thompson
2024-2025,Houston Rockets,SF,31,5,859,146,262,0.557,11,41,0.268,135,221,0.611,0.578,74,106,0.698,76,146,222,66,34,35,59,71,377,Amen Thompson
2023-2024,Detroit Pistons,SF,63,38,1583,232,480,0.483,21,113,0.186,211,367,0.575,0.505,71,119,0.597,129,273,402,120,68,59,84,175,556,Ausar Thompson
2024-2025,Detroit Pistons,SF,11,3,185,34,72,0.472,4,16,0.25,30,56,0.536,0.5,9,17,0.529,14,30,44,20,9,4,15,31,81,Ausar Thompson
2011-2012,Golden State Warriors,SG,66,29,1608,318,718,0.443,111,268,0.414,207,450,0.46,0.52,79,91,0.868,24,137,161,133,49,20,103,155,826,Klay Thompson
2012-2013,Golden State Warriors,SG,82,82,2936,508,1205,0.422,211,526,0.401,297,679,0.437,0.509,132,157,0.841,32,274,306,183,86,45,157,237,1359,Klay Thompson
2013-2014,Golden State Warriors,SG,81,81,2868,559,1259,0.444,223,535,0.417,336,724,0.464,0.533,147,185,0.795,38,211,249,181,74,37,135,234,1488,Klay Thompson
2014-2015,Golden State Warriors,SG,77,77,2455,602,1299,0.463,239,545,0.439,363,754,0.481,0.555,225,256,0.879,27,220,247,222,87,60,149,122,1668,Klay Thompson
2015-2016,Golden State Warriors,SG,80,80,2666,651,1386,0.47,276,650,0.425,375,736,0.51,0.569,193,221,0.873,35,271,306,166,60,49,138,152,1771,Klay Thompson
2016-2017,Golden State Warriors,SG,78,78,2649,644,1376,0.468,268,647,0.414,376,729,0.516,0.565,186,218,0.853,49,236,285,160,66,40,128,139,1742,Klay Thompson
2017-2018,Golden State Warriors,SG,73,73,2506,575,1179,0.488,229,521,0.44,346,658,0.526,0.585,82,98,0.837,31,246,277,185,55,34,128,117,1461,Klay Thompson
2018-2019,Golden State Warriors,SG,78,78,2652,655,1402,0.467,241,599,0.402,414,803,0.516,0.553,129,158,0.816,37,262,299,186,84,47,115,157,1680,Klay Thompson
2021-2022,Golden State Warriors,SG,32,32,941,246,573,0.429,114,296,0.385,132,277,0.477,0.529,46,51,0.902,15,110,125,88,16,17,43,54,652,Klay Thompson
2022-2023,Golden State Warriors,SF,69,69,2279,546,1252,0.436,301,731,0.412,245,521,0.47,0.556,116,132,0.879,39,247,286,163,49,29,123,130,1509,Klay Thompson
2023-2024,Golden State Warriors,SF,77,63,2284,490,1133,0.432,268,692,0.387,222,441,0.503,0.551,127,137,0.927,35,219,254,176,50,35,117,127,1375,Klay Thompson
2024-2025,Dallas Mavericks,SF,27,27,740,137,324,0.423,82,213,0.385,55,111,0.495,0.549,26,29,0.897,17,78,95,52,26,11,32,36,382,Klay Thompson
2011-2012,Cleveland Cavaliers,PF,60,25,1424,194,442,0.439,0,2,0,194,440,0.441,0.439,106,192,0.552,187,202,389,27,27,62,81,134,494,Tristan Thompson
2012-2013,Cleveland Cavaliers,PF,82,82,2564,390,799,0.488,0,3,0,390,796,0.49,0.488,177,291,0.608,306,467,773,108,60,71,123,234,957,Tristan Thompson
2013-2014,Cleveland Cavaliers,PF,82,82,2594,363,761,0.477,0,1,0,363,760,0.478,0.477,235,339,0.693,269,485,754,72,42,35,108,188,961,Tristan Thompson
2014-2015,Cleveland Cavaliers,PF,82,15,2194,267,488,0.547,0,0,,267,488,0.547,0.547,159,248,0.641,274,383,657,39,34,61,83,189,693,Tristan Thompson
2015-2016,Cleveland Cavaliers,PF,82,34,2269,247,420,0.588,0,0,,247,420,0.588,0.588,149,242,0.616,268,470,738,62,38,51,61,202,643,Tristan Thompson
2016-2017,Cleveland Cavaliers,C,78,78,2336,262,437,0.6,0,3,0,262,434,0.604,0.6,106,213,0.498,286,429,715,77,39,84,64,176,630,Tristan Thompson
2017-2018,Cleveland Cavaliers,C,53,22,1072,132,235,0.562,0,0,,132,235,0.562,0.562,43,79,0.544,126,226,352,33,16,17,36,102,307,Tristan Thompson
2018-2019,Cleveland Cavaliers,C,43,40,1198,201,380,0.529,0,0,,201,380,0.529,0.529,68,106,0.642,173,265,438,86,28,16,59,89,470,Tristan Thompson
2019-2020,Cleveland Cavaliers,C,57,51,1721,288,562,0.512,9,23,0.391,279,539,0.518,0.52,99,161,0.615,226,351,577,120,33,50,103,124,684,Tristan Thompson
2020-2021,Boston Celtics,C,54,43,1287,169,326,0.518,0,3,0,169,323,0.523,0.518,71,120,0.592,169,270,439,67,24,33,62,119,409,Tristan Thompson
2021-2022,Total,C,57,6,897,141,267,0.528,1,3,0.333,140,264,0.53,0.53,61,116,0.526,120,168,288,34,23,21,45,98,344,Tristan Thompson
2021-2022,Sacramento Kings,C,30,3,455,76,151,0.503,1,1,1,75,150,0.5,0.507,32,60,0.533,72,89,161,18,11,12,29,52,185,Tristan Thompson
2021-2022,Indiana Pacers,C,4,0,66,13,24,0.542,0,0,,13,24,0.542,0.542,3,8,0.375,7,11,18,2,0,2,4,7,29,Tristan Thompson
2021-2022,Chicago Bulls,C,23,3,376,52,92,0.565,0,2,0,52,90,0.578,0.565,26,48,0.542,41,68,109,14,12,7,12,39,130,Tristan Thompson
2023-2024,Cleveland Cavaliers,C,49,0,549,73,120,0.608,0,1,0,73,119,0.613,0.608,15,52,0.288,73,101,174,51,12,14,29,59,161,Tristan Thompson
2024-2025,Cleveland Cavaliers,PF,12,0,90,13,27,0.481,0,1,0,13,26,0.5,0.481,4,14,0.286,8,24,32,4,0,4,5,10,30,Tristan Thompson
2021-2022,Charlotte Hornets,PF,33,0,262,24,55,0.436,7,27,0.259,17,28,0.607,0.5,12,20,0.6,11,32,43,19,8,11,10,26,67,JT Thor
2022-2023,Charlotte Hornets,PF,69,8,969,95,238,0.399,39,123,0.317,56,115,0.487,0.481,33,47,0.702,36,116,152,36,22,23,44,66,262,JT Thor
2023-2024,Charlotte Hornets,PF,63,3,781,80,183,0.437,28,81,0.346,52,102,0.51,0.514,11,20,0.55,43,103,146,29,11,27,15,60,199,JT Thor
2024-2025,Cleveland Cavaliers,PF,4,0,21,7,8,0.875,3,3,1,4,5,0.8,1.063,6,6,1,1,2,3,0,2,3,2,4,23,JT Thor
2019-2020,Philadelphia 76ers,SG,65,14,1287,112,265,0.423,56,157,0.357,56,108,0.519,0.528,25,41,0.61,44,63,107,79,94,47,51,141,305,Matisse Thybulle
2020-2021,Philadelphia 76ers,SG,65,8,1298,102,243,0.42,43,143,0.301,59,100,0.59,0.508,8,18,0.444,30,94,124,63,105,71,32,127,255,Matisse Thybulle
2021-2022,Philadelphia 76ers,SG,66,50,1685,150,300,0.5,45,144,0.313,105,156,0.673,0.575,34,43,0.791,42,109,151,75,115,71,39,158,379,Matisse Thybulle
2022-2023,Total,SF,71,28,1200,110,253,0.435,54,148,0.365,56,105,0.533,0.542,19,28,0.679,40,100,140,53,83,32,24,113,293,Matisse Thybulle
2022-2023,Philadelphia 76ers,SF,49,6,591,50,116,0.431,21,63,0.333,29,53,0.547,0.522,9,12,0.75,20,43,63,23,45,14,8,65,130,Matisse Thybulle
2022-2023,Portland Trail Blazers,SG,22,22,609,60,137,0.438,33,85,0.388,27,52,0.519,0.558,10,16,0.625,20,57,77,30,38,18,16,48,163,Matisse Thybulle
2023-2024,Portland Trail Blazers,SF,65,19,1487,126,317,0.397,80,231,0.346,46,86,0.535,0.524,22,29,0.759,30,106,136,90,113,49,40,93,354,Matisse Thybulle
2020-2021,Memphis Grizzlies,C,18,1,182,19,57,0.333,10,33,0.303,9,24,0.375,0.421,9,11,0.818,6,18,24,8,5,8,2,20,57,Killian Tillie
2021-2022,Memphis Grizzlies,C,36,3,461,43,127,0.339,27,86,0.314,16,41,0.39,0.445,5,8,0.625,21,39,60,22,23,15,13,58,118,Killian Tillie
2020-2021,Memphis Grizzlies,PF,59,12,1085,167,299,0.559,22,65,0.338,145,234,0.62,0.595,34,53,0.642,74,182,256,75,44,33,45,116,390,Xavier Tillman Sr.
2021-2022,Memphis Grizzlies,PF,53,2,701,98,216,0.454,10,49,0.204,88,167,0.527,0.477,46,71,0.648,66,95,161,62,49,15,34,63,252,Xavier Tillman Sr.
2022-2023,Memphis Grizzlies,C,61,29,1180,188,306,0.614,4,15,0.267,184,291,0.632,0.621,49,89,0.551,121,186,307,96,58,29,44,97,429,Xavier Tillman Sr.
2023-2024,Total,PF,54,15,974,121,279,0.434,20,81,0.247,101,198,0.51,0.47,22,50,0.44,70,141,211,77,51,44,34,75,284,Xavier Tillman Sr.
2023-2024,Memphis Grizzlies,C,34,13,700,87,213,0.408,12,53,0.226,75,160,0.469,0.437,18,43,0.419,56,101,157,57,42,35,29,60,204,Xavier Tillman Sr.
2023-2024,Boston Celtics,PF,20,2,274,34,66,0.515,8,28,0.286,26,38,0.684,0.576,4,7,0.571,14,40,54,20,9,9,5,15,80,Xavier Tillman Sr.
2024-2025,Boston Celtics,C,19,1,156,9,34,0.265,4,18,0.222,5,16,0.313,0.324,1,2,0.5,8,26,34,6,5,3,6,13,23,Xavier Tillman Sr.
2021-2022,Washington Wizards,PF,12,0,74,7,26,0.269,4,16,0.25,3,10,0.3,0.346,2,6,0.333,3,9,12,4,4,2,4,4,20,Isaiah Todd
2022-2023,Washington Wizards,PF,6,1,61,3,19,0.158,1,10,0.1,2,9,0.222,0.184,2,2,1,2,10,12,4,1,0,2,4,9,Isaiah Todd
2023-2024,New York Knicks,SF,9,0,38,5,9,0.556,1,4,0.25,4,5,0.8,0.611,2,2,1,3,4,7,3,0,1,1,3,13,Jacob Toppin
2024-2025,New York Knicks,SF,8,0,22,1,3,0.333,0,2,0,1,1,1,0.333,0,0,,0,3,3,2,0,0,1,1,2,Jacob Toppin
2020-2021,New York Knicks,PF,62,0,683,104,209,0.498,26,85,0.306,78,124,0.629,0.56,19,26,0.731,26,112,138,29,17,15,23,55,253,Obi Toppin
2021-2022,New York Knicks,PF,72,10,1230,251,473,0.531,52,169,0.308,199,304,0.655,0.586,94,124,0.758,69,199,268,77,25,33,56,102,648,Obi Toppin
2022-2023,New York Knicks,PF,67,5,1050,187,419,0.446,85,247,0.344,102,172,0.593,0.548,38,47,0.809,29,158,187,66,23,12,38,68,497,Obi Toppin
2023-2024,Indiana Pacers,PF,82,28,1730,332,579,0.573,102,253,0.403,230,326,0.706,0.661,77,100,0.77,85,235,320,128,47,43,69,143,843,Obi Toppin
2024-2025,Indiana Pacers,PF,30,0,598,123,222,0.554,38,106,0.358,85,116,0.733,0.64,31,36,0.861,21,101,122,52,24,11,19,47,315,Obi Toppin
2019-2020,Golden State Warriors,SG,13,6,272,29,63,0.46,8,23,0.348,21,40,0.525,0.524,3,5,0.6,9,43,52,26,13,5,16,30,69,Juan Toscano-Anderson
2020-2021,Golden State Warriors,SG,53,16,1107,121,209,0.579,37,92,0.402,84,117,0.718,0.667,22,31,0.71,29,205,234,150,41,26,61,111,301,Juan Toscano-Anderson
2021-2022,Golden State Warriors,SF,73,6,994,115,235,0.489,28,87,0.322,87,148,0.588,0.549,40,70,0.571,28,148,176,127,48,17,68,115,298,Juan Toscano-Anderson
2022-2023,Total,SF,52,9,700,64,143,0.448,8,43,0.186,56,100,0.56,0.476,19,24,0.792,28,96,124,65,16,10,34,80,155,Juan Toscano-Anderson
2022-2023,Los Angeles Lakers,SF,30,7,365,33,66,0.5,4,20,0.2,29,46,0.63,0.53,11,15,0.733,14,47,61,25,10,7,17,46,81,Juan Toscano-Anderson
2022-2023,Utah Jazz,SF,22,2,335,31,77,0.403,4,23,0.174,27,54,0.5,0.429,8,9,0.889,14,49,63,40,6,3,17,34,74,Juan Toscano-Anderson
2023-2024,Sacramento Kings,SF,11,0,53,3,12,0.25,1,4,0.25,2,8,0.25,0.292,0,0,,4,10,14,4,1,1,2,11,7,Juan Toscano-Anderson
2015-2016,Minnesota Timberwolves,C,82,82,2627,625,1153,0.542,30,88,0.341,595,1065,0.559,0.555,223,275,0.811,229,629,858,161,58,138,183,245,1503,Karl-Anthony Towns
2016-2017,Minnesota Timberwolves,C,82,82,3030,802,1480,0.542,101,275,0.367,701,1205,0.582,0.576,356,428,0.832,296,711,1007,220,56,103,212,241,2061,Karl-Anthony Towns
2017-2018,Minnesota Timberwolves,C,82,82,2918,639,1172,0.545,120,285,0.421,519,887,0.585,0.596,345,402,0.858,238,774,1012,199,64,115,159,285,1743,Karl-Anthony Towns
2018-2019,Minnesota Timberwolves,C,77,77,2545,681,1314,0.518,142,355,0.4,539,959,0.562,0.572,376,450,0.836,263,691,954,259,67,125,240,292,1880,Karl-Anthony Towns
2019-2020,Minnesota Timberwolves,C,35,35,1187,316,622,0.508,114,277,0.412,202,345,0.586,0.6,180,226,0.796,95,283,378,153,33,42,110,117,926,Karl-Anthony Towns
2020-2021,Minnesota Timberwolves,C,50,50,1689,425,875,0.486,122,315,0.387,303,560,0.541,0.555,267,311,0.859,133,396,529,225,39,57,160,186,1239,Karl-Anthony Towns
2021-2022,Minnesota Timberwolves,C,74,74,2476,642,1214,0.529,150,366,0.41,492,848,0.58,0.591,384,467,0.822,194,533,727,269,72,83,226,267,1818,Karl-Anthony Towns
2022-2023,Minnesota Timberwolves,PF,29,29,957,212,428,0.495,60,164,0.366,152,264,0.576,0.565,118,135,0.874,48,188,236,140,20,17,86,111,602,Karl-Anthony Towns
2023-2024,Minnesota Timberwolves,PF,62,62,2026,479,951,0.504,136,327,0.416,343,624,0.55,0.575,255,292,0.873,94,421,515,189,43,41,177,204,1349,Karl-Anthony Towns
2024-2025,New York Knicks,C,29,29,984,249,462,0.539,65,145,0.448,184,317,0.58,0.609,142,170,0.835,82,309,391,98,25,26,76,105,705,Karl-Anthony Towns
2024-2025,Los Angeles Lakers,SF,8,0,61,5,18,0.278,0,7,0,5,11,0.455,0.278,2,7,0.286,1,13,14,1,4,2,2,6,12,Armel Traoré
2024-2025,Cleveland Cavaliers,SG,6,0,42,3,7,0.429,0,3,0,3,4,0.75,0.429,2,2,1,1,5,6,5,1,1,2,3,8,Luke Travers
2018-2019,Portland Trail Blazers,SG,15,1,111,16,50,0.32,5,21,0.238,11,29,0.379,0.37,3,7,0.429,1,10,11,5,1,2,4,4,40,Gary Trent Jr.
2019-2020,Portland Trail Blazers,SF,61,8,1332,196,441,0.444,112,268,0.418,84,173,0.486,0.571,37,45,0.822,25,75,100,61,48,16,21,90,541,Gary Trent Jr.
2020-2021,Total,SG,58,38,1802,320,785,0.408,165,429,0.385,155,356,0.435,0.513,83,106,0.783,27,125,152,80,56,10,43,92,888,Gary Trent Jr.
2020-2021,Portland Trail Blazers,SG,41,23,1262,217,524,0.414,121,305,0.397,96,219,0.438,0.53,58,75,0.773,21,70,91,58,37,6,31,63,613,Gary Trent Jr.
2020-2021,Toronto Raptors,SG,17,15,540,103,261,0.395,44,124,0.355,59,137,0.431,0.479,25,31,0.806,6,55,61,22,19,4,12,29,275,Gary Trent Jr.
2021-2022,Toronto Raptors,SG,70,69,2448,450,1086,0.414,209,545,0.383,241,541,0.445,0.511,174,204,0.853,26,165,191,141,122,19,73,144,1283,Gary Trent Jr.
2022-2023,Toronto Raptors,SG,66,44,2118,405,935,0.433,166,450,0.369,239,485,0.493,0.522,172,205,0.839,30,143,173,106,104,14,55,102,1148,Gary Trent Jr.
2023-2024,Toronto Raptors,SG,71,41,1994,361,847,0.426,178,453,0.393,183,394,0.464,0.531,74,96,0.771,25,163,188,119,77,10,47,96,974,Gary Trent Jr.
2024-2025,Milwaukee Bucks,SG,27,7,681,89,212,0.42,55,137,0.401,34,75,0.453,0.55,23,26,0.885,5,55,60,24,27,1,17,57,256,Gary Trent Jr.
2023-2024,Indiana Pacers,PF,8,0,42,10,20,0.5,0,0,10,20,0.5,0.5,6,8,0.75,8,8,16,2,2,1,0,3,26,0,Oscar Tshiebwe
2024-2025,Utah Jazz,PF,1,0,16,0,0,,0,0,0,0,,,3,4,0.75,3,6,9,0,2,0,1,3,3,0,Oscar Tshiebwe
2006-2007,Toronto Raptors,SF,17,0,83,11,22,0.5,0,0,,11,22,0.5,0.5,8,14,0.571,11,12,23,3,2,0,6,12,30,P.J. Tucker
2012-2013,Phoenix Suns,SG,79,45,1910,210,444,0.473,22,70,0.314,188,374,0.503,0.498,64,86,0.744,132,218,350,109,62,19,67,145,506,P.J. Tucker
2013-2014,Phoenix Suns,SF,81,81,2490,265,615,0.431,74,191,0.387,191,424,0.45,0.491,156,201,0.776,161,368,529,141,110,23,102,204,760,P.J. Tucker
2014-2015,Phoenix Suns,SF,78,63,2383,261,596,0.438,87,252,0.345,174,344,0.506,0.511,104,143,0.727,114,388,502,122,107,23,96,179,713,P.J. Tucker
2015-2016,Phoenix Suns,SF,82,80,2540,239,582,0.411,68,206,0.33,171,376,0.455,0.469,106,142,0.746,165,347,512,177,106,20,111,202,652,P.J. Tucker
2016-2017,Total,SF,81,21,2236,199,482,0.413,70,196,0.357,129,286,0.451,0.485,72,93,0.774,117,354,471,99,116,19,66,196,540,P.J. Tucker
2016-2017,Phoenix Suns,SF,57,17,1627,147,354,0.415,46,136,0.338,101,218,0.463,0.48,61,77,0.792,94,248,342,73,85,14,52,143,401,P.J. Tucker
2016-2017,Toronto Raptors,SF,24,4,609,52,128,0.406,24,60,0.4,28,68,0.412,0.5,11,16,0.688,23,106,129,26,31,5,14,53,139,P.J. Tucker
2017-2018,Houston Rockets,PF,82,34,2281,172,441,0.39,115,310,0.371,57,131,0.435,0.52,43,60,0.717,93,364,457,77,78,26,74,205,502,P.J. Tucker
2018-2019,Houston Rockets,PF,82,82,2802,207,523,0.396,146,387,0.377,61,136,0.449,0.535,41,59,0.695,121,358,479,96,132,39,63,252,601,P.J. Tucker
2019-2020,Houston Rockets,PF,72,72,2467,177,426,0.415,107,299,0.358,70,127,0.551,0.541,39,48,0.813,112,364,476,115,77,36,72,229,500,P.J. Tucker
2020-2021,Total,PF,52,33,1356,66,177,0.373,40,119,0.336,26,58,0.448,0.486,21,28,0.75,51,153,204,61,39,20,40,125,193,P.J. Tucker
2020-2021,Houston Rockets,PF,32,32,959,48,131,0.366,27,86,0.314,21,45,0.467,0.469,18,23,0.783,33,115,148,45,29,18,33,91,141,P.J. Tucker
2020-2021,Milwaukee Bucks,PF,20,1,397,18,46,0.391,13,33,0.394,5,13,0.385,0.533,3,5,0.6,18,38,56,16,10,2,7,34,52,P.J. Tucker
2021-2022,Miami Heat,PF,71,70,1981,207,428,0.484,80,193,0.415,127,235,0.54,0.577,45,61,0.738,100,287,387,149,58,15,66,161,539,P.J. Tucker
2022-2023,Philadelphia 76ers,PF,75,75,1920,96,225,0.427,55,140,0.393,41,85,0.482,0.549,19,23,0.826,95,200,295,60,39,15,44,180,266,P.J. Tucker
2023-2024,Total,PF,31,10,486,18,50,0.36,13,35,0.371,5,15,0.333,0.49,3,3,1,28,57,85,16,16,7,8,54,52,P.J. Tucker
2023-2024,Philadelphia 76ers,PF,3,3,66,2,5,0.4,2,5,0.4,0,0,,0.6,0,0,,1,13,14,0,3,2,2,9,6,P.J. Tucker
2023-2024,Los Angeles Clippers,PF,28,7,420,16,45,0.356,11,30,0.367,5,15,0.333,0.478,3,3,1,27,44,71,16,13,5,6,45,46,P.J. Tucker
2019-2020,Utah Jazz,SG,20,0,161,20,43,0.465,3,17,0.176,17,26,0.654,0.5,19,23,0.826,3,17,20,5,1,1,8,10,62,Rayjon Tucker
2020-2021,Philadelphia 76ers,PG,14,0,68,9,18,0.5,2,7,0.286,7,11,0.636,0.556,14,19,0.737,1,10,11,6,2,0,4,8,34,Rayjon Tucker
2021-2022,Total,SG,5,0,71,6,9,0.667,4,5,0.8,2,4,0.5,0.889,5,7,0.714,3,5,8,10,4,0,1,5,21,Rayjon Tucker
2021-2022,Denver Nuggets,SG,3,0,29,1,2,0.5,1,2,0.5,0,0,,0.75,3,4,0.75,1,3,4,4,1,0,0,3,6,Rayjon Tucker
2021-2022,Milwaukee Bucks,SG,2,0,42,5,7,0.714,3,3,1,2,4,0.5,0.929,2,3,0.667,2,2,4,6,3,0,1,2,15,Rayjon Tucker
2015-2016,Indiana Pacers,C,60,30,1367,264,530,0.498,3,14,0.214,261,516,0.506,0.501,88,121,0.727,68,264,332,41,25,86,67,158,619,Myles Turner
2016-2017,Indiana Pacers,C,81,81,2541,444,869,0.511,40,115,0.348,404,754,0.536,0.534,245,303,0.809,139,450,589,106,74,172,105,262,1173,Myles Turner
2017-2018,Indiana Pacers,C,65,62,1836,306,639,0.479,56,157,0.357,250,482,0.519,0.523,160,206,0.777,93,324,417,87,38,118,96,186,828,Myles Turner
2018-2019,Indiana Pacers,C,74,74,2119,380,780,0.487,76,196,0.388,304,584,0.521,0.536,148,201,0.736,101,430,531,115,60,199,100,195,984,Myles Turner
2019-2020,Indiana Pacers,C,62,62,1826,268,587,0.457,86,250,0.344,182,337,0.54,0.53,127,169,0.751,86,321,407,72,46,132,85,166,749,Myles Turner
2020-2021,Indiana Pacers,C,47,47,1455,206,432,0.477,69,206,0.335,137,226,0.606,0.557,111,142,0.782,63,243,306,48,40,159,67,165,592,Myles Turner
2021-2022,Indiana Pacers,C,42,42,1235,200,393,0.509,61,183,0.333,139,210,0.662,0.587,79,105,0.752,65,232,297,44,28,118,54,119,540,Myles Turner
2022-2023,Indiana Pacers,C,62,62,1825,402,733,0.548,93,249,0.373,309,484,0.638,0.612,216,276,0.783,88,378,466,89,36,140,103,215,1113,Myles Turner
2023-2024,Indiana Pacers,C,77,77,2076,476,909,0.524,116,324,0.358,360,585,0.615,0.587,245,317,0.773,113,420,533,100,39,144,109,232,1313,Myles Turner
2024-2025,Indiana Pacers,C,30,30,937,162,337,0.481,60,152,0.395,102,185,0.551,0.57,65,90,0.722,40,173,213,46,24,64,72,90,449,Myles Turner
2023-2024,Denver Nuggets,PF,18,0,48,8,20,0.4,4,14,0.286,4,6,0.667,0.5,0,0,,1,8,9,2,1,0,2,10,20,Hunter Tyson
2024-2025,Denver Nuggets,PF,19,0,179,18,39,0.462,8,22,0.364,10,17,0.588,0.564,13,15,0.867,8,28,36,9,4,3,8,22,57,Hunter Tyson
2024-2025,Cleveland Cavaliers,SG,18,1,141,17,36,0.472,4,13,0.308,13,23,0.565,0.528,4,8,0.5,12,17,29,13,5,0,9,23,42,Jaylon Tyson
2022-2023,Detroit Pistons,SG,1,0,2,0,1,0,0,1,0,0,0,,0,2,2,1,0,0,0,0,1,1,0,0,2,Stanley Umude
2023-2024,Detroit Pistons,SG,24,2,307,37,84,0.44,24,53,0.453,13,31,0.419,0.583,29,32,0.906,8,43,51,11,8,7,14,40,127,Stanley Umude
2024-2025,Milwaukee Bucks,SG,8,0,26,1,5,0.2,1,4,0.25,0,1,0,0.3,0,2,0,0,6,6,2,1,1,0,1,3,Stanley Umude
2012-2013,Toronto Raptors,C,62,57,1482,204,366,0.557,0,0,,204,366,0.557,0.557,146,185,0.789,121,251,372,45,17,78,94,188,554,Jonas Valančiūnas
2013-2014,Toronto Raptors,C,81,81,2282,359,676,0.531,0,1,0,359,675,0.532,0.531,198,260,0.762,226,488,714,57,24,71,136,249,916,Jonas Valančiūnas
2014-2015,Toronto Raptors,C,80,80,2096,373,652,0.572,0,1,0,373,651,0.573,0.572,217,276,0.786,215,478,693,39,33,95,109,222,963,Jonas Valančiūnas
2015-2016,Toronto Raptors,C,60,59,1557,303,536,0.565,0,0,,303,536,0.565,0.565,162,213,0.761,184,363,547,42,25,80,85,158,768,Jonas Valančiūnas
2016-2017,Toronto Raptors,C,80,80,2066,391,702,0.557,1,2,0.5,390,700,0.557,0.558,176,217,0.811,226,533,759,57,37,63,106,216,959,Jonas Valančiūnas
2017-2018,Toronto Raptors,C,77,77,1727,390,687,0.568,30,74,0.405,360,613,0.587,0.59,170,211,0.806,183,477,660,81,29,69,115,192,980,Jonas Valančiūnas
2018-2019,Total,C,49,27,1091,301,538,0.559,14,48,0.292,287,490,0.586,0.572,147,185,0.795,106,313,419,70,19,53,90,146,763,Jonas Valančiūnas
2018-2019,Toronto Raptors,C,30,10,564,149,259,0.575,9,30,0.3,140,229,0.611,0.593,77,94,0.819,54,162,216,29,13,23,39,82,384,Jonas Valančiūnas
2018-2019,Memphis Grizzlies,C,19,17,527,152,279,0.545,5,18,0.278,147,261,0.563,0.554,70,91,0.769,52,151,203,41,6,30,51,64,379,Jonas Valančiūnas
2019-2020,Memphis Grizzlies,C,70,70,1845,432,739,0.585,32,91,0.352,400,648,0.617,0.606,148,200,0.74,213,575,788,131,30,76,127,185,1044,Jonas Valančiūnas
2020-2021,Memphis Grizzlies,C,62,61,1755,440,743,0.592,21,57,0.368,419,686,0.611,0.606,157,203,0.773,253,523,776,112,35,57,100,179,1058,Jonas Valančiūnas
2021-2022,New Orleans Pelicans,C,74,74,2240,510,938,0.544,57,158,0.361,453,780,0.581,0.574,237,289,0.82,226,617,843,190,41,60,179,247,1314,Jonas Valančiūnas
2022-2023,New Orleans Pelicans,C,79,79,1968,446,816,0.547,38,109,0.349,408,707,0.577,0.57,185,224,0.826,225,579,804,140,20,52,159,245,1115,Jonas Valančiūnas
2023-2024,New Orleans Pelicans,C,82,82,1925,402,719,0.559,37,120,0.308,365,599,0.609,0.585,161,205,0.785,186,535,721,173,32,68,111,218,1002,Jonas Valančiūnas
2024-2025,Washington Wizards,C,28,7,556,132,239,0.552,2,17,0.118,130,222,0.586,0.556,60,65,0.923,64,161,225,63,13,22,49,45,326,Jonas Valančiūnas
2016-2017,Chicago Bulls,SG,57,0,976,102,288,0.354,73,208,0.351,29,80,0.363,0.481,14,18,0.778,11,140,151,63,30,7,49,86,291,Denzel Valentine
2017-2018,Chicago Bulls,SG,77,37,2095,301,721,0.417,143,370,0.386,158,351,0.45,0.517,38,51,0.745,48,345,393,244,65,11,99,185,783,Denzel Valentine
2019-2020,Chicago Bulls,SF,36,5,488,97,237,0.409,46,137,0.336,51,100,0.51,0.506,6,8,0.75,9,65,74,43,26,6,26,51,246,Denzel Valentine
2020-2021,Chicago Bulls,SG,62,3,1036,155,416,0.373,80,242,0.331,75,174,0.431,0.469,16,17,0.941,24,173,197,105,30,7,42,70,406,Denzel Valentine
2021-2022,Total,SG,24,0,222,25,66,0.379,19,47,0.404,6,19,0.316,0.523,0,0,,9,33,42,11,8,0,12,20,69,Denzel Valentine
2021-2022,Cleveland Cavaliers,SG,22,0,204,23,62,0.371,18,44,0.409,5,18,0.278,0.516,0,0,,9,29,38,11,7,0,10,17,64,Denzel Valentine
2021-2022,Utah Jazz,SG,2,0,18,2,4,0.5,1,3,0.333,1,1,1,0.625,0,0,,0,4,4,0,1,0,2,3,5,Denzel Valentine
2016-2017,Toronto Raptors,PG,37,0,294,39,111,0.351,11,29,0.379,28,82,0.341,0.401,18,22,0.818,4,38,42,35,16,3,15,36,107,Fred VanVleet
2017-2018,Toronto Raptors,PG,76,0,1520,232,545,0.426,108,261,0.414,124,284,0.437,0.525,84,101,0.832,25,159,184,243,68,19,74,130,656,Fred VanVleet
2018-2019,Toronto Raptors,PG,64,28,1760,246,600,0.41,112,296,0.378,134,304,0.441,0.503,97,115,0.843,21,146,167,307,57,20,82,110,701,Fred VanVleet
2019-2020,Toronto Raptors,SG,54,54,1928,319,773,0.413,146,374,0.39,173,399,0.434,0.507,168,198,0.848,18,185,203,357,100,17,121,132,952,Fred VanVleet
2020-2021,Toronto Raptors,SG,52,52,1899,338,870,0.389,174,476,0.366,164,394,0.416,0.489,169,191,0.885,32,188,220,328,87,37,95,119,1019,Fred VanVleet
2021-2022,Toronto Raptors,PG,65,65,2462,442,1097,0.403,242,642,0.377,200,455,0.44,0.513,194,222,0.874,44,245,289,434,111,35,170,162,1320,Fred VanVleet
2022-2023,Toronto Raptors,PG,69,69,2535,437,1112,0.393,207,606,0.342,230,506,0.455,0.486,254,283,0.898,30,250,280,495,123,38,140,193,1335,Fred VanVleet
2023-2024,Houston Rockets,PG,73,73,2684,423,1018,0.416,227,586,0.387,196,432,0.454,0.527,197,229,0.86,33,245,278,589,101,59,126,183,1270,Fred VanVleet
2024-2025,Houston Rockets,PG,29,29,1016,156,410,0.38,74,230,0.322,82,180,0.456,0.471,59,74,0.797,23,107,130,174,40,14,42,67,445,Fred VanVleet
2018-2019,Denver Nuggets,PF,17,0,69,9,19,0.474,0,1,0,9,18,0.5,0.474,6,10,0.6,7,16,23,3,6,1,8,8,24,Jarred Vanderbilt
2019-2020,Total,PF,11,0,46,5,8,0.625,0,1,0,5,7,0.714,0.625,2,2,1,3,6,9,2,3,1,7,6,12,Jarred Vanderbilt
2019-2020,Denver Nuggets,PF,9,0,41,5,7,0.714,0,0,,5,7,0.714,0.714,0,0,,3,5,8,2,3,1,7,6,10,Jarred Vanderbilt
2019-2020,Minnesota Timberwolves,PF,2,0,5,0,1,0,0,1,0,0,0,,0,2,2,1,0,1,1,0,0,0,0,0,2,Jarred Vanderbilt
2020-2021,Minnesota Timberwolves,PF,64,30,1139,143,236,0.606,1,5,0.2,142,231,0.615,0.608,57,102,0.559,118,250,368,76,64,46,53,123,344,Jarred Vanderbilt
2021-2022,Minnesota Timberwolves,PF,74,67,1880,212,361,0.587,2,14,0.143,210,347,0.605,0.59,86,131,0.656,215,409,624,94,99,46,73,181,512,Jarred Vanderbilt
2022-2023,Total,PF,78,65,1879,247,451,0.548,29,90,0.322,218,361,0.604,0.58,96,139,0.691,170,412,582,184,83,21,97,190,619,Jarred Vanderbilt
2022-2023,Utah Jazz,PF,52,41,1254,173,311,0.556,19,57,0.333,154,254,0.606,0.587,67,102,0.657,121,288,409,142,53,15,68,133,432,Jarred Vanderbilt
2022-2023,Los Angeles Lakers,PF,26,24,625,74,140,0.529,10,33,0.303,64,107,0.598,0.564,29,37,0.784,49,124,173,42,30,6,29,57,187,Jarred Vanderbilt
2023-2024,Los Angeles Lakers,PF,29,6,581,59,114,0.518,8,27,0.296,51,87,0.586,0.553,24,36,0.667,41,97,138,36,36,5,28,43,150,Jarred Vanderbilt
2020-2021,San Antonio Spurs,SF,62,7,1056,123,303,0.406,52,150,0.347,71,153,0.464,0.492,43,51,0.843,24,150,174,56,43,18,22,88,341,Devin Vassell
2021-2022,San Antonio Spurs,SF,71,32,1937,326,764,0.427,137,380,0.361,189,384,0.492,0.516,83,99,0.838,44,262,306,136,76,41,58,143,872,Devin Vassell
2022-2023,San Antonio Spurs,SG,38,32,1178,261,595,0.439,103,266,0.387,158,329,0.48,0.525,78,100,0.78,8,140,148,136,43,17,57,57,703,Devin Vassell
2023-2024,San Antonio Spurs,SG,68,62,2248,498,1056,0.472,166,446,0.372,332,610,0.544,0.55,161,201,0.801,27,234,261,277,73,23,108,74,1323,Devin Vassell
2024-2025,San Antonio Spurs,SG,16,5,434,91,202,0.45,35,90,0.389,56,112,0.5,0.537,29,35,0.829,11,34,45,44,17,7,26,31,246,Devin Vassell
2023-2024,Sacramento Kings,PF,42,0,511,84,191,0.44,45,120,0.375,39,71,0.549,0.558,12,15,0.8,30,66,96,19,20,7,12,42,225,Sasha Vezenkov
2019-2020,Miami Heat,PG,9,0,83,8,37,0.216,6,27,0.222,2,10,0.2,0.297,0,0,,0,5,5,6,5,0,1,6,22,Gabe Vincent
2020-2021,Miami Heat,PG,50,7,655,88,233,0.378,46,149,0.309,42,84,0.5,0.476,20,23,0.87,10,46,56,67,21,2,34,79,242,Gabe Vincent
2021-2022,Miami Heat,PG,68,27,1589,214,513,0.417,119,323,0.368,95,190,0.5,0.533,44,54,0.815,22,104,126,210,62,12,98,158,591,Gabe Vincent
2022-2023,Miami Heat,PG,68,34,1759,228,567,0.402,117,350,0.334,111,217,0.512,0.505,68,78,0.872,27,118,145,167,62,5,92,154,641,Gabe Vincent
2023-2024,Los Angeles Lakers,PG,11,0,218,15,49,0.306,3,28,0.107,12,21,0.571,0.337,1,2,0.5,4,5,9,21,9,0,5,19,34,Gabe Vincent
2024-2025,Los Angeles Lakers,PG,30,4,579,50,133,0.376,29,87,0.333,21,46,0.457,0.485,4,8,0.5,10,30,40,29,24,5,18,60,133,Gabe Vincent
2014-2015,Charlotte Hornets,PF,25,0,259,30,76,0.395,5,13,0.385,25,63,0.397,0.428,18,26,0.692,28,58,86,4,4,9,11,20,83,Noah Vonleh
2015-2016,Portland Trail Blazers,PF,78,56,1174,117,278,0.421,11,46,0.239,106,232,0.457,0.441,38,51,0.745,91,214,305,30,27,26,50,152,283,Noah Vonleh
2016-2017,Portland Trail Blazers,PF,74,41,1265,130,270,0.481,7,20,0.35,123,250,0.492,0.494,60,94,0.638,131,256,387,31,30,27,64,154,327,Noah Vonleh
2017-2018,Total,PF,54,16,875,104,234,0.444,20,66,0.303,84,168,0.5,0.487,36,58,0.621,70,241,311,34,19,17,31,68,264,Noah Vonleh
2017-2018,Portland Trail Blazers,PF,33,12,476,47,96,0.49,2,6,0.333,45,90,0.5,0.5,23,31,0.742,35,132,167,13,6,11,15,42,119,Noah Vonleh
2017-2018,Chicago Bulls,PF,21,4,399,57,138,0.413,18,60,0.3,39,78,0.5,0.478,13,27,0.481,35,109,144,21,13,6,16,26,145,Noah Vonleh
2018-2019,New York Knicks,PF,68,57,1722,207,440,0.47,46,137,0.336,161,303,0.531,0.523,111,156,0.712,113,415,528,129,46,51,88,174,571,Noah Vonleh
2019-2020,Total,C,36,1,377,52,92,0.565,3,15,0.2,49,77,0.636,0.582,25,32,0.781,37,87,124,28,11,6,21,40,132,Noah Vonleh
2019-2020,Minnesota Timberwolves,C,29,1,347,47,86,0.547,2,14,0.143,45,72,0.625,0.558,23,28,0.821,34,82,116,26,11,6,19,36,119,Noah Vonleh
2019-2020,Denver Nuggets,C,7,0,30,5,6,0.833,1,1,1,4,5,0.8,0.917,2,4,0.5,3,5,8,2,0,0,2,4,13,Noah Vonleh
2020-2021,Brooklyn Nets,C,4,0,11,0,3,0,0,2,0,0,1,0,0,0,0,,0,1,1,1,0,0,2,2,0,Noah Vonleh
2022-2023,Boston Celtics,C,23,1,171,11,24,0.458,1,4,0.25,10,20,0.5,0.479,2,2,1,18,30,48,7,2,8,11,35,25,Noah Vonleh
2011-2012,Philadelphia 76ers,C,51,15,812,131,291,0.45,3,8,0.375,128,283,0.452,0.455,18,34,0.529,88,158,246,31,20,34,33,111,283,Nikola Vučević
2012-2013,Orlando Magic,C,77,77,2559,461,889,0.519,0,3,0,461,886,0.52,0.519,86,126,0.683,273,644,917,143,61,79,141,218,1008,Nikola Vučević
2013-2014,Orlando Magic,C,57,57,1812,353,696,0.507,0,0,,353,696,0.507,0.507,105,137,0.766,185,441,626,104,60,47,112,169,811,Nikola Vučević
2014-2015,Orlando Magic,C,74,74,2529,631,1206,0.523,2,6,0.333,629,1200,0.524,0.524,164,218,0.752,238,572,810,147,54,54,148,220,1428,Nikola Vučević
2015-2016,Orlando Magic,C,65,60,2037,533,1046,0.51,2,9,0.222,531,1037,0.512,0.511,113,150,0.753,174,402,576,179,53,70,123,173,1181,Nikola Vučević
2016-2017,Orlando Magic,C,75,55,2163,483,1031,0.468,23,75,0.307,460,956,0.481,0.48,107,160,0.669,176,603,779,208,76,74,117,180,1096,Nikola Vučević
2017-2018,Orlando Magic,C,57,57,1683,399,840,0.475,64,204,0.314,335,636,0.527,0.513,77,94,0.819,101,422,523,191,56,62,109,144,939,Nikola Vučević
2018-2019,Orlando Magic,C,80,80,2510,701,1354,0.518,84,231,0.364,617,1123,0.549,0.549,179,227,0.789,224,736,960,307,81,89,159,157,1665,Nikola Vučević
2019-2020,Orlando Magic,C,62,62,1998,493,1033,0.477,98,289,0.339,395,744,0.531,0.525,131,167,0.784,140,533,673,222,54,47,88,135,1215,Nikola Vučević
2020-2021,Total,C,70,70,2348,666,1396,0.477,176,440,0.4,490,956,0.513,0.54,131,156,0.84,146,671,817,269,65,48,126,137,1639,Nikola Vučević
2020-2021,Orlando Magic,C,44,44,1500,436,908,0.48,117,288,0.406,319,620,0.515,0.545,91,110,0.827,87,430,517,167,42,28,83,79,1080,Nikola Vučević
2020-2021,Chicago Bulls,C,26,26,848,230,488,0.471,59,152,0.388,171,336,0.509,0.532,40,46,0.87,59,241,300,102,23,20,43,58,559,Nikola Vučević
2021-2022,Chicago Bulls,C,73,73,2418,546,1154,0.473,104,331,0.314,442,823,0.537,0.518,92,121,0.76,142,662,804,236,70,71,136,181,1288,Nikola Vučević
2022-2023,Chicago Bulls,C,82,82,2746,597,1148,0.52,121,347,0.349,476,801,0.594,0.573,132,158,0.835,159,744,903,265,60,57,139,179,1447,Nikola Vučević
2023-2024,Chicago Bulls,C,76,74,2610,586,1211,0.484,92,313,0.294,494,898,0.55,0.522,106,129,0.822,210,591,801,254,50,60,120,190,1370,Nikola Vučević
2024-2025,Chicago Bulls,C,30,30,957,250,430,0.581,62,136,0.456,188,294,0.639,0.653,58,68,0.853,62,231,293,96,24,22,50,70,620,Nikola Vučević
2023-2024,Washington Wizards,C,10,4,153,29,67,0.433,10,36,0.278,19,31,0.613,0.507,17,22,0.773,6,30,36,13,5,7,10,28,85,Tristan Vukcevic
2024-2025,Washington Wizards,C,1,0,3,0,2,0,0,2,0,0,0,,0,0,0,,0,0,0,0,0,1,0,0,0,Tristan Vukcevic
2019-2020,Cleveland Cavaliers,PF,12,0,71,9,13,0.692,2,4,0.5,7,9,0.778,0.769,0,1,0,3,16,19,2,2,4,3,8,20,Dean Wade
2020-2021,Cleveland Cavaliers,PF,63,19,1212,134,311,0.431,78,213,0.366,56,98,0.571,0.556,30,39,0.769,38,177,215,74,35,21,30,78,376,Dean Wade
2021-2022,Cleveland Cavaliers,PF,51,28,980,99,217,0.456,51,142,0.359,48,75,0.64,0.574,20,30,0.667,31,119,150,52,29,7,16,88,269,Dean Wade
2022-2023,Cleveland Cavaliers,PF,44,13,891,73,177,0.412,45,127,0.354,28,50,0.56,0.54,15,23,0.652,20,130,150,37,28,21,17,89,206,Dean Wade
2023-2024,Cleveland Cavaliers,PF,54,32,1108,96,232,0.414,79,202,0.391,17,30,0.567,0.584,20,26,0.769,37,181,218,43,40,25,20,93,291,Dean Wade
2024-2025,Cleveland Cavaliers,PF,22,13,489,43,109,0.394,34,94,0.362,9,15,0.6,0.55,11,23,0.478,18,86,104,34,23,10,6,32,131,Dean Wade
2021-2022,Orlando Magic,SF,79,79,2429,456,975,0.468,96,271,0.354,360,704,0.511,0.517,189,219,0.863,84,272,356,231,68,34,119,164,1197,Franz Wagner
2022-2023,Orlando Magic,SF,80,80,2609,542,1118,0.485,130,360,0.361,412,758,0.544,0.543,271,322,0.842,70,259,329,283,77,17,167,183,1485,Franz Wagner
2023-2024,Orlando Magic,SF,72,72,2337,528,1096,0.482,94,334,0.281,434,762,0.57,0.525,271,319,0.85,72,309,381,269,76,28,137,168,1421,Franz Wagner
2024-2025,Orlando Magic,SF,25,25,829,220,473,0.465,51,159,0.321,169,314,0.538,0.519,119,135,0.881,23,117,140,142,43,12,61,58,610,Franz Wagner
2018-2019,Los Angeles Lakers,C,43,5,446,71,171,0.415,22,77,0.286,49,94,0.521,0.48,43,53,0.811,17,68,85,24,11,13,39,57,207,Moritz Wagner
2019-2020,Washington Wizards,C,45,5,835,145,266,0.545,25,80,0.313,120,186,0.645,0.592,78,95,0.821,56,163,219,56,28,19,66,152,393,Moritz Wagner
2020-2021,Total,C,45,24,722,104,229,0.454,31,91,0.341,73,138,0.529,0.522,71,87,0.816,27,119,146,50,26,18,43,108,310,Moritz Wagner
2020-2021,Washington Wizards,C,25,13,375,62,122,0.508,13,42,0.31,49,80,0.613,0.561,41,52,0.788,13,60,73,32,22,8,21,62,178,Moritz Wagner
2020-2021,Boston Celtics,C,9,1,61,4,14,0.286,2,6,0.333,2,8,0.25,0.357,1,2,0.5,3,16,19,6,0,1,9,10,11,Moritz Wagner
2020-2021,Orlando Magic,C,11,10,286,38,93,0.409,16,43,0.372,22,50,0.44,0.495,29,33,0.879,11,43,54,12,4,9,13,36,121,Moritz Wagner
2021-2022,Orlando Magic,C,63,3,960,197,396,0.497,66,201,0.328,131,195,0.672,0.581,104,129,0.806,42,190,232,87,20,13,56,123,564,Moritz Wagner
2022-2023,Orlando Magic,C,57,18,1109,198,396,0.5,51,163,0.313,147,233,0.631,0.564,153,182,0.841,69,190,259,84,37,13,68,136,600,Moritz Wagner
2023-2024,Orlando Magic,C,80,1,1415,332,552,0.601,38,115,0.33,294,437,0.673,0.636,166,204,0.814,117,230,347,96,39,21,97,160,868,Moritz Wagner
2024-2025,Orlando Magic,C,30,1,564,140,249,0.562,27,75,0.36,113,174,0.649,0.616,79,110,0.718,40,108,148,42,24,12,49,55,386,Moritz Wagner
2021-2022,Phoenix Suns,PF,45,0,359,41,104,0.394,19,59,0.322,22,45,0.489,0.486,7,12,0.583,27,27,54,15,20,6,13,49,108,Ish Wainright
2022-2023,Phoenix Suns,SF,60,2,915,84,227,0.37,57,173,0.329,27,54,0.5,0.496,26,31,0.839,45,94,139,53,38,22,22,117,251,Ish Wainright
2023-2024,Total,SF,11,0,62,7,24,0.292,7,20,0.35,0,4,0,0.438,2,2,1,3,11,14,1,4,1,2,8,23,Ish Wainright
2023-2024,Portland Trail Blazers,SF,7,0,46,6,18,0.333,6,16,0.375,0,2,0,0.5,2,2,1,0,9,9,0,2,1,1,4,20,Ish Wainright
2023-2024,Phoenix Suns,SF,4,0,16,1,6,0.167,1,4,0.25,0,2,0,0.25,0,0,,3,2,5,1,2,0,1,4,3,Ish Wainright
2022-2023,Portland Trail Blazers,SF,56,0,619,83,198,0.419,16,56,0.286,67,142,0.472,0.46,34,45,0.756,48,83,131,34,10,13,29,69,216,Jabari Walker
2023-2024,Portland Trail Blazers,SF,72,23,1700,234,509,0.46,41,139,0.295,193,370,0.522,0.5,129,171,0.754,151,357,508,71,42,22,66,173,638,Jabari Walker
2024-2025,Portland Trail Blazers,SF,23,1,244,32,73,0.438,4,21,0.19,28,52,0.538,0.466,12,15,0.8,21,50,71,13,8,3,13,27,80,Jabari Walker
2023-2024,Indiana Pacers,PF,33,0,340,45,110,0.409,22,55,0.4,23,55,0.418,0.509,8,9,0.889,12,51,63,40,15,11,17,29,120,Jarace Walker
2024-2025,Indiana Pacers,PF,32,1,565,69,156,0.442,31,84,0.369,38,72,0.528,0.542,23,37,0.622,13,95,108,49,33,10,42,53,192,Jarace Walker
2018-2019,San Antonio Spurs,SG,17,0,118,16,46,0.348,5,13,0.385,11,33,0.333,0.402,8,10,0.8,0,17,17,9,7,3,4,7,45,Lonnie Walker IV
2019-2020,San Antonio Spurs,SG,61,12,988,152,357,0.426,41,101,0.406,111,256,0.434,0.483,44,61,0.721,23,116,139,68,32,14,44,78,389,Lonnie Walker IV
2020-2021,San Antonio Spurs,SG,60,38,1522,256,609,0.42,100,282,0.355,156,327,0.477,0.502,57,70,0.814,14,141,155,101,29,15,65,101,669,Lonnie Walker IV
2021-2022,San Antonio Spurs,SG,70,6,1612,311,764,0.407,111,353,0.314,200,411,0.487,0.48,116,148,0.784,18,163,181,152,44,19,71,98,849,Lonnie Walker IV
2022-2023,Los Angeles Lakers,SG,56,32,1297,236,527,0.448,91,249,0.365,145,278,0.522,0.534,91,106,0.858,14,95,109,64,30,17,46,71,654,Lonnie Walker IV
2023-2024,Brooklyn Nets,SG,58,0,1011,208,492,0.423,104,271,0.384,104,221,0.471,0.528,45,59,0.763,13,114,127,74,32,20,51,71,565,Lonnie Walker IV
2021-2022,Phoenix Suns,SG,2,0,8,0,4,0,0,2,0,0,2,0,0,0,0,0,1,1,1,2,0,0,1,0,0,M.J. Walker
2010-2011,Washington Wizards,PG,69,64,2606,398,972,0.409,34,115,0.296,364,857,0.425,0.427,301,393,0.766,35,282,317,574,121,35,261,175,1131,John Wall
2011-2012,Washington Wizards,PG,66,66,2386,378,894,0.423,3,42,0.071,375,852,0.44,0.424,317,402,0.789,48,252,300,530,95,57,255,137,1076,John Wall
2012-2013,Washington Wizards,PG,49,42,1602,324,735,0.441,12,45,0.267,312,690,0.452,0.449,246,306,0.804,35,161,196,373,65,37,157,117,906,John Wall
2013-2014,Washington Wizards,PG,82,82,2980,579,1337,0.433,108,308,0.351,471,1029,0.458,0.473,317,394,0.805,38,295,333,721,149,40,295,219,1583,John Wall
2014-2015,Washington Wizards,PG,79,79,2837,519,1166,0.445,65,217,0.3,454,949,0.478,0.473,284,362,0.785,36,330,366,792,138,45,304,180,1387,John Wall
2015-2016,Washington Wizards,PG,77,77,2784,572,1349,0.424,115,328,0.351,457,1021,0.448,0.467,272,344,0.791,42,337,379,789,145,59,318,159,1531,John Wall
2016-2017,Washington Wizards,PG,78,78,2836,647,1435,0.451,89,272,0.327,558,1163,0.48,0.482,422,527,0.801,59,267,326,831,157,49,322,151,1805,John Wall
2017-2018,Washington Wizards,PG,41,41,1410,280,667,0.42,62,167,0.371,218,500,0.436,0.466,175,241,0.726,22,128,150,393,57,45,158,80,797,John Wall
2018-2019,Washington Wizards,PG,32,32,1104,245,552,0.444,51,169,0.302,194,383,0.507,0.49,122,175,0.697,15,101,116,279,49,29,121,71,663,John Wall
2020-2021,Houston Rockets,PG,40,40,1288,293,726,0.404,79,249,0.317,214,477,0.449,0.458,158,211,0.749,17,112,129,275,42,31,141,46,823,John Wall
2022-2023,Los Angeles Clippers,PG,34,3,755,138,338,0.408,33,109,0.303,105,229,0.459,0.457,77,113,0.681,14,78,92,178,27,12,80,59,386,John Wall
2023-2024,Oklahoma City Thunder,SG,82,13,1692,217,442,0.491,98,234,0.419,119,208,0.572,0.602,29,37,0.784,52,135,187,120,76,37,45,129,561,Cason Wallace
2024-2025,Oklahoma City Thunder,SG,29,17,769,79,186,0.425,27,90,0.3,52,96,0.542,0.497,6,7,0.857,35,67,102,64,48,23,17,60,191,Cason Wallace
2024-2025,Atlanta Hawks,PG,14,1,219,24,59,0.407,9,29,0.31,15,30,0.5,0.483,4,4,1,2,17,19,26,10,6,16,13,61,Keaton Wallace
2023-2024,Boston Celtics,SF,9,1,83,6,15,0.4,2,9,0.222,4,6,0.667,0.467,1,2,0.5,5,15,20,5,5,1,3,11,15,Jordan Walsh
2024-2025,Boston Celtics,PF,22,1,182,12,36,0.333,7,28,0.25,5,8,0.625,0.431,4,6,0.667,10,17,27,6,5,7,5,13,35,Jordan Walsh
2024-2025,Toronto Raptors,SG,16,6,328,52,131,0.397,17,61,0.279,35,70,0.5,0.462,21,29,0.724,16,32,48,25,9,5,15,38,142,Ja'Kobe Walter
2024-2025,Miami Heat,C,13,0,113,19,39,0.487,3,10,0.3,16,29,0.552,0.526,2,2,1,6,24,30,2,5,8,6,11,43,Kel'el Ware
2014-2015,Phoenix Suns,SF,40,1,614,113,214,0.528,5,21,0.238,108,193,0.56,0.54,14,19,0.737,41,44,85,25,18,9,27,51,245,T.J. Warren
2015-2016,Phoenix Suns,SF,47,4,1070,221,441,0.501,28,70,0.4,193,371,0.52,0.533,45,64,0.703,57,90,147,44,37,16,32,94,515,T.J. Warren
2016-2017,Phoenix Suns,SF,66,59,2048,403,814,0.495,26,98,0.265,377,716,0.527,0.511,119,154,0.773,125,214,339,75,76,39,57,175,951,T.J. Warren
2017-2018,Phoenix Suns,SF,65,65,2142,529,1063,0.498,20,90,0.222,509,973,0.523,0.507,193,255,0.757,125,208,333,85,65,41,85,149,1271,T.J. Warren
2018-2019,Phoenix Suns,SF,43,36,1360,297,611,0.486,77,180,0.428,220,431,0.51,0.549,101,124,0.815,31,143,174,64,51,29,52,119,772,T.J. Warren
2019-2020,Indiana Pacers,SF,67,67,2202,534,997,0.536,91,226,0.403,443,771,0.575,0.581,167,204,0.819,68,212,280,99,78,34,84,187,1326,T.J. Warren
2020-2021,Indiana Pacers,SF,4,4,117,27,51,0.529,0,7,0,27,44,0.614,0.529,8,10,0.8,2,12,14,5,2,0,4,16,62,T.J. Warren
2022-2023,Total,PF,42,0,687,132,270,0.489,22,67,0.328,110,203,0.542,0.53,28,35,0.8,26,95,121,40,22,12,20,65,314,T.J. Warren
2022-2023,Brooklyn Nets,PF,26,0,490,102,200,0.51,16,48,0.333,86,152,0.566,0.55,27,33,0.818,13,59,72,29,15,7,17,45,247,T.J. Warren
2022-2023,Phoenix Suns,SF,16,0,197,30,70,0.429,6,19,0.316,24,51,0.471,0.471,1,2,0.5,13,36,49,11,7,5,3,20,67,T.J. Warren
2023-2024,Minnesota Timberwolves,SF,11,0,125,18,41,0.439,2,13,0.154,16,28,0.571,0.463,3,4,0.75,5,17,22,9,4,1,4,11,41,T.J. Warren
2021-2022,Indiana Pacers,PG,48,7,968,173,427,0.405,81,215,0.377,92,212,0.434,0.5,46,61,0.754,4,79,83,85,26,3,57,66,473,Duane Washington Jr.
2022-2023,Phoenix Suns,SG,31,3,394,94,256,0.367,40,111,0.36,54,145,0.372,0.445,16,24,0.667,2,34,36,63,6,4,34,23,244,Duane Washington Jr.
2019-2020,Charlotte Hornets,PF,58,57,1759,268,589,0.455,86,230,0.374,182,359,0.507,0.528,88,136,0.647,58,258,316,123,51,44,93,158,710,P.J. Washington
2020-2021,Charlotte Hornets,PF,64,61,1954,302,686,0.44,112,290,0.386,190,396,0.48,0.522,108,145,0.745,93,325,418,161,69,79,128,171,824,P.J. Washington
2021-2022,Charlotte Hornets,C,65,28,1768,250,532,0.47,110,301,0.365,140,231,0.606,0.573,58,81,0.716,82,255,337,147,57,61,82,152,668,P.J. Washington
2022-2023,Charlotte Hornets,PF,73,73,2380,434,978,0.444,149,428,0.348,285,550,0.518,0.52,127,174,0.73,73,285,358,175,66,79,110,193,1144,P.J. Washington
2023-2024,Total,PF,73,45,2221,354,811,0.436,132,413,0.32,222,398,0.558,0.518,99,145,0.683,85,326,411,141,72,59,96,169,939,P.J. Washington
2023-2024,Charlotte Hornets,PF,44,17,1286,227,509,0.446,79,244,0.324,148,265,0.558,0.524,67,94,0.713,53,179,232,97,38,32,66,112,600,P.J. Washington
2023-2024,Dallas Mavericks,PF,29,28,935,127,302,0.421,53,169,0.314,74,133,0.556,0.508,32,51,0.627,32,147,179,44,34,27,30,57,339,P.J. Washington
2024-2025,Dallas Mavericks,PF,25,24,809,111,247,0.449,39,99,0.394,72,148,0.486,0.528,43,58,0.741,37,155,192,55,31,27,44,51,304,P.J. Washington
2022-2023,Houston Rockets,PG,31,2,433,58,160,0.363,19,80,0.238,39,80,0.488,0.422,10,18,0.556,2,43,45,47,15,2,14,29,145,TyTy Washington Jr.
2023-2024,Milwaukee Bucks,PG,11,0,56,6,20,0.3,2,6,0.333,4,14,0.286,0.35,0,0,,1,4,5,5,3,0,2,1,14,TyTy Washington Jr.
2024-2025,Phoenix Suns,PG,3,0,27,3,6,0.5,2,3,0.667,1,3,0.333,0.667,0,0,,0,1,1,4,2,0,1,0,8,TyTy Washington Jr.
2018-2019,Memphis Grizzlies,SF,15,0,174,15,51,0.294,2,16,0.125,13,35,0.371,0.314,7,10,0.7,4,27,31,8,4,1,6,11,39,Yuta Watanabe
2019-2020,Memphis Grizzlies,SF,18,0,105,15,34,0.441,3,8,0.375,12,26,0.462,0.485,3,8,0.375,7,13,20,5,5,1,2,9,36,Yuta Watanabe
2020-2021,Toronto Raptors,SF,50,4,723,79,180,0.439,36,90,0.4,43,90,0.478,0.539,24,29,0.828,36,123,159,40,26,19,19,57,218,Yuta Watanabe
2021-2022,Toronto Raptors,SF,38,4,445,56,138,0.406,27,79,0.342,29,59,0.492,0.504,24,40,0.6,18,74,92,21,11,16,19,38,163,Yuta Watanabe
2022-2023,Brooklyn Nets,SF,58,1,928,114,232,0.491,60,135,0.444,54,97,0.557,0.621,34,47,0.723,30,111,141,48,25,17,22,80,322,Yuta Watanabe
2023-2024,Total,SF,34,0,464,41,116,0.353,25,85,0.294,16,31,0.516,0.461,10,17,0.588,11,43,54,15,12,7,19,39,117,Yuta Watanabe
2023-2024,Phoenix Suns,SF,29,0,382,35,97,0.361,24,75,0.32,11,22,0.5,0.485,10,15,0.667,11,34,45,10,9,7,16,34,104,Yuta Watanabe
2023-2024,Memphis Grizzlies,SF,5,0,82,6,19,0.316,1,10,0.1,5,9,0.556,0.342,0,2,0,0,9,9,5,3,0,3,5,13,Yuta Watanabe
2021-2022,Oklahoma City Thunder,SG,25,1,465,71,175,0.406,53,146,0.363,18,29,0.621,0.557,4,5,0.8,6,67,73,24,19,8,11,31,199,Lindy Waters III
2022-2023,Oklahoma City Thunder,SG,41,0,531,70,178,0.393,58,162,0.358,12,16,0.75,0.556,16,20,0.8,16,59,75,28,14,11,10,42,214,Lindy Waters III
2023-2024,Oklahoma City Thunder,SG,38,0,280,49,104,0.471,37,85,0.435,12,19,0.632,0.649,2,2,1,7,33,40,24,5,7,7,23,137,Lindy Waters III
2024-2025,Golden State Warriors,SG,23,8,411,47,129,0.364,31,93,0.333,16,36,0.444,0.484,4,5,0.8,11,48,59,31,17,5,8,37,129,Lindy Waters III
2019-2020,Boston Celtics,PG,11,1,119,14,49,0.286,4,24,0.167,10,25,0.4,0.327,8,8,1,0,12,12,16,10,2,15,13,40,Tremont Waters
2020-2021,Boston Celtics,PG,26,3,238,34,84,0.405,15,38,0.395,19,46,0.413,0.494,16,17,0.941,5,16,21,62,15,1,27,17,99,Tremont Waters
2021-2022,Total,PG,3,0,50,4,14,0.286,2,9,0.222,2,5,0.4,0.357,0,0,,0,4,4,7,5,0,4,4,10,Tremont Waters
2021-2022,Toronto Raptors,PG,2,0,42,3,12,0.25,2,9,0.222,1,3,0.333,0.333,0,0,,0,4,4,7,4,0,4,2,8,Tremont Waters
2021-2022,Washington Wizards,PG,1,0,8,1,2,0.5,0,0,,1,2,0.5,0.5,0,0,,0,0,0,0,1,0,0,2,2,Tremont Waters
2021-2022,Portland Trail Blazers,SF,48,10,869,142,267,0.532,9,38,0.237,133,229,0.581,0.549,71,94,0.755,57,142,199,81,25,28,44,116,364,Trendon Watford
2022-2023,Portland Trail Blazers,PF,62,12,1182,181,323,0.56,25,64,0.391,156,259,0.602,0.599,72,100,0.72,42,196,238,130,32,12,71,118,459,Trendon Watford
2023-2024,Brooklyn Nets,PF,63,2,856,164,311,0.527,27,68,0.397,137,243,0.564,0.571,77,97,0.794,52,142,194,81,23,19,63,106,432,Trendon Watford
2024-2025,Brooklyn Nets,PF,13,0,209,35,79,0.443,8,26,0.308,27,53,0.509,0.494,30,35,0.857,4,32,36,15,5,4,16,30,108,Trendon Watford
2022-2023,Denver Nuggets,SG,23,2,186,29,59,0.492,6,14,0.429,23,45,0.511,0.542,11,20,0.55,8,29,37,11,2,11,8,14,75,Peyton Watson
2023-2024,Denver Nuggets,SF,80,4,1488,208,447,0.465,45,152,0.296,163,295,0.553,0.516,71,106,0.67,56,202,258,86,42,88,58,143,532,Peyton Watson
2024-2025,Denver Nuggets,SF,29,12,696,92,187,0.492,22,61,0.361,70,126,0.556,0.551,49,63,0.778,30,68,98,40,22,27,23,58,255,Peyton Watson
2019-2020,San Antonio Spurs,SG,11,0,78,5,17,0.294,1,5,0.2,4,12,0.333,0.324,1,2,0.5,1,6,7,11,3,1,5,8,12,Quinndary Weatherspoon
2020-2021,San Antonio Spurs,SG,20,0,121,16,35,0.457,1,6,0.167,15,29,0.517,0.471,13,16,0.813,3,8,11,8,8,2,10,18,46,Quinndary Weatherspoon
2021-2022,Golden State Warriors,SG,11,0,73,12,21,0.571,1,5,0.2,11,16,0.688,0.595,5,5,1,2,12,14,5,1,1,3,15,30,Quinndary Weatherspoon
2024-2025,Memphis Grizzlies,SG,32,27,793,133,289,0.46,59,151,0.391,74,138,0.536,0.562,43,53,0.811,30,71,101,54,15,5,37,57,368,Jaylen Wells
2018-2019,Denver Nuggets,C,11,0,36,7,13,0.538,3,7,0.429,4,6,0.667,0.654,1,2,0.5,0,4,4,5,0,0,1,3,18,Thomas Welsh
2023-2024,San Antonio Spurs,C,71,71,2106,551,1186,0.465,128,394,0.325,423,792,0.534,0.519,292,367,0.796,161,594,755,274,88,254,260,153,1522,Victor Wembanyama
2024-2025,San Antonio Spurs,C,26,26,858,234,487,0.48,88,244,0.361,146,243,0.601,0.571,99,112,0.884,48,215,263,101,27,105,93,54,655,Victor Wembanyama
2022-2023,San Antonio Spurs,SG,37,1,669,69,215,0.321,20,52,0.385,49,163,0.301,0.367,26,44,0.591,12,69,81,98,25,5,65,67,184,Blake Wesley
2023-2024,San Antonio Spurs,SG,61,3,876,102,215,0.474,12,55,0.218,90,160,0.563,0.502,52,78,0.667,18,76,94,166,29,9,55,89,268,Blake Wesley
2024-2025,San Antonio Spurs,SG,22,0,250,34,75,0.453,4,20,0.2,30,55,0.545,0.48,15,21,0.714,6,13,19,42,9,2,22,14,87,Blake Wesley
2008-2009,Oklahoma City Thunder,PG,82,65,2668,436,1095,0.398,35,129,0.271,401,966,0.415,0.414,349,428,0.815,178,221,399,435,110,16,274,191,1256,Russell Westbrook
2009-2010,Oklahoma City Thunder,PG,82,82,2813,485,1160,0.418,23,104,0.221,462,1056,0.438,0.428,329,422,0.78,143,258,401,652,108,34,268,204,1322,Russell Westbrook
2010-2011,Oklahoma City Thunder,PG,82,82,2847,614,1390,0.442,34,103,0.33,580,1287,0.451,0.454,531,631,0.842,121,258,379,670,155,30,316,207,1793,Russell Westbrook
2011-2012,Oklahoma City Thunder,PG,66,66,2331,578,1266,0.457,62,196,0.316,516,1070,0.482,0.481,340,413,0.823,96,205,301,362,112,21,239,147,1558,Russell Westbrook
2012-2013,Oklahoma City Thunder,PG,82,82,2861,673,1535,0.438,97,300,0.323,576,1235,0.466,0.47,460,575,0.8,111,317,428,607,145,24,273,189,1903,Russell Westbrook
2013-2014,Oklahoma City Thunder,PG,46,46,1412,346,791,0.437,68,214,0.318,278,577,0.482,0.48,242,293,0.826,55,208,263,319,88,7,177,104,1002,Russell Westbrook
2014-2015,Oklahoma City Thunder,PG,67,67,2302,627,1471,0.426,86,288,0.299,541,1183,0.457,0.455,546,654,0.835,124,364,488,574,140,14,293,184,1886,Russell Westbrook
2015-2016,Oklahoma City Thunder,PG,80,80,2750,656,1444,0.454,101,341,0.296,555,1103,0.503,0.489,465,573,0.812,145,481,626,834,163,20,342,200,1878,Russell Westbrook
2016-2017,Oklahoma City Thunder,PG,81,81,2802,824,1941,0.425,200,583,0.343,624,1358,0.459,0.476,710,840,0.845,137,727,864,840,132,31,438,190,2558,Russell Westbrook
2017-2018,Oklahoma City Thunder,PG,80,80,2914,757,1687,0.449,97,326,0.298,660,1361,0.485,0.477,417,566,0.737,152,652,804,820,147,20,381,200,2028,Russell Westbrook
2018-2019,Oklahoma City Thunder,PG,73,73,2630,630,1473,0.428,119,411,0.29,511,1062,0.481,0.468,296,451,0.656,109,698,807,784,142,33,325,245,1675,Russell Westbrook
2019-2020,Houston Rockets,PG,57,57,2049,604,1281,0.472,55,213,0.258,549,1068,0.514,0.493,290,380,0.763,100,351,451,401,93,20,255,200,1553,Russell Westbrook
2020-2021,Washington Wizards,PG,65,65,2369,544,1238,0.439,86,273,0.315,458,965,0.475,0.474,271,413,0.656,109,641,750,763,89,23,312,190,1445,Russell Westbrook
2021-2022,Los Angeles Lakers,PG,78,78,2678,548,1233,0.444,79,265,0.298,469,968,0.485,0.476,266,399,0.667,110,470,580,550,75,20,295,235,1441,Russell Westbrook
2022-2023,Total,PG,73,24,2126,432,991,0.436,89,286,0.311,343,705,0.487,0.481,206,314,0.656,89,334,423,551,76,33,255,162,1159,Russell Westbrook
2022-2023,Los Angeles Lakers,PG,52,3,1491,304,729,0.417,63,213,0.296,241,516,0.467,0.46,156,238,0.655,59,262,321,391,53,23,184,121,827,Russell Westbrook
2022-2023,Los Angeles Clippers,PG,21,21,635,128,262,0.489,26,73,0.356,102,189,0.54,0.538,50,76,0.658,30,72,102,160,23,10,71,41,332,Russell Westbrook
2023-2024,Los Angeles Clippers,PG,68,11,1529,301,663,0.454,42,154,0.273,259,509,0.509,0.486,110,160,0.688,93,250,343,306,74,23,144,121,754,Russell Westbrook
2024-2025,Denver Nuggets,PG,29,8,755,128,298,0.43,34,108,0.315,94,190,0.495,0.487,61,99,0.616,29,93,122,183,48,17,79,72,351,Russell Westbrook
2019-2020,Chicago Bulls,PG,65,1,1674,312,792,0.394,133,376,0.354,179,416,0.43,0.478,102,129,0.791,28,202,230,175,49,6,109,117,859,Coby White
2020-2021,Chicago Bulls,PG,69,54,2156,375,902,0.416,163,454,0.359,212,448,0.473,0.506,128,142,0.901,28,256,284,328,38,15,156,179,1041,Coby White
2021-2022,Chicago Bulls,PG,61,17,1675,279,644,0.433,136,353,0.385,143,291,0.491,0.539,78,91,0.857,17,165,182,176,29,11,70,137,772,Coby White
2022-2023,Chicago Bulls,SG,74,2,1730,263,594,0.443,128,344,0.372,135,250,0.54,0.551,61,70,0.871,16,196,212,204,54,6,74,122,715,Coby White
2023-2024,Chicago Bulls,PG,79,78,2881,541,1209,0.447,209,556,0.376,332,653,0.508,0.534,218,260,0.838,44,314,358,405,53,18,166,186,1509,Coby White
2024-2025,Chicago Bulls,SG,29,29,944,171,407,0.42,91,248,0.367,80,159,0.503,0.532,79,90,0.878,11,88,99,131,33,5,70,73,512,Coby White
2017-2018,San Antonio Spurs,PG,17,0,139,16,33,0.485,8,13,0.615,8,20,0.4,0.606,14,20,0.7,5,21,26,9,4,3,6,8,54,Derrick White
2018-2019,San Antonio Spurs,PG,67,55,1728,260,543,0.479,48,142,0.338,212,401,0.529,0.523,95,123,0.772,35,212,247,263,67,47,97,145,663,Derrick White
2019-2020,San Antonio Spurs,SG,68,20,1677,253,552,0.458,79,216,0.366,174,336,0.518,0.53,180,211,0.853,35,188,223,241,44,59,89,152,765,Derrick White
2020-2021,San Antonio Spurs,SG,36,32,1064,186,453,0.411,84,243,0.346,102,210,0.486,0.503,97,114,0.851,13,94,107,127,26,36,45,91,553,Derrick White
2021-2022,Total,SG,75,52,2199,337,800,0.421,115,369,0.312,222,431,0.515,0.493,203,235,0.864,38,223,261,366,64,58,119,172,992,Derrick White
2021-2022,San Antonio Spurs,SG,49,48,1486,243,570,0.426,81,258,0.314,162,312,0.519,0.497,139,160,0.869,25,148,173,274,49,42,87,116,706,Derrick White
2021-2022,Boston Celtics,SG,26,4,713,94,230,0.409,34,111,0.306,60,119,0.504,0.483,64,75,0.853,13,75,88,92,15,16,32,56,286,Derrick White
2022-2023,Boston Celtics,SG,82,70,2319,350,758,0.462,149,391,0.381,201,367,0.548,0.56,168,192,0.875,52,241,293,321,54,76,95,177,1017,Derrick White
2023-2024,Boston Celtics,SG,73,73,2381,387,839,0.461,196,495,0.396,191,344,0.555,0.578,137,152,0.901,51,259,310,377,74,87,112,152,1107,Derrick White
2024-2025,Boston Celtics,SG,30,30,1027,172,386,0.446,106,272,0.39,66,114,0.579,0.583,56,66,0.848,30,111,141,141,31,32,51,63,506,Derrick White
2022-2023,Denver Nuggets,SF,17,0,66,8,19,0.421,3,9,0.333,5,10,0.5,0.5,2,3,0.667,6,11,17,4,3,2,2,9,21,Jack White
2023-2024,Memphis Grizzlies,SF,4,0,64,2,16,0.125,2,10,0.2,0,6,0,0.188,0,0,,4,8,12,1,4,1,2,3,6,Jack White
2016-2017,Miami Heat,PF,35,0,471,33,87,0.379,12,34,0.353,21,53,0.396,0.448,20,22,0.909,25,57,82,21,10,10,18,52,98,Okaro White
2017-2018,Miami Heat,PF,6,4,80,7,16,0.438,4,11,0.364,3,5,0.6,0.563,2,3,0.667,3,8,11,2,1,1,1,6,20,Okaro White
2018-2019,Washington Wizards,PF,3,0,6,0,2,0,0,2,0,0,0,,0,0,0,,1,1,2,0,0,0,0,0,0,Okaro White
2023-2024,Houston Rockets,SF,47,2,880,212,467,0.454,79,220,0.359,133,247,0.538,0.539,76,112,0.679,44,136,180,33,30,17,46,64,579,Cam Whitmore
2024-2025,Houston Rockets,SF,13,0,163,42,97,0.433,9,42,0.214,33,55,0.6,0.479,17,24,0.708,10,21,31,7,5,2,8,11,110,Cam Whitmore
2021-2022,San Antonio Spurs,SG,29,0,205,20,56,0.357,14,43,0.326,6,13,0.462,0.482,7,13,0.538,4,10,14,9,4,3,2,14,61,Joe Wieskamp
2022-2023,Toronto Raptors,SF,9,0,50,3,14,0.214,3,12,0.25,0,2,0,0.321,0,0,,0,4,4,3,0,0,1,3,9,Joe Wieskamp
2021-2022,Oklahoma City Thunder,SG,50,35,1209,156,337,0.463,42,138,0.304,114,199,0.573,0.525,62,85,0.729,51,127,178,68,30,10,54,93,416,Aaron Wiggins
2022-2023,Oklahoma City Thunder,SG,70,14,1297,186,363,0.512,48,122,0.393,138,241,0.573,0.579,59,71,0.831,68,142,210,80,39,15,55,110,479,Aaron Wiggins
2023-2024,Oklahoma City Thunder,SG,78,4,1228,212,377,0.562,62,126,0.492,150,251,0.598,0.645,56,71,0.789,60,126,186,86,56,19,56,91,542,Aaron Wiggins
2024-2025,Oklahoma City Thunder,SG,29,8,562,95,215,0.442,39,102,0.382,56,113,0.496,0.533,15,19,0.789,24,67,91,40,24,8,24,36,244,Aaron Wiggins
2014-2015,Minnesota Timberwolves,SF,82,82,2969,497,1137,0.437,39,126,0.31,458,1011,0.453,0.454,354,466,0.76,134,240,374,170,86,50,177,190,1387,Andrew Wiggins
2015-2016,Minnesota Timberwolves,SF,81,81,2845,594,1294,0.459,57,190,0.3,537,1104,0.486,0.481,430,565,0.761,105,186,291,164,78,46,182,165,1675,Andrew Wiggins
2016-2017,Minnesota Timberwolves,SF,82,82,3048,709,1570,0.452,103,289,0.356,606,1281,0.473,0.484,412,542,0.76,102,226,328,189,82,30,187,183,1933,Andrew Wiggins
2017-2018,Minnesota Timberwolves,SF,82,82,2979,569,1300,0.438,112,338,0.331,457,962,0.475,0.481,202,314,0.643,82,276,358,160,91,51,138,163,1452,Andrew Wiggins
2018-2019,Minnesota Timberwolves,SF,73,73,2543,498,1209,0.412,118,348,0.339,380,861,0.441,0.461,207,296,0.699,83,269,352,184,70,48,138,153,1321,Andrew Wiggins
2019-2020,Total,SF,54,54,1858,437,978,0.447,111,334,0.332,326,644,0.506,0.504,190,268,0.709,66,208,274,198,45,53,132,127,1175,Andrew Wiggins
2019-2020,Minnesota Timberwolves,SF,42,42,1455,351,790,0.444,91,275,0.331,260,515,0.505,0.502,149,207,0.72,48,171,219,155,29,36,107,101,942,Andrew Wiggins
2019-2020,Golden State Warriors,SF,12,12,403,86,188,0.457,20,59,0.339,66,129,0.512,0.511,41,61,0.672,18,37,55,43,16,17,25,26,233,Andrew Wiggins
2020-2021,Golden State Warriors,PF,71,71,2364,505,1058,0.477,140,368,0.38,365,690,0.529,0.543,170,238,0.714,82,265,347,167,67,70,126,159,1320,Andrew Wiggins
2021-2022,Golden State Warriors,SF,73,73,2330,475,1019,0.466,157,399,0.393,318,620,0.513,0.543,149,235,0.634,85,240,325,161,76,51,111,158,1256,Andrew Wiggins
2022-2023,Golden State Warriors,SF,37,37,1190,250,529,0.473,89,225,0.396,161,304,0.53,0.557,44,72,0.611,61,125,186,85,45,28,48,107,633,Andrew Wiggins
2023-2024,Golden State Warriors,SF,71,59,1920,353,780,0.453,91,254,0.358,262,526,0.498,0.511,142,189,0.751,108,213,321,119,42,41,87,147,939,Andrew Wiggins
2024-2025,Golden State Warriors,SF,26,26,748,153,340,0.45,59,139,0.424,94,201,0.468,0.537,77,98,0.786,42,70,112,60,23,20,30,44,442,Andrew Wiggins
2021-2022,Milwaukee Bucks,PG,19,0,199,26,61,0.426,9,26,0.346,17,35,0.486,0.5,19,35,0.543,3,22,25,23,5,1,12,17,80,Lindell Wigginton
2022-2023,Milwaukee Bucks,PG,7,1,87,18,37,0.486,6,18,0.333,12,19,0.632,0.568,8,9,0.889,0,7,7,14,0,2,12,7,50,Lindell Wigginton
2023-2024,Milwaukee Bucks,PG,3,0,8,2,5,0.4,0,2,0,2,3,0.667,0.4,2,2,1,0,0,0,0,0,0,1,1,6,Lindell Wigginton
2022-2023,Brooklyn Nets,SG,1,0,5,0,0,,0,0,,0,0,,,0,0,,0,1,1,0,0,0,2,1,0,Alondes Williams
2023-2024,Miami Heat,SG,7,0,16,2,8,0.25,0,4,0,2,4,0.5,0.25,1,1,1,0,1,1,0,0,1,2,2,5,Alondes Williams
2024-2025,Detroit Pistons,SG,1,0,4,2,2,1,1,1,1,1,1,1,1.25,0,0,,0,0,0,1,0,0,0,0,5,Alondes Williams
2021-2022,Portland Trail Blazers,PG,24,16,640,105,282,0.372,31,106,0.292,74,176,0.42,0.427,68,97,0.701,19,55,74,94,24,10,58,52,309,Brandon Williams
2023-2024,Dallas Mavericks,PG,17,0,113,20,54,0.37,3,15,0.2,17,39,0.436,0.398,11,17,0.647,4,9,13,17,1,1,7,4,54,Brandon Williams
2024-2025,Dallas Mavericks,PG,5,0,21,2,9,0.222,0,2,0,2,7,0.286,0.222,2,3,0.667,1,3,4,2,0,0,2,2,6,Brandon Williams
2024-2025,Utah Jazz,SG,17,7,324,20,70,0.286,8,38,0.211,12,32,0.375,0.343,6,10,0.6,9,29,38,20,7,6,12,24,54,Cody Williams
2022-2023,Atlanta Hawks,SG,2,0,4,2,5,0.4,0,2,0,2,3,0.667,0.4,0,0,0,2,2,0,0,0,0,0,4,0,Donovan Williams
2019-2020,Boston Celtics,PF,69,5,1043,87,211,0.412,24,96,0.25,63,115,0.548,0.469,39,54,0.722,59,119,178,68,30,36,50,163,237,Grant Williams
2020-2021,Boston Celtics,PF,63,9,1138,108,247,0.437,48,129,0.372,60,118,0.508,0.534,30,51,0.588,48,130,178,64,32,24,56,161,294,Grant Williams
2021-2022,Boston Celtics,PF,77,21,1875,205,432,0.475,106,258,0.411,99,174,0.569,0.597,86,95,0.905,64,210,274,78,38,57,62,186,602,Grant Williams
2022-2023,Boston Celtics,PF,79,23,2045,216,476,0.454,115,291,0.395,101,185,0.546,0.575,94,122,0.77,87,276,363,131,41,31,82,192,641,Grant Williams
2023-2024,Total,PF,76,43,2130,276,605,0.456,126,336,0.375,150,269,0.558,0.56,106,140,0.757,86,232,318,174,44,39,109,226,784,Grant Williams
2023-2024,Dallas Mavericks,PF,47,33,1242,131,317,0.413,79,210,0.376,52,107,0.486,0.538,41,55,0.745,46,123,169,81,24,27,53,137,382,Grant Williams
2023-2024,Charlotte Hornets,PF,29,10,888,145,288,0.503,47,126,0.373,98,162,0.605,0.585,65,85,0.765,40,109,149,93,20,12,56,89,402,Grant Williams
2024-2025,Charlotte Hornets,PF,16,7,479,54,123,0.439,27,74,0.365,27,49,0.551,0.549,31,37,0.838,18,64,82,37,18,13,28,46,166,Grant Williams
2022-2023,Oklahoma City Thunder,SG,75,62,2276,414,794,0.521,73,205,0.356,341,589,0.579,0.567,155,191,0.812,84,253,337,248,103,35,123,191,1056,Jalen Williams
2023-2024,Oklahoma City Thunder,PF,71,71,2223,536,993,0.54,103,241,0.427,433,752,0.576,0.592,180,221,0.814,37,245,282,322,80,45,123,175,1355,Jalen Williams
2024-2025,Oklahoma City Thunder,SG,29,29,938,244,504,0.484,57,150,0.38,187,354,0.528,0.541,79,98,0.806,26,144,170,145,51,21,67,77,624,Jalen Williams
2022-2023,Oklahoma City Thunder,C,49,36,914,102,234,0.436,46,113,0.407,56,121,0.463,0.534,38,54,0.704,44,197,241,76,28,12,37,111,288,Jaylin Williams
2023-2024,Oklahoma City Thunder,C,69,1,897,95,228,0.417,53,144,0.368,42,84,0.5,0.533,33,41,0.805,36,198,234,110,28,27,34,98,276,Jaylin Williams
2024-2025,Oklahoma City Thunder,PF,2,0,17,2,6,0.333,2,6,0.333,0,0,,0.5,0,0,,1,2,3,3,0,1,0,2,6,Jaylin Williams
2022-2023,Portland Trail Blazers,SG,5,4,127,24,39,0.615,3,8,0.375,21,31,0.677,0.654,2,3,0.667,10,5,15,10,3,2,4,13,53,Jeenathan Williams
2023-2024,Houston Rockets,SG,22,0,129,27,50,0.54,2,5,0.4,25,45,0.556,0.56,7,13,0.538,12,11,23,7,4,1,4,10,63,Jeenathan Williams
2024-2025,Houston Rockets,SG,3,0,10,3,4,0.75,1,2,0.5,2,2,1,0.875,0,0,,0,3,3,0,1,0,0,0,7,Jeenathan Williams
2018-2019,New Orleans Pelicans,SF,46,29,1079,107,279,0.384,52,156,0.333,55,123,0.447,0.477,13,19,0.684,55,164,219,83,45,19,36,95,279,Kenrich Williams
2019-2020,New Orleans Pelicans,PF,39,18,832,51,147,0.347,25,97,0.258,26,50,0.52,0.432,9,26,0.346,51,135,186,57,27,21,22,88,136,Kenrich Williams
2020-2021,Oklahoma City Thunder,PF,66,13,1426,219,411,0.533,52,117,0.444,167,294,0.568,0.596,36,63,0.571,84,189,273,152,55,17,76,143,526,Kenrich Williams
2021-2022,Oklahoma City Thunder,SF,49,0,1072,146,317,0.461,41,121,0.339,105,196,0.536,0.525,30,55,0.545,75,145,220,108,44,10,46,81,363,Kenrich Williams
2022-2023,Oklahoma City Thunder,PF,53,10,1206,179,346,0.517,50,134,0.373,129,212,0.608,0.59,17,39,0.436,97,164,261,105,45,14,32,112,425,Kenrich Williams
2023-2024,Oklahoma City Thunder,PF,69,1,1029,131,280,0.468,56,141,0.397,75,139,0.54,0.568,7,14,0.5,61,148,209,93,38,9,32,101,325,Kenrich Williams
2024-2025,Oklahoma City Thunder,PF,19,0,247,45,81,0.556,17,43,0.395,28,38,0.737,0.66,8,8,1,18,44,62,19,13,4,5,31,115,Kenrich Williams
2023-2024,Toronto Raptors,C,7,2,107,9,34,0.265,1,5,0.2,8,29,0.276,0.279,0,2,0,15,23,38,2,3,4,3,15,19,Malik Williams
2022-2023,Charlotte Hornets,C,43,17,828,160,251,0.637,0,0,160,251,0.637,0.637,67,97,0.691,93,211,304,18,28,45,40,94,387,0,Mark Williams
2023-2024,Charlotte Hornets,C,19,19,508,98,151,0.649,0,0,98,151,0.649,0.649,46,64,0.719,76,108,184,22,16,20,17,50,242,0,Mark Williams
2024-2025,Charlotte Hornets,C,8,5,129,37,58,0.638,0,0,37,58,0.638,0.638,14,19,0.737,18,32,50,17,4,6,4,16,88,0,Mark Williams
2020-2021,Chicago Bulls,PF,71,71,1983,255,528,0.483,54,138,0.391,201,390,0.515,0.534,91,125,0.728,66,261,327,99,64,46,98,126,655,Patrick Williams
2021-2022,Chicago Bulls,PF,17,9,422,54,102,0.529,15,29,0.517,39,73,0.534,0.603,30,41,0.732,17,52,69,15,9,9,16,28,153,Patrick Williams
2022-2023,Chicago Bulls,PF,82,65,2323,314,677,0.464,115,277,0.415,199,400,0.498,0.549,90,105,0.857,78,249,327,100,72,70,101,147,833,Patrick Williams
2023-2024,Chicago Bulls,PF,43,30,1174,159,359,0.443,59,148,0.399,100,211,0.474,0.525,52,66,0.788,46,120,166,66,40,33,57,87,429,Patrick Williams
2024-2025,Chicago Bulls,PF,21,20,563,73,188,0.388,38,103,0.369,35,85,0.412,0.489,27,31,0.871,19,76,95,48,20,11,32,28,211,Patrick Williams
2018-2019,Boston Celtics,C,32,2,283,36,51,0.706,0,0,,36,51,0.706,0.706,9,15,0.6,27,54,81,7,9,40,10,36,81,Robert Williams
2019-2020,Boston Celtics,C,29,1,388,64,88,0.727,0,0,,64,88,0.727,0.727,22,34,0.647,40,88,128,27,22,35,21,51,150,Robert Williams
2020-2021,Boston Celtics,C,52,13,985,186,258,0.721,0,2,0,186,256,0.727,0.721,45,73,0.616,133,225,358,94,43,91,52,105,417,Robert Williams
2021-2022,Boston Celtics,C,61,61,1804,271,368,0.736,0,1,0,271,367,0.738,0.736,65,90,0.722,238,350,588,121,56,134,63,137,607,Robert Williams
2022-2023,Boston Celtics,C,35,20,824,127,170,0.747,0,1,0,127,169,0.751,0.747,25,41,0.61,104,188,292,50,22,48,34,68,279,Robert Williams
2023-2024,Portland Trail Blazers,C,6,0,119,17,26,0.654,0,0,,17,26,0.654,0.654,7,9,0.778,11,27,38,5,7,7,7,17,41,Robert Williams
2024-2025,Portland Trail Blazers,C,10,1,171,31,42,0.738,1,2,0.5,30,40,0.75,0.75,12,13,0.923,18,35,53,12,8,14,8,9,75,Robert Williams
2022-2023,Memphis Grizzlies,SG,15,1,105,12,40,0.3,4,28,0.143,8,12,0.667,0.35,2,2,1,4,11,15,4,6,2,5,12,30,Vince Williams Jr.
2023-2024,Memphis Grizzlies,SG,52,33,1436,169,379,0.446,79,209,0.378,90,170,0.529,0.55,104,130,0.8,59,231,290,175,47,34,92,135,521,Vince Williams Jr.
2024-2025,Memphis Grizzlies,SG,3,0,45,7,19,0.368,1,8,0.125,6,11,0.545,0.395,1,4,0.25,4,7,11,9,0,2,7,9,16,Vince Williams Jr.
2021-2022,Memphis Grizzlies,SF,62,31,1346,191,424,0.45,76,242,0.314,115,182,0.632,0.54,43,55,0.782,26,103,129,65,35,12,41,113,501,Ziaire Williams
2022-2023,Memphis Grizzlies,SF,37,4,561,84,196,0.429,25,97,0.258,59,99,0.596,0.492,17,22,0.773,16,63,79,35,14,6,37,58,210,Ziaire Williams
2023-2024,Memphis Grizzlies,SF,51,15,1038,150,378,0.397,58,189,0.307,92,189,0.487,0.474,62,75,0.827,35,145,180,75,36,9,66,85,420,Ziaire Williams
2024-2025,Brooklyn Nets,SF,21,7,459,64,159,0.403,18,66,0.273,46,93,0.495,0.459,35,44,0.795,22,70,92,24,20,7,19,56,181,Ziaire Williams
2019-2020,New Orleans Pelicans,PF,24,24,668,210,360,0.583,6,14,0.429,204,346,0.59,0.592,114,178,0.64,64,86,150,50,16,9,59,42,540,Zion Williamson
2020-2021,New Orleans Pelicans,PF,61,61,2026,634,1037,0.611,10,34,0.294,624,1003,0.622,0.616,369,529,0.698,167,274,441,226,57,39,167,135,1647,Zion Williamson
2022-2023,New Orleans Pelicans,PF,29,29,956,285,469,0.608,7,19,0.368,278,450,0.618,0.615,177,248,0.714,58,144,202,133,32,16,99,65,754,Zion Williamson
2023-2024,New Orleans Pelicans,PF,70,70,2207,624,1094,0.57,6,18,0.333,618,1076,0.574,0.573,347,494,0.702,122,284,406,352,77,47,193,159,1601,Zion Williamson
2024-2025,New Orleans Pelicans,PF,6,6,186,47,104,0.452,2,6,0.333,45,98,0.459,0.462,40,60,0.667,16,32,48,32,4,7,22,18,136,Zion Williamson
2017-2018,Milwaukee Bucks,PF,22,0,71,9,16,0.563,2,5,0.4,7,11,0.636,0.625,1,2,0.5,2,8,10,3,3,1,4,7,21,D.J. Wilson
2018-2019,Milwaukee Bucks,PF,48,3,882,104,251,0.414,46,127,0.362,58,124,0.468,0.506,26,47,0.553,45,177,222,52,18,20,32,85,280,D.J. Wilson
2019-2020,Milwaukee Bucks,PF,37,1,363,52,132,0.394,18,73,0.247,34,59,0.576,0.462,11,18,0.611,12,80,92,25,3,5,19,33,133,D.J. Wilson
2020-2021,Total,PF,35,1,433,68,168,0.405,30,87,0.345,38,81,0.469,0.494,17,25,0.68,20,92,112,23,11,16,22,44,183,D.J. Wilson
2020-2021,Milwaukee Bucks,PF,12,0,105,16,43,0.372,10,28,0.357,6,15,0.4,0.488,1,2,0.5,3,22,25,3,1,4,4,13,43,D.J. Wilson
2020-2021,Houston Rockets,PF,23,1,328,52,125,0.416,20,59,0.339,32,66,0.485,0.496,16,23,0.696,17,70,87,20,10,12,18,31,140,D.J. Wilson
2021-2022,Toronto Raptors,PF,4,1,54,11,15,0.733,0,2,0,11,13,0.846,0.733,8,10,0.8,1,15,16,5,5,1,2,6,30,D.J. Wilson
2023-2024,Philadelphia 76ers,PF,2,0,15,4,6,0.667,2,2,1,2,4,0.5,0.833,0,0,,1,1,2,2,0,2,0,1,10,D.J. Wilson
2023-2024,Brooklyn Nets,PF,43,3,664,76,179,0.425,24,74,0.324,52,105,0.495,0.492,38,46,0.826,47,84,131,45,11,4,19,48,214,Jalen Wilson
2024-2025,Brooklyn Nets,PF,30,7,784,90,232,0.388,41,128,0.32,49,104,0.471,0.476,46,55,0.836,29,74,103,57,15,1,29,66,267,Jalen Wilson
2020-2021,Cleveland Cavaliers,SF,31,0,513,57,130,0.438,26,77,0.338,31,53,0.585,0.538,21,27,0.778,20,87,107,33,19,12,32,37,161,Dylan Windler
2021-2022,Cleveland Cavaliers,SF,50,0,459,37,98,0.378,21,70,0.3,16,28,0.571,0.485,15,18,0.833,21,68,89,34,14,3,16,47,110,Dylan Windler
2022-2023,Cleveland Cavaliers,SF,3,0,10,2,3,0.667,1,2,0.5,1,1,1,0.833,0,0,,0,0,0,1,1,0,1,0,5,Dylan Windler
2023-2024,Total,SF,17,0,108,15,30,0.5,13,27,0.481,2,3,0.667,0.717,0,0,,3,13,16,10,2,0,2,6,43,Dylan Windler
2023-2024,New York Knicks,SF,3,0,7,1,2,0.5,1,2,0.5,0,0,,0.75,0,0,,0,1,1,1,0,0,0,1,3,Dylan Windler
2023-2024,Los Angeles Lakers,SF,8,0,28,4,9,0.444,4,8,0.5,0,1,0,0.667,0,0,,0,3,3,6,0,0,0,2,12,Dylan Windler
2023-2024,Atlanta Hawks,SF,6,0,73,10,19,0.526,8,17,0.471,2,2,1,0.737,0,0,,3,9,12,3,2,0,2,3,28,Dylan Windler
2015-2016,Miami Heat,SF,78,8,2232,195,462,0.422,32,116,0.276,163,346,0.471,0.457,80,117,0.684,81,322,403,117,68,26,95,184,502,Justise Winslow
2016-2017,Miami Heat,SF,18,15,625,80,225,0.356,7,35,0.2,73,190,0.384,0.371,29,47,0.617,23,71,94,66,26,6,33,52,196,Justise Winslow
2017-2018,Miami Heat,PF,68,25,1680,207,488,0.424,49,129,0.38,158,359,0.44,0.474,66,104,0.635,64,306,370,148,54,33,77,140,529,Justise Winslow
2018-2019,Miami Heat,SF,66,52,1959,324,749,0.433,96,256,0.375,228,493,0.462,0.497,86,137,0.628,63,292,355,282,72,19,142,177,830,Justise Winslow
2019-2020,Miami Heat,SG,11,5,352,50,129,0.388,6,27,0.222,44,102,0.431,0.411,18,27,0.667,16,57,73,44,7,5,24,38,124,Justise Winslow
2020-2021,Memphis Grizzlies,SF,26,1,507,74,210,0.352,10,54,0.185,64,156,0.41,0.376,20,35,0.571,18,100,118,50,15,12,37,47,178,Justise Winslow
2021-2022,Total,PF,48,11,775,110,257,0.428,15,66,0.227,95,191,0.497,0.457,39,66,0.591,50,152,202,84,35,25,49,67,274,Justise Winslow
2021-2022,Los Angeles Clippers,PF,37,1,480,63,141,0.447,5,29,0.172,58,112,0.518,0.465,25,41,0.61,30,103,133,52,21,18,37,46,156,Justise Winslow
2021-2022,Portland Trail Blazers,PF,11,10,295,47,116,0.405,10,37,0.27,37,79,0.468,0.448,14,25,0.56,20,49,69,32,14,7,12,21,118,Justise Winslow
2022-2023,Portland Trail Blazers,PF,29,11,776,81,198,0.409,14,45,0.311,67,153,0.438,0.444,20,28,0.714,49,96,145,98,30,11,43,89,196,Justise Winslow
2020-2021,Washington Wizards,PG,22,0,98,14,33,0.424,8,17,0.471,6,16,0.375,0.545,5,6,0.833,0,9,9,12,2,1,5,8,41,Cassius Winston
2021-2022,Washington Wizards,PG,7,0,39,4,11,0.364,2,6,0.333,2,5,0.4,0.455,4,4,1,0,1,1,7,0,0,3,9,14,Cassius Winston
2020-2021,Golden State Warriors,C,39,27,836,191,368,0.519,12,38,0.316,179,330,0.542,0.535,54,86,0.628,55,171,226,26,11,36,60,121,448,James Wiseman
2022-2023,Total,C,45,22,867,189,339,0.558,4,20,0.2,185,319,0.58,0.563,68,97,0.701,73,194,267,30,7,27,51,108,450,James Wiseman
2022-2023,Golden State Warriors,C,21,0,262,59,94,0.628,1,2,0.5,58,92,0.63,0.633,26,38,0.684,18,55,73,14,3,7,14,39,145,James Wiseman
2022-2023,Detroit Pistons,C,24,22,605,130,245,0.531,3,18,0.167,127,227,0.559,0.537,42,59,0.712,55,139,194,16,4,20,37,69,305,James Wiseman
2023-2024,Detroit Pistons,C,63,6,1091,187,305,0.613,0,2,0,187,303,0.617,0.613,72,102,0.706,110,226,336,54,12,39,66,141,446,James Wiseman
2024-2025,Indiana Pacers,C,1,0,5,2,4,0.5,0,1,0,2,3,0.667,0.5,2,2,1,0,1,1,0,0,0,0,0,6,James Wiseman
2023-2024,Indiana Pacers,SG,1,0,4,1,3,0.333,0,1,0,1,2,0.5,0.333,0,0,,0,0,0,0,0,0,0,0,2,Isaiah Wong
2024-2025,Charlotte Hornets,SG,8,0,107,17,41,0.415,4,12,0.333,13,29,0.448,0.463,11,18,0.611,10,9,19,16,4,0,8,10,49,Isaiah Wong
2015-2016,Philadelphia 76ers,PF,17,0,145,22,53,0.415,4,11,0.364,18,42,0.429,0.453,13,21,0.619,13,25,38,3,5,7,2,11,61,Christian Wood
2016-2017,Charlotte Hornets,PF,13,0,107,12,23,0.522,0,5,0,12,18,0.667,0.522,11,15,0.733,14,15,29,2,3,6,7,11,35,Christian Wood
2018-2019,Total,PF,21,2,251,61,117,0.521,9,26,0.346,52,91,0.571,0.56,41,56,0.732,17,66,83,8,7,10,17,17,172,Christian Wood
2018-2019,Milwaukee Bucks,PF,13,0,62,12,25,0.48,3,5,0.6,9,20,0.45,0.54,10,15,0.667,4,16,20,2,0,0,3,3,37,Christian Wood
2018-2019,New Orleans Pelicans,PF,8,2,189,49,92,0.533,6,21,0.286,43,71,0.606,0.565,31,41,0.756,13,50,63,6,7,10,14,14,135,Christian Wood
2019-2020,Detroit Pistons,PF,62,12,1325,288,508,0.567,54,140,0.386,234,368,0.636,0.62,180,242,0.744,104,286,390,60,34,54,84,98,810,Christian Wood
2020-2021,Houston Rockets,C,41,41,1326,329,640,0.514,77,206,0.374,252,434,0.581,0.574,125,198,0.631,76,319,395,71,34,48,80,88,860,Christian Wood
2021-2022,Houston Rockets,C,68,67,2094,440,878,0.501,131,336,0.39,309,542,0.57,0.576,207,332,0.623,110,576,686,155,54,65,126,171,1218,Christian Wood
2022-2023,Dallas Mavericks,C,67,17,1738,396,769,0.515,105,279,0.376,291,490,0.594,0.583,217,281,0.772,87,404,491,121,30,72,121,169,1114,Christian Wood
2023-2024,Los Angeles Lakers,PF,50,1,872,123,264,0.466,35,114,0.307,88,150,0.587,0.532,66,94,0.702,39,215,254,49,16,33,50,72,347,Christian Wood
2020-2021,Sacramento Kings,SF,13,0,45,8,20,0.4,1,6,0.167,7,14,0.5,0.425,3,8,0.375,4,12,16,2,0,3,1,4,20,Robert Woodard II
2021-2022,Sacramento Kings,SF,12,0,42,2,16,0.125,1,4,0.25,1,12,0.083,0.156,2,2,1,5,6,11,3,1,1,1,3,7,Robert Woodard II
2015-2016,Toronto Raptors,PG,27,1,229,36,80,0.45,5,13,0.385,31,67,0.463,0.481,26,35,0.743,8,29,37,31,8,3,16,7,103,Delon Wright
2016-2017,Toronto Raptors,PG,27,0,446,49,116,0.422,10,30,0.333,39,86,0.453,0.466,42,55,0.764,16,32,48,57,27,11,25,31,150,Delon Wright
2017-2018,Toronto Raptors,PG,69,4,1433,201,432,0.465,56,153,0.366,145,279,0.52,0.53,97,117,0.829,45,153,198,200,72,33,78,81,555,Delon Wright
2018-2019,Total,PG,75,13,1699,242,558,0.434,50,168,0.298,192,390,0.492,0.478,119,150,0.793,68,198,266,248,88,30,77,103,653,Delon Wright
2018-2019,Toronto Raptors,PG,49,2,897,127,293,0.433,30,90,0.333,97,203,0.478,0.485,53,61,0.869,39,86,125,110,46,15,37,53,337,Delon Wright
2018-2019,Memphis Grizzlies,PG,26,11,802,115,265,0.434,20,78,0.256,95,187,0.508,0.472,66,89,0.742,29,112,141,138,42,15,40,50,316,Delon Wright
2019-2020,Dallas Mavericks,PG,73,5,1570,190,411,0.462,47,127,0.37,143,284,0.504,0.519,77,100,0.77,70,210,280,244,85,22,73,93,504,Delon Wright
2020-2021,Total,PG,63,39,1748,240,518,0.463,64,172,0.372,176,346,0.509,0.525,101,126,0.802,65,204,269,278,101,30,83,75,645,Delon Wright
2020-2021,Detroit Pistons,PG,36,31,1052,136,293,0.464,31,89,0.348,105,204,0.515,0.517,71,90,0.789,37,127,164,181,58,19,48,45,374,Delon Wright
2020-2021,Sacramento Kings,PG,27,8,696,104,225,0.462,33,83,0.398,71,142,0.5,0.536,30,36,0.833,28,77,105,97,43,11,35,30,271,Delon Wright
2021-2022,Atlanta Hawks,SG,77,8,1452,122,269,0.454,44,116,0.379,78,153,0.51,0.535,54,63,0.857,50,170,220,188,93,19,45,56,342,Delon Wright
2022-2023,Washington Wizards,PG,50,14,1221,138,291,0.474,41,119,0.345,97,172,0.564,0.545,52,60,0.867,58,122,180,194,92,17,44,59,369,Delon Wright
2023-2024,Total,PG,47,1,742,74,188,0.394,25,68,0.368,49,120,0.408,0.46,37,45,0.822,19,67,86,119,54,11,14,32,210,Delon Wright
2023-2024,Washington Wizards,PG,33,0,456,48,122,0.393,14,38,0.368,34,84,0.405,0.451,24,29,0.828,13,46,59,82,35,8,11,22,134,Delon Wright
2023-2024,Miami Heat,PG,14,1,286,26,66,0.394,11,30,0.367,15,36,0.417,0.477,13,16,0.813,6,21,27,37,19,3,3,10,76,Delon Wright
2024-2025,Milwaukee Bucks,PG,22,2,366,21,70,0.3,11,42,0.262,10,28,0.357,0.379,8,14,0.571,15,27,42,42,19,6,13,16,61,Delon Wright
2021-2022,Minnesota Timberwolves,PG,5,0,19,2,3,0.667,1,2,0.5,1,1,1,0.833,0,0,,0,0,0,3,0,0,1,1,5,McKinley Wright IV
2022-2023,Dallas Mavericks,PG,27,1,335,46,98,0.469,9,28,0.321,37,70,0.529,0.515,13,19,0.684,9,38,47,58,8,5,19,24,114,McKinley Wright IV
2019-2020,Utah Jazz,PG,4,0,45,7,20,0.35,2,10,0.2,5,10,0.5,0.4,3,4,0.75,0,5,5,7,2,0,3,5,19,Justin Wright-Foreman
2021-2022,Indiana Pacers,SG,2,0,21,2,7,0.286,1,6,0.167,1,1,1,0.357,3,5,0.6,0,2,2,4,2,1,1,4,8,Gabe York
2022-2023,Indiana Pacers,SG,3,0,56,8,21,0.381,6,18,0.333,2,3,0.667,0.524,2,2,1,0,6,6,5,2,0,0,5,24,Gabe York
2007-2008,Philadelphia 76ers,PF,74,22,1554,264,490,0.539,6,19,0.316,258,471,0.548,0.545,76,103,0.738,120,192,312,58,73,8,64,126,610,Thaddeus Young
2008-2009,Philadelphia 76ers,PF,75,71,2580,475,960,0.495,56,164,0.341,419,796,0.526,0.524,139,189,0.735,139,238,377,86,100,23,118,165,1145,Thaddeus Young
2009-2010,Philadelphia 76ers,PF,67,45,2145,382,813,0.47,48,138,0.348,334,675,0.495,0.499,114,165,0.691,130,220,350,97,81,15,126,133,926,Thaddeus Young
2010-2011,Philadelphia 76ers,PF,82,1,2135,458,847,0.541,6,22,0.273,452,825,0.548,0.544,123,174,0.707,153,281,434,82,90,26,99,170,1045,Thaddeus Young
2011-2012,Philadelphia 76ers,PF,63,1,1755,348,687,0.507,1,4,0.25,347,683,0.508,0.507,111,144,0.771,137,188,325,74,64,41,55,127,808,Thaddeus Young
2012-2013,Philadelphia 76ers,PF,76,76,2629,509,958,0.531,1,8,0.125,508,950,0.535,0.532,108,188,0.574,182,389,571,125,133,55,90,191,1127,Thaddeus Young
2013-2014,Philadelphia 76ers,PF,79,78,2718,582,1283,0.454,90,292,0.308,492,991,0.496,0.489,163,229,0.712,166,310,476,182,167,36,165,213,1417,Thaddeus Young
2014-2015,Total,PF,76,68,2434,451,968,0.466,38,115,0.33,413,853,0.484,0.486,131,200,0.655,127,284,411,173,124,25,117,171,1071,Thaddeus Young
2014-2015,Minnesota Timberwolves,PF,48,48,1605,289,641,0.451,19,65,0.292,270,576,0.469,0.466,88,129,0.682,75,170,245,135,86,17,75,115,685,Thaddeus Young
2014-2015,Brooklyn Nets,PF,28,20,829,162,327,0.495,19,50,0.38,143,277,0.516,0.524,43,71,0.606,52,114,166,38,38,8,42,56,386,Thaddeus Young
2015-2016,Brooklyn Nets,PF,73,73,2407,495,963,0.514,7,30,0.233,488,933,0.523,0.518,105,163,0.644,176,484,660,136,112,37,136,182,1102,Thaddeus Young
2016-2017,Indiana Pacers,PF,74,74,2237,362,687,0.527,45,118,0.381,317,569,0.557,0.56,45,86,0.523,131,317,448,122,113,29,95,135,814,Thaddeus Young
2017-2018,Indiana Pacers,PF,81,81,2607,421,864,0.487,58,181,0.32,363,683,0.531,0.521,55,92,0.598,184,328,512,152,135,36,105,175,955,Thaddeus Young
2018-2019,Indiana Pacers,PF,81,81,2489,443,841,0.527,51,146,0.349,392,695,0.564,0.557,87,135,0.644,192,331,523,204,123,36,123,194,1024,Thaddeus Young
2019-2020,Chicago Bulls,PF,64,16,1591,269,601,0.448,79,222,0.356,190,379,0.501,0.513,42,72,0.583,94,221,315,117,92,23,102,134,659,Thaddeus Young
2020-2021,Chicago Bulls,PF,68,23,1652,370,662,0.559,12,45,0.267,358,617,0.58,0.568,71,113,0.628,168,255,423,291,74,40,137,152,823,Thaddeus Young
2021-2022,Total,PF,52,1,845,141,272,0.518,17,48,0.354,124,224,0.554,0.55,23,49,0.469,80,128,208,104,54,18,52,81,322,Thaddeus Young
2021-2022,San Antonio Spurs,PF,26,1,370,74,128,0.578,0,5,0,74,123,0.602,0.578,10,22,0.455,40,53,93,59,23,7,30,38,158,Thaddeus Young
2021-2022,Toronto Raptors,PF,26,0,475,67,144,0.465,17,43,0.395,50,101,0.495,0.524,13,27,0.481,40,75,115,45,31,11,22,43,164,Thaddeus Young
2022-2023,Toronto Raptors,PF,54,9,795,108,198,0.545,6,34,0.176,102,164,0.622,0.561,18,26,0.692,71,95,166,75,54,5,42,88,240,Thaddeus Young
2023-2024,Total,PF,33,6,439,65,108,0.602,1,7,0.143,64,101,0.634,0.606,6,15,0.4,46,57,103,57,23,5,15,49,137,Thaddeus Young
2023-2024,Toronto Raptors,PF,23,6,350,54,87,0.621,1,6,0.167,53,81,0.654,0.626,5,12,0.417,29,46,75,50,18,3,11,38,114,Thaddeus Young
2023-2024,Phoenix Suns,PF,10,0,89,11,21,0.524,0,1,0,11,20,0.55,0.524,1,3,0.333,17,11,28,7,5,2,4,11,23,Thaddeus Young
2018-2019,Atlanta Hawks,PG,81,81,2503,525,1256,0.418,156,482,0.324,369,774,0.477,0.48,343,414,0.829,64,237,301,653,72,15,308,140,1549,Trae Young
2019-2020,Atlanta Hawks,PG,60,60,2120,546,1249,0.437,205,568,0.361,341,681,0.501,0.519,481,559,0.86,32,223,255,560,65,8,289,104,1778,Trae Young
2020-2021,Atlanta Hawks,PG,63,63,2125,487,1112,0.438,136,397,0.343,351,715,0.491,0.499,484,546,0.886,38,207,245,594,53,12,261,111,1594,Trae Young
2021-2022,Atlanta Hawks,PG,76,76,2652,711,1544,0.46,233,610,0.382,478,934,0.512,0.536,500,553,0.904,50,234,284,737,72,7,303,128,2155,Trae Young
2022-2023,Atlanta Hawks,PG,73,73,2541,597,1390,0.429,154,460,0.335,443,930,0.476,0.485,566,639,0.886,56,161,217,741,80,9,300,104,1914,Trae Young
2023-2024,Atlanta Hawks,PG,54,54,1942,433,1008,0.43,175,469,0.373,258,539,0.479,0.516,348,407,0.855,23,126,149,583,72,11,235,109,1389,Trae Young
2024-2025,Atlanta Hawks,PG,29,29,1046,194,488,0.398,79,240,0.329,115,248,0.464,0.478,171,195,0.877,18,91,109,350,38,4,131,62,638,Trae Young
2021-2022,Miami Heat,C,56,12,706,130,247,0.526,1,11,0.091,129,236,0.547,0.528,38,61,0.623,85,209,294,49,17,20,41,84,299,Omer Yurtseven
2022-2023,Miami Heat,C,9,0,83,16,27,0.593,3,7,0.429,13,20,0.65,0.648,5,6,0.833,8,15,23,2,2,2,4,16,40,Omer Yurtseven
2023-2024,Utah Jazz,C,48,12,545,99,184,0.538,5,24,0.208,94,160,0.588,0.552,19,28,0.679,72,136,208,29,8,18,37,52,222,Omer Yurtseven
2013-2014,Charlotte Hornets,C,82,3,1416,172,404,0.426,0,1,0,172,403,0.427,0.426,146,200,0.73,118,235,353,92,40,41,87,170,490,Cody Zeller
2014-2015,Charlotte Hornets,C,62,45,1487,172,373,0.461,1,1,1,171,372,0.46,0.462,127,164,0.774,97,265,362,100,34,49,62,156,472,Cody Zeller
2015-2016,Charlotte Hornets,C,73,60,1774,231,437,0.529,1,10,0.1,230,427,0.539,0.53,175,232,0.754,138,317,455,71,57,63,68,204,638,Cody Zeller
2016-2017,Charlotte Hornets,C,62,58,1725,253,443,0.571,0,1,0,253,442,0.572,0.571,133,196,0.679,135,270,405,99,62,58,65,189,639,Cody Zeller
2017-2018,Charlotte Hornets,C,33,0,627,85,156,0.545,2,3,0.667,83,153,0.542,0.551,61,85,0.718,67,110,177,31,14,21,33,81,233,Cody Zeller
2018-2019,Charlotte Hornets,C,49,47,1243,190,345,0.551,6,22,0.273,184,323,0.57,0.559,111,141,0.787,110,223,333,102,38,41,62,164,497,Cody Zeller
2019-2020,Charlotte Hornets,C,58,39,1341,251,479,0.524,18,75,0.24,233,404,0.577,0.543,122,179,0.682,160,251,411,88,40,25,75,140,642,Cody Zeller
2020-2021,Charlotte Hornets,C,48,21,1005,181,324,0.559,4,28,0.143,177,296,0.598,0.565,85,119,0.714,119,209,328,86,27,17,51,121,451,Cody Zeller
2021-2022,Portland Trail Blazers,C,27,0,355,51,90,0.567,0,4,0,51,86,0.593,0.567,38,49,0.776,50,75,125,22,8,6,19,56,140,Cody Zeller
2022-2023,Miami Heat,C,15,2,217,37,59,0.627,0,2,0,37,57,0.649,0.627,24,35,0.686,25,39,64,10,3,4,14,33,98,Cody Zeller
2023-2024,New Orleans Pelicans,C,43,0,320,26,62,0.419,1,3,0.333,25,59,0.424,0.427,23,38,0.605,48,64,112,39,9,5,16,45,76,Cody Zeller
2016-2017,Los Angeles Lakers,C,38,11,609,126,238,0.529,0,3,0,126,235,0.536,0.529,32,49,0.653,41,118,159,30,14,33,30,66,284,Ivica Zubac
2017-2018,Los Angeles Lakers,C,43,0,410,61,122,0.5,0,1,0,61,121,0.504,0.5,39,51,0.765,45,78,123,25,8,15,26,47,161,Ivica Zubac
2018-2019,Total,C,59,37,1040,212,379,0.559,0,0,,212,379,0.559,0.559,101,126,0.802,115,247,362,63,14,51,70,137,525,Ivica Zubac
2018-2019,Los Angeles Lakers,C,33,12,516,112,193,0.58,0,0,,112,193,0.58,0.58,57,66,0.864,54,108,162,25,4,27,33,73,281,Ivica Zubac
2018-2019,Los Angeles Clippers,C,26,25,524,100,186,0.538,0,0,,100,186,0.538,0.538,44,60,0.733,61,139,200,38,10,24,37,64,244,Ivica Zubac
2019-2020,Los Angeles Clippers,C,72,70,1326,236,385,0.613,0,2,0,236,383,0.616,0.613,124,166,0.747,197,346,543,82,16,66,61,168,596,Ivica Zubac
2020-2021,Los Angeles Clippers,C,72,33,1609,257,394,0.652,1,4,0.25,256,390,0.656,0.654,135,171,0.789,189,330,519,90,24,62,81,187,650,Ivica Zubac
2021-2022,Los Angeles Clippers,C,76,76,1852,310,495,0.626,0,0,,310,495,0.626,0.626,165,227,0.727,217,427,644,120,36,77,114,203,785,Ivica Zubac
2022-2023,Los Angeles Clippers,C,76,76,2170,326,514,0.634,0,2,0,326,512,0.637,0.634,166,238,0.697,236,520,756,77,29,98,117,219,818,Ivica Zubac
2023-2024,Los Angeles Clippers,C,68,68,1794,337,519,0.649,0,0,,337,519,0.649,0.649,120,166,0.723,196,430,626,93,22,83,79,180,794,Ivica Zubac
2024-2025,Los Angeles Clippers,C,31,31,1011,213,347,0.614,0,0,,213,347,0.614,0.614,46,88,0.523,122,267,389,77,22,35,59,64,472,Ivica Zubac
