rank,team,g,mp,fg,fga,fg%,3p,3pa,3p%,2p,2pa,2p%,ft,fta,ft%,orb,drb,trb,ast,stl,blk,tov,pf,pts,season
1,Orlando Magic,82,19930,3460,6899,0.502,523,1412,0.37,2937,5487,0.535,1648,2465,0.669,1149,2457,3606,2281,672,488,1297,1726,9091,1994-1995
2,Phoenix Suns,82,19830,3356,6967,0.482,584,1584,0.369,2772,5383,0.515,1777,2352,0.756,1027,2403,3430,2198,687,312,1167,1839,9073,1994-1995
3,Seattle SuperSonics,82,19830,3310,6741,0.491,491,1305,0.376,2819,5436,0.519,1944,2564,0.758,1068,2337,3405,2115,917,392,1295,2067,9055,1994-1995
4,San Antonio Spurs,82,19855,3236,6687,0.484,434,1158,0.375,2802,5529,0.507,1836,2487,0.738,1029,2661,3690,1919,656,456,1246,1871,8742,1994-1995
5,Utah Jazz,82,19780,3243,6339,0.512,301,801,0.376,2942,5538,0.531,1939,2483,0.781,874,2412,3286,2256,758,392,1289,2045,8726,1994-1995
6,Golden State Warriors,82,19905,3217,6873,0.468,546,1602,0.341,2671,5271,0.507,1687,2395,0.704,1101,2371,3472,2017,649,391,1497,1804,8667,1994-1995
7,Los Angeles Lakers,82,19905,3284,7088,0.463,525,1492,0.352,2759,5596,0.493,1523,2072,0.735,1126,2316,3442,2078,750,563,1243,1933,8616,1994-1995
8,Houston Rockets,82,19730,3159,6579,0.48,646,1757,0.368,2513,4822,0.521,1527,2039,0.749,880,2440,3320,2060,721,514,1322,1714,8491,1994-1995
9,Dallas Mavericks,82,19930,3227,7342,0.44,386,1200,0.322,2841,6142,0.463,1622,2210,0.734,1514,2433,3947,1941,579,348,1345,1811,8462,1994-1995
10,Portland Trail Blazers,82,19705,3217,7134,0.451,462,1266,0.365,2755,5868,0.469,1555,2230,0.697,1352,2443,3795,1846,668,467,1212,2024,8451,1994-1995
11,Boston Celtics,82,19805,3179,6847,0.464,362,984,0.368,2817,5863,0.48,1708,2268,0.753,1156,2320,3476,1783,612,361,1305,1975,8428,1994-1995
12,Chicago Bulls,82,19830,3191,6710,0.476,443,1187,0.373,2748,5523,0.498,1500,2065,0.726,1106,2294,3400,1970,797,352,1297,1962,8325,1994-1995
13,Denver Nuggets,82,19980,3098,6461,0.479,413,1160,0.356,2685,5301,0.507,1700,2305,0.738,1040,2402,3442,1836,660,585,1381,2063,8309,1994-1995
14,Miami Heat,82,19805,3144,6738,0.467,436,1182,0.369,2708,5556,0.487,1569,2133,0.736,1092,2272,3364,1779,662,298,1291,2000,8293,1994-1995
15,Charlotte Hornets,82,19805,3051,6438,0.474,560,1409,0.397,2491,5029,0.495,1587,2042,0.777,832,2395,3227,2072,620,399,1224,1685,8249,1994-1995
16,Washington Bullets,82,19855,3176,6899,0.46,433,1264,0.343,2743,5635,0.487,1457,2013,0.724,1044,2219,3263,1749,648,404,1301,1949,8242,1994-1995
17,Milwaukee Bucks,82,19855,3022,6586,0.459,494,1349,0.366,2528,5237,0.483,1608,2259,0.712,1063,2187,3250,1737,674,359,1393,1858,8146,1994-1995
18,Indiana Pacers,82,19780,2983,6248,0.477,374,985,0.38,2609,5263,0.496,1796,2390,0.751,1051,2290,3341,1877,703,363,1340,1939,8136,1994-1995
19,Sacramento Kings,82,19855,3025,6463,0.468,359,1037,0.346,2666,5426,0.491,1647,2317,0.711,1073,2325,3398,1824,650,457,1449,2040,8056,1994-1995
20,New York Knicks,82,19780,2985,6394,0.467,532,1446,0.368,2453,4948,0.496,1552,2114,0.734,929,2473,3402,2055,591,387,1305,2102,8054,1994-1995
21,Detroit Pistons,82,19730,3060,6633,0.461,494,1396,0.354,2566,5237,0.49,1439,1941,0.741,958,2204,3162,1872,705,420,1318,2151,8053,1994-1995
22,New Jersey Nets,82,19880,2939,6738,0.436,414,1297,0.319,2525,5441,0.464,1750,2305,0.759,1213,2569,3782,1884,544,548,1300,1844,8042,1994-1995
23,Los Angeles Clippers,82,19880,3060,6888,0.444,331,1051,0.315,2729,5837,0.468,1476,2079,0.71,1064,2076,3140,1805,787,435,1334,2152,7927,1994-1995
24,Atlanta Hawks,82,19855,2986,6680,0.447,539,1580,0.341,2447,5100,0.48,1410,1948,0.724,1104,2272,3376,1757,738,412,1221,1804,7921,1994-1995
25,Philadelphia 76ers,82,19805,2949,6577,0.448,355,936,0.379,2594,5641,0.46,1567,2125,0.737,1105,2230,3335,1566,643,576,1355,1835,7820,1994-1995
26,Minnesota Timberwolves,82,19780,2792,6219,0.449,318,1016,0.313,2474,5203,0.475,1824,2355,0.775,883,2090,2973,1780,609,402,1400,2074,7726,1994-1995
27,Cleveland Cavaliers,82,19930,2756,6255,0.441,398,1033,0.385,2358,5222,0.452,1507,1982,0.76,1045,2237,3282,1672,630,349,1176,1694,7417,1994-1995
1,Chicago Bulls,82,19730,3293,6892,0.478,544,1349,0.403,2749,5543,0.496,1495,2004,0.746,1247,2411,3658,2033,745,345,1175,1807,8625,1995-1996
2,Seattle SuperSonics,82,19880,3074,6401,0.48,581,1596,0.364,2493,4805,0.519,1843,2424,0.76,954,2449,3403,1999,882,393,1441,1967,8572,1995-1996
3,Orlando Magic,82,19855,3203,6640,0.482,622,1645,0.378,2581,4995,0.517,1543,2232,0.691,966,2401,3367,2080,663,406,1160,1709,8571,1995-1996
4,Phoenix Suns,82,19955,3159,6673,0.473,327,984,0.332,2832,5689,0.498,1907,2472,0.771,1009,2501,3510,2001,623,331,1207,1776,8552,1995-1996
5,Boston Celtics,82,19905,3163,6942,0.456,539,1453,0.371,2624,5489,0.478,1630,2284,0.714,1050,2427,3477,1792,653,406,1302,2041,8495,1995-1996
6,San Antonio Spurs,82,19780,3148,6602,0.477,518,1320,0.392,2630,5282,0.498,1663,2261,0.736,937,2586,3523,2044,645,536,1195,1820,8477,1995-1996
7,Los Angeles Lakers,82,19680,3216,6706,0.48,477,1359,0.351,2739,5347,0.512,1529,2049,0.746,995,2303,3298,2080,722,516,1163,1702,8438,1995-1996
8,Charlotte Hornets,82,19880,3108,6618,0.47,584,1520,0.384,2524,5098,0.495,1631,2119,0.77,987,2256,3243,1907,582,277,1241,1815,8431,1995-1996
9,Dallas Mavericks,82,19930,3124,7431,0.42,735,2039,0.36,2389,5392,0.443,1426,1975,0.722,1408,2379,3787,1913,642,342,1270,1836,8409,1995-1996
10,Washington Bullets,82,19805,3202,6618,0.484,493,1212,0.407,2709,5406,0.501,1511,2076,0.728,930,2327,3257,1815,592,506,1327,1981,8408,1995-1996
11,Houston Rockets,82,19805,3078,6638,0.464,637,1761,0.362,2441,4877,0.501,1611,2106,0.765,919,2455,3374,1982,645,476,1245,1753,8404,1995-1996
12,Utah Jazz,82,19780,3129,6417,0.488,377,1013,0.372,2752,5404,0.509,1769,2302,0.768,993,2373,3366,2139,667,418,1215,2046,8404,1995-1996
13,Golden State Warriors,82,19755,3056,6700,0.456,447,1199,0.373,2609,5501,0.474,1775,2340,0.759,1173,2285,3458,1889,706,470,1343,1835,8334,1995-1996
14,Sacramento Kings,82,19755,2971,6494,0.457,462,1194,0.387,2509,5300,0.473,1759,2407,0.731,1114,2345,3459,1829,643,436,1442,2131,8163,1995-1996
15,Los Angeles Clippers,82,19730,3126,6618,0.472,509,1374,0.37,2617,5244,0.499,1392,1984,0.702,979,2190,3169,1672,703,411,1355,2008,8153,1995-1996
16,Portland Trail Blazers,82,19905,3064,6688,0.458,480,1358,0.353,2584,5330,0.485,1537,2321,0.662,1160,2577,3737,1760,594,417,1377,1859,8145,1995-1996
17,Indiana Pacers,82,19755,2979,6205,0.48,363,973,0.373,2616,5232,0.5,1823,2416,0.755,1010,2262,3272,1917,579,323,1335,2031,8144,1995-1996
18,Atlanta Hawks,82,19730,2985,6665,0.448,566,1595,0.355,2419,5070,0.477,1523,2012,0.757,1182,2148,3330,1609,771,319,1228,1714,8059,1995-1996
19,Minnesota Timberwolves,82,19780,2974,6481,0.459,279,857,0.326,2695,5624,0.479,1797,2314,0.777,985,2271,3256,1867,650,481,1426,1994,8024,1995-1996
20,Denver Nuggets,82,19830,3001,6657,0.451,397,1148,0.346,2604,5509,0.473,1614,2173,0.743,1057,2487,3544,1851,521,597,1265,1882,8013,1995-1996
21,Toronto Raptors,82,19830,3084,6598,0.467,414,1168,0.354,2670,5430,0.492,1412,1953,0.723,1071,2213,3284,1927,745,493,1544,1987,7994,1995-1996
22,New York Knicks,82,19830,3003,6382,0.471,485,1285,0.377,2518,5097,0.494,1480,1954,0.757,829,2449,3278,1822,645,377,1272,1864,7971,1995-1996
23,Miami Heat,82,19780,2902,6348,0.457,552,1458,0.379,2350,4890,0.481,1553,2187,0.71,999,2495,3494,1752,574,439,1394,2158,7909,1995-1996
24,Milwaukee Bucks,82,19730,3034,6490,0.467,357,1056,0.338,2677,5434,0.493,1412,1914,0.738,973,2164,3137,1755,582,307,1295,1943,7837,1995-1996
25,Detroit Pistons,82,19830,2810,6122,0.459,545,1350,0.404,2265,4772,0.475,1657,2206,0.751,884,2440,3324,1610,506,352,1215,1953,7822,1995-1996
26,Philadelphia 76ers,82,19730,2796,6418,0.436,492,1438,0.342,2304,4980,0.463,1662,2263,0.734,1031,2161,3192,1629,643,420,1414,1777,7746,1995-1996
27,New Jersey Nets,82,19905,2881,6750,0.427,250,746,0.335,2631,6004,0.438,1672,2244,0.745,1350,2503,3853,1752,627,571,1375,1880,7684,1995-1996
28,Cleveland Cavaliers,82,19830,2761,5998,0.46,596,1582,0.377,2165,4416,0.49,1355,1775,0.763,867,2055,2922,1818,674,340,1073,1685,7473,1995-1996
29,Vancouver Grizzlies,82,19880,2772,6483,0.428,372,1129,0.329,2400,5354,0.448,1446,1998,0.724,957,2170,3127,1706,728,333,1347,1852,7362,1995-1996
1,Chicago Bulls,82,19730,3277,6923,0.473,523,1403,0.373,2754,5520,0.499,1381,1848,0.747,1235,2461,3696,2142,716,332,1109,1617,8458,1996-1997
2,Utah Jazz,82,19830,3131,6217,0.504,334,902,0.37,2797,5315,0.526,1858,2416,0.769,889,2410,3299,2199,748,418,1259,1981,8454,1996-1997
3,Phoenix Suns,82,19855,3143,6705,0.469,527,1428,0.369,2616,5277,0.496,1618,2125,0.761,916,2376,3292,2067,664,322,1180,1727,8431,1996-1997
4,Seattle SuperSonics,82,19780,2995,6415,0.467,559,1583,0.353,2436,4832,0.504,1725,2295,0.752,1010,2271,3281,1931,904,388,1231,1803,8274,1996-1997
5,Boston Celtics,82,19905,3066,6967,0.44,467,1331,0.351,2599,5636,0.461,1649,2199,0.75,1095,2188,3283,1792,810,315,1342,1915,8248,1996-1997
6,Houston Rockets,82,19855,3037,6484,0.468,671,1839,0.365,2366,4645,0.509,1503,1992,0.755,927,2565,3492,2013,685,347,1365,1610,8248,1996-1997
7,Philadelphia 76ers,82,19780,3003,6850,0.438,433,1356,0.319,2570,5494,0.468,1776,2450,0.725,1267,2355,3622,1695,683,394,1437,1733,8215,1996-1997
8,Los Angeles Lakers,82,19930,3018,6642,0.454,551,1500,0.367,2467,5142,0.48,1613,2330,0.692,1092,2414,3506,1845,740,575,1222,1818,8200,1996-1997
9,Golden State Warriors,82,19905,2997,6567,0.456,481,1363,0.353,2516,5204,0.483,1696,2180,0.778,1086,2259,3345,1822,611,359,1410,1787,8171,1996-1997
10,Washington Bullets,82,19855,3208,6678,0.48,331,1001,0.331,2877,5677,0.507,1400,1979,0.707,1010,2420,3430,1921,712,402,1289,1815,8147,1996-1997
11,Portland Trail Blazers,82,19855,3000,6465,0.464,501,1401,0.358,2499,5064,0.493,1613,2261,0.713,1058,2494,3552,1710,640,435,1357,1928,8114,1996-1997
12,Charlotte Hornets,82,19805,2988,6342,0.471,591,1382,0.428,2397,4960,0.483,1541,1984,0.777,910,2298,3208,2021,597,349,1203,1702,8108,1996-1997
13,Denver Nuggets,82,19930,2934,6687,0.439,636,1711,0.372,2298,4976,0.462,1516,1992,0.761,994,2452,3446,1889,503,487,1359,1784,8020,1996-1997
14,New Jersey Nets,82,19780,2994,7091,0.422,484,1371,0.353,2510,5720,0.439,1502,2031,0.74,1410,2376,3786,1726,677,481,1290,1865,7974,1996-1997
15,Los Angeles Clippers,82,19930,2989,6696,0.446,474,1339,0.354,2515,5357,0.469,1517,2074,0.731,1092,2242,3334,1662,733,441,1311,1964,7969,1996-1997
16,Sacramento Kings,82,19855,3000,6611,0.454,414,1058,0.391,2586,5553,0.466,1494,2067,0.723,1100,2307,3407,1799,588,362,1332,1946,7908,1996-1997
17,Minnesota Timberwolves,82,19780,2937,6436,0.456,371,1093,0.339,2566,5343,0.48,1637,2180,0.751,957,2302,3259,1874,618,557,1243,1818,7882,1996-1997
18,Toronto Raptors,82,19830,2897,6632,0.437,589,1624,0.363,2308,5008,0.461,1446,2008,0.72,1135,2254,3389,1714,722,517,1347,1883,7829,1996-1997
19,New York Knicks,82,19855,2882,6227,0.463,470,1294,0.363,2412,4933,0.489,1585,2119,0.748,973,2516,3489,1809,629,378,1462,2033,7819,1996-1997
20,Indiana Pacers,82,19930,2851,6254,0.456,430,1130,0.381,2421,5124,0.472,1687,2336,0.722,1029,2390,3419,1750,585,394,1338,1977,7819,1996-1997
21,Milwaukee Bucks,82,19730,2967,6303,0.471,324,920,0.352,2643,5383,0.491,1560,2104,0.741,955,2263,3218,1610,632,348,1285,1892,7818,1996-1997
22,Miami Heat,82,19805,2822,6235,0.453,678,1865,0.364,2144,4370,0.491,1454,2022,0.719,957,2402,3359,1735,650,439,1306,1919,7776,1996-1997
23,Atlanta Hawks,82,19805,2812,6307,0.446,659,1834,0.359,2153,4473,0.481,1491,1955,0.763,1021,2350,3371,1557,701,427,1228,1591,7774,1996-1997
24,Detroit Pistons,82,19830,2827,6095,0.464,582,1499,0.388,2245,4596,0.488,1487,1995,0.745,858,2292,3150,1554,632,283,1041,1652,7723,1996-1997
25,Orlando Magic,82,19855,2839,6497,0.437,567,1662,0.341,2272,4835,0.47,1474,1975,0.746,1071,2221,3292,1689,694,363,1250,1643,7719,1996-1997
26,Dallas Mavericks,82,19805,2813,6452,0.436,430,1316,0.327,2383,5136,0.464,1375,1918,0.717,1040,2262,3302,1663,654,351,1324,1798,7431,1996-1997
27,San Antonio Spurs,82,19730,2827,6391,0.442,378,1180,0.32,2449,5211,0.47,1386,1929,0.719,1101,2129,3230,1661,646,431,1243,1764,7418,1996-1997
28,Vancouver Grizzlies,82,19780,2819,6453,0.437,445,1274,0.349,2374,5179,0.458,1230,1734,0.709,1023,2155,3178,1862,657,464,1301,1755,7313,1996-1997
29,Cleveland Cavaliers,82,19855,2704,5972,0.453,483,1284,0.376,2221,4688,0.474,1282,1773,0.723,909,2159,3068,1714,655,315,1188,1882,7173,1996-1997
1,Los Angeles Lakers,82,19830,3146,6536,0.481,497,1415,0.351,2649,5121,0.517,1863,2743,0.679,1079,2471,3550,2009,734,556,1256,1859,8652,1997-1998
2,Minnesota Timberwolves,82,19930,3157,6844,0.461,303,873,0.347,2854,5971,0.478,1673,2253,0.743,1063,2429,3492,2068,639,427,1138,1882,8290,1997-1998
3,Utah Jazz,82,19780,2993,6113,0.49,249,670,0.372,2744,5443,0.504,2044,2644,0.773,962,2405,3367,2070,648,412,1259,1961,8279,1997-1998
4,Seattle SuperSonics,82,19755,3052,6458,0.473,621,1569,0.396,2431,4889,0.497,1521,2109,0.721,931,2225,3156,1986,804,376,1145,1812,8246,1997-1998
5,New Jersey Nets,82,19880,3055,6928,0.441,310,937,0.331,2745,5991,0.458,1750,2351,0.744,1344,2137,3481,1685,777,314,1180,1917,8170,1997-1998
6,Phoenix Suns,82,19955,3138,6710,0.468,431,1211,0.356,2707,5499,0.492,1459,1948,0.749,991,2452,3443,2124,756,429,1236,1765,8166,1997-1998
7,Houston Rockets,82,19830,2946,6513,0.452,573,1670,0.343,2373,4843,0.49,1634,2120,0.771,987,2350,3337,1799,686,294,1298,1653,8099,1997-1998
8,Washington Wizards,82,19805,3080,6811,0.452,320,944,0.339,2760,5867,0.47,1489,2156,0.691,1121,2341,3462,1900,689,379,1156,1839,7969,1997-1998
9,Chicago Bulls,82,19855,3064,6801,0.451,311,962,0.323,2753,5839,0.471,1492,2009,0.743,1243,2438,3681,1952,696,353,1178,1691,7931,1997-1998
10,Charlotte Hornets,82,19780,2968,6344,0.468,346,904,0.383,2622,5440,0.482,1641,2186,0.751,985,2341,3326,1941,691,312,1247,1757,7923,1997-1998
11,Vancouver Grizzlies,82,19830,3006,6567,0.458,325,898,0.362,2681,5669,0.473,1586,2145,0.739,1081,2313,3394,1960,614,349,1405,1809,7923,1997-1998
12,Indiana Pacers,82,19830,2921,6223,0.469,401,1029,0.39,2520,5194,0.485,1631,2136,0.764,874,2348,3222,1889,645,368,1168,1859,7874,1997-1998
13,Los Angeles Clippers,82,19780,2930,6690,0.438,525,1468,0.358,2405,5222,0.461,1480,2047,0.723,1040,2276,3316,1533,625,456,1323,1827,7865,1997-1998
14,Boston Celtics,82,19730,3012,6934,0.434,415,1249,0.332,2597,5685,0.457,1425,1964,0.726,1196,2044,3240,1816,987,366,1330,2203,7864,1997-1998
15,Atlanta Hawks,82,19880,2887,6352,0.455,337,1016,0.332,2550,5336,0.478,1749,2314,0.756,1106,2417,3523,1569,653,491,1214,1671,7860,1997-1998
16,Miami Heat,82,19755,2850,6327,0.45,548,1544,0.355,2302,4783,0.481,1539,2082,0.739,1028,2419,3447,1758,665,429,1226,1982,7787,1997-1998
17,Toronto Raptors,82,19930,2965,6813,0.435,372,1086,0.343,2593,5727,0.453,1479,2060,0.718,1187,2149,3336,1746,769,663,1371,1851,7781,1997-1998
18,Milwaukee Bucks,82,19930,2918,6399,0.456,249,703,0.354,2669,5696,0.469,1663,2167,0.767,1035,2236,3271,1649,733,357,1383,1915,7748,1997-1998
19,Portland Trail Blazers,82,19830,2885,6397,0.451,324,1047,0.309,2561,5350,0.479,1640,2226,0.737,1086,2522,3608,1766,585,464,1383,1859,7734,1997-1998
20,Detroit Pistons,82,19955,2862,6373,0.449,293,938,0.312,2569,5435,0.473,1704,2288,0.745,1044,2338,3382,1597,678,344,1198,1805,7721,1997-1998
21,Philadelphia 76ers,82,19755,2837,6409,0.443,243,810,0.3,2594,5599,0.463,1734,2352,0.737,1125,2294,3419,1729,729,490,1356,1878,7651,1997-1998
22,Sacramento Kings,82,19730,2957,6684,0.442,283,806,0.351,2674,5878,0.455,1440,2096,0.687,1094,2304,3398,1836,596,420,1271,1810,7637,1997-1998
23,San Antonio Spurs,82,19830,2898,6187,0.468,302,863,0.35,2596,5324,0.488,1489,2164,0.688,984,2638,3622,1839,516,568,1318,1731,7587,1997-1998
24,Cleveland Cavaliers,82,19830,2817,6207,0.454,298,801,0.372,2519,5406,0.466,1653,2187,0.756,955,2331,3286,1894,814,419,1421,1939,7585,1997-1998
25,New York Knicks,82,19830,2864,6413,0.447,382,1139,0.335,2482,5274,0.471,1399,1812,0.772,978,2434,3412,1787,634,278,1247,1947,7509,1997-1998
26,Dallas Mavericks,82,19905,2882,6754,0.427,422,1183,0.357,2460,5571,0.442,1308,1738,0.753,1008,2280,3288,1535,646,466,1183,1643,7494,1997-1998
27,Orlando Magic,82,19830,2771,6455,0.429,293,907,0.323,2478,5548,0.447,1552,2138,0.726,1178,2203,3381,1694,649,441,1258,1617,7387,1997-1998
28,Denver Nuggets,82,19730,2677,6412,0.417,288,893,0.323,2389,5519,0.433,1658,2147,0.772,1040,2157,3197,1547,664,393,1312,1937,7300,1997-1998
29,Golden State Warriors,82,19830,2845,6883,0.413,189,696,0.272,2656,6187,0.429,1358,1912,0.71,1288,2473,3761,1708,621,448,1369,1859,7237,1997-1998
1,Sacramento Kings,50,12200,1918,4307,0.445,290,943,0.308,1628,3364,0.484,883,1293,0.683,706,1573,2279,1129,444,232,842,1016,5009,1998-1999
2,Los Angeles Lakers,50,12050,1841,3935,0.468,241,685,0.352,1600,3250,0.492,1027,1503,0.683,619,1482,2101,1095,389,287,754,1231,4950,1998-1999
3,Phoenix Suns,50,12050,1797,4004,0.449,261,702,0.372,1536,3302,0.465,924,1215,0.76,598,1418,2016,1249,444,200,681,1022,4779,1998-1999
4,Seattle SuperSonics,50,12100,1756,3976,0.442,309,899,0.344,1447,3077,0.47,922,1354,0.681,676,1422,2098,1087,393,201,765,1047,4743,1998-1999
5,Portland Trail Blazers,50,12175,1747,3956,0.442,246,675,0.364,1501,3281,0.457,1002,1349,0.743,646,1570,2216,1073,411,290,771,1126,4742,1998-1999
6,Indiana Pacers,50,12100,1731,3866,0.448,294,799,0.368,1437,3067,0.469,977,1228,0.796,574,1452,2026,1005,316,223,649,1082,4733,1998-1999
7,Houston Rockets,50,12075,1755,3798,0.462,336,914,0.368,1419,2884,0.492,865,1187,0.729,536,1540,2076,1058,386,260,812,960,4711,1998-1999
8,Denver Nuggets,50,12025,1681,3989,0.421,302,922,0.328,1379,3067,0.45,1010,1325,0.762,647,1392,2039,969,376,275,739,1145,4674,1998-1999
9,Utah Jazz,50,12175,1684,3620,0.465,140,388,0.361,1544,3232,0.478,1158,1510,0.767,555,1508,2063,1204,398,276,814,1133,4666,1998-1999
10,Boston Celtics,50,12150,1816,4164,0.436,273,758,0.36,1543,3406,0.453,745,1077,0.692,680,1458,2138,1073,453,255,807,1193,4650,1998-1999
11,Minnesota Timberwolves,50,12025,1838,4327,0.425,122,410,0.298,1716,3917,0.438,849,1143,0.743,754,1392,2146,1218,426,272,641,1185,4647,1998-1999
12,Charlotte Hornets,50,12150,1671,3718,0.449,268,735,0.365,1403,2983,0.47,1034,1384,0.747,480,1493,1973,1110,443,247,796,1101,4644,1998-1999
13,San Antonio Spurs,50,12075,1740,3812,0.456,172,521,0.33,1568,3291,0.476,988,1415,0.698,614,1584,2198,1101,421,351,759,1010,4640,1998-1999
14,Milwaukee Bucks,50,12050,1753,3818,0.459,231,619,0.373,1522,3199,0.476,847,1155,0.733,570,1369,1939,1030,442,202,719,1142,4584,1998-1999
15,Dallas Mavericks,50,12075,1749,4033,0.434,202,595,0.339,1547,3438,0.45,881,1210,0.728,645,1478,2123,921,352,292,692,1065,4581,1998-1999
16,New Jersey Nets,50,12050,1691,4160,0.406,225,679,0.331,1466,3481,0.421,962,1251,0.769,715,1437,2152,923,491,273,750,1134,4569,1998-1999
17,Washington Wizards,50,12050,1768,3969,0.445,179,580,0.309,1589,3389,0.469,845,1198,0.705,595,1403,1998,1064,393,193,736,1151,4560,1998-1999
18,Toronto Raptors,50,12075,1660,3940,0.421,226,662,0.341,1434,3278,0.437,1011,1330,0.76,712,1447,2159,1036,439,321,799,1139,4557,1998-1999
19,Los Angeles Clippers,50,12125,1711,4007,0.427,214,668,0.32,1497,3339,0.448,883,1225,0.721,665,1293,1958,820,424,236,796,1223,4519,1998-1999
20,Detroit Pistons,50,12050,1660,3716,0.447,248,679,0.365,1412,3037,0.465,950,1283,0.74,605,1412,2017,1009,444,208,790,1139,4518,1998-1999
21,Philadelphia 76ers,50,12150,1656,3883,0.426,98,371,0.264,1558,3512,0.444,1073,1486,0.722,729,1428,2157,934,542,271,822,1152,4483,1998-1999
22,Orlando Magic,50,12050,1687,3943,0.428,223,675,0.33,1464,3268,0.448,876,1252,0.7,688,1445,2133,1067,496,213,819,935,4473,1998-1999
23,Miami Heat,50,12025,1616,3565,0.453,289,804,0.359,1327,2761,0.481,928,1262,0.735,503,1512,2015,1019,327,304,744,1035,4449,1998-1999
24,Vancouver Grizzlies,50,12175,1643,3838,0.428,148,453,0.327,1495,3385,0.442,1009,1408,0.717,650,1359,2009,964,420,199,848,1123,4443,1998-1999
25,Golden State Warriors,50,12125,1730,4173,0.415,162,565,0.287,1568,3608,0.435,794,1175,0.676,816,1559,2375,1037,414,221,768,1270,4416,1998-1999
26,Cleveland Cavaliers,50,12050,1562,3561,0.439,182,534,0.341,1380,3027,0.456,1016,1356,0.749,472,1316,1788,1093,452,203,785,1208,4322,1998-1999
27,New York Knicks,50,12100,1610,3704,0.435,208,589,0.353,1402,3115,0.45,892,1218,0.732,551,1510,2061,963,395,262,804,1140,4320,1998-1999
28,Atlanta Hawks,50,12075,1539,3760,0.409,197,644,0.306,1342,3116,0.431,1040,1422,0.731,676,1499,2175,782,346,260,745,987,4315,1998-1999
29,Chicago Bulls,50,12075,1539,3837,0.401,177,612,0.289,1362,3225,0.422,840,1185,0.709,573,1394,1967,1017,436,169,774,1112,4095,1998-1999
1,Sacramento Kings,82,19805,3276,7288,0.45,534,1656,0.322,2742,5632,0.487,1521,2016,0.754,1056,2635,3691,1953,787,381,1325,1729,8607,1999-2000
2,Detroit Pistons,82,19830,3044,6635,0.459,439,1223,0.359,2605,5412,0.481,1956,2506,0.781,917,2458,3375,1707,665,273,1288,2011,8483,1999-2000
3,Dallas Mavericks,82,19730,3195,7047,0.453,519,1326,0.391,2676,5721,0.468,1407,1751,0.804,931,2444,3375,1810,592,416,1124,1770,8316,1999-2000
4,Indiana Pacers,82,19730,3047,6640,0.459,583,1487,0.392,2464,5153,0.478,1629,2008,0.811,842,2612,3454,1857,559,422,1159,1786,8306,1999-2000
5,Milwaukee Bucks,82,19855,3174,6827,0.465,394,1069,0.369,2780,5758,0.483,1558,1982,0.786,1016,2373,3389,1852,671,381,1230,2020,8300,1999-2000
6,Los Angeles Lakers,82,19805,3137,6836,0.459,344,1047,0.329,2793,5789,0.482,1649,2368,0.696,1117,2738,3855,1921,613,534,1143,1841,8267,1999-2000
7,Orlando Magic,82,19755,3169,7014,0.452,294,870,0.338,2875,6144,0.468,1574,2142,0.735,1145,2540,3685,1709,743,467,1443,1967,8206,1999-2000
8,Houston Rockets,82,19830,3001,6664,0.45,581,1625,0.358,2420,5039,0.48,1573,2145,0.733,1008,2586,3594,1774,613,438,1425,1663,8156,1999-2000
9,Boston Celtics,82,19730,3054,6880,0.444,417,1260,0.331,2637,5620,0.469,1621,2175,0.745,1108,2420,3528,1741,795,286,1259,2223,8146,1999-2000
10,Seattle SuperSonics,82,19780,3108,6946,0.447,546,1611,0.339,2562,5335,0.48,1363,1960,0.695,1042,2483,3525,1878,657,345,1152,1776,8125,1999-2000
11,Denver Nuggets,82,19855,3057,6911,0.442,470,1397,0.336,2587,5514,0.469,1531,2116,0.724,1073,2590,3663,1911,554,618,1281,1962,8115,1999-2000
12,Phoenix Suns,82,19805,3093,6771,0.457,458,1246,0.368,2635,5525,0.477,1467,1934,0.759,1022,2558,3580,2098,744,433,1368,1973,8111,1999-2000
13,Minnesota Timberwolves,82,19905,3226,6910,0.467,248,716,0.346,2978,6194,0.481,1379,1769,0.78,1016,2471,3487,2205,622,444,1139,1913,8079,1999-2000
14,Charlotte Hornets,82,19780,2935,6533,0.449,339,1001,0.339,2596,5532,0.469,1863,2458,0.758,884,2635,3519,2023,732,480,1206,1670,8072,1999-2000
15,New Jersey Nets,82,19830,2979,6881,0.433,477,1374,0.347,2502,5507,0.454,1601,2041,0.784,1040,2315,3355,1688,720,393,1119,1913,8036,1999-2000
16,Portland Trail Blazers,82,19780,3021,6430,0.47,407,1128,0.361,2614,5302,0.493,1542,2029,0.76,966,2560,3526,1925,633,396,1243,1865,7991,1999-2000
17,Toronto Raptors,82,19755,2980,6882,0.433,425,1171,0.363,2555,5711,0.447,1583,2068,0.765,1098,2449,3547,1947,666,544,1137,1989,7968,1999-2000
18,Cleveland Cavaliers,82,19855,2977,6734,0.442,343,919,0.373,2634,5815,0.453,1653,2205,0.75,1010,2499,3509,1941,715,363,1427,2219,7950,1999-2000
19,Washington Wizards,82,19805,3010,6681,0.451,335,890,0.376,2675,5791,0.462,1566,2107,0.743,1064,2438,3502,1771,593,383,1320,2149,7921,1999-2000
20,Utah Jazz,82,19755,2962,6380,0.464,329,854,0.385,2633,5526,0.476,1661,2150,0.773,936,2426,3362,2041,629,446,1220,2013,7914,1999-2000
21,San Antonio Spurs,82,19855,2952,6393,0.462,330,882,0.374,2622,5511,0.476,1652,2214,0.746,927,2666,3593,1819,614,551,1233,1716,7886,1999-2000
22,Golden State Warriors,82,19755,2996,7140,0.42,345,1069,0.323,2651,6071,0.437,1497,2147,0.697,1300,2438,3738,1851,731,356,1302,2043,7834,1999-2000
23,Philadelphia 76ers,82,19830,2993,6776,0.442,208,643,0.323,2785,6133,0.454,1577,2226,0.708,1147,2468,3615,1817,791,386,1284,1939,7771,1999-2000
24,Miami Heat,82,19830,2974,6462,0.46,446,1202,0.371,2528,5260,0.481,1345,1827,0.736,921,2619,3540,1931,582,524,1231,1947,7739,1999-2000
25,Atlanta Hawks,82,19830,3000,6807,0.441,258,814,0.317,2742,5993,0.458,1477,1987,0.743,1146,2570,3716,1548,500,461,1266,1718,7735,1999-2000
26,Vancouver Grizzlies,82,19855,2892,6441,0.449,324,898,0.361,2568,5543,0.463,1594,2060,0.774,1005,2324,3329,1700,608,346,1381,1881,7702,1999-2000
27,New York Knicks,82,19830,2897,6374,0.455,351,937,0.375,2546,5437,0.468,1410,1805,0.781,802,2521,3323,1588,515,349,1201,1983,7555,1999-2000
28,Los Angeles Clippers,82,19705,2877,6757,0.426,429,1267,0.339,2448,5490,0.446,1363,1826,0.746,955,2377,3332,1479,578,494,1325,1821,7546,1999-2000
29,Chicago Bulls,82,19805,2565,6180,0.415,340,1032,0.329,2225,5148,0.432,1482,2089,0.709,1032,2323,3355,1645,646,383,1557,1908,6952,1999-2000
1,Sacramento Kings,82,20080,3132,6969,0.449,479,1353,0.354,2653,5616,0.472,1600,2075,0.771,987,2705,3692,1852,793,432,1221,1596,8343,2000-2001
2,Milwaukee Bucks,82,19780,3112,6798,0.458,562,1481,0.379,2550,5317,0.48,1474,1874,0.787,975,2500,3475,1844,672,386,1123,1928,8260,2000-2001
3,Los Angeles Lakers,82,19905,3109,6685,0.465,439,1275,0.344,2670,5410,0.494,1594,2333,0.683,1085,2583,3668,1888,564,490,1184,1872,8251,2000-2001
4,Dallas Mavericks,82,19805,3085,6716,0.459,517,1357,0.381,2568,5359,0.479,1552,1954,0.794,831,2571,3402,1740,618,492,1141,1907,8239,2000-2001
5,Toronto Raptors,82,19955,3048,6972,0.437,429,1164,0.369,2619,5808,0.451,1482,1984,0.747,1118,2529,3647,2004,599,519,1080,1745,8007,2000-2001
6,Orlando Magic,82,19955,3013,6873,0.438,490,1346,0.364,2523,5527,0.456,1476,2068,0.714,1069,2450,3519,1803,674,481,1245,2071,7992,2000-2001
7,Minnesota Timberwolves,82,19830,3148,6871,0.458,322,901,0.357,2826,5970,0.473,1364,1737,0.785,1002,2470,3472,2083,682,456,1136,1900,7982,2000-2001
8,Seattle SuperSonics,82,19805,3029,6649,0.456,466,1169,0.399,2563,5480,0.468,1454,1986,0.732,999,2422,3421,1792,657,409,1252,1733,7978,2000-2001
9,Houston Rockets,82,19830,2943,6494,0.453,504,1412,0.357,2439,5082,0.48,1582,2086,0.758,919,2524,3443,1613,587,358,1204,1657,7972,2000-2001
10,Utah Jazz,82,19780,2960,6289,0.471,325,852,0.381,2635,5437,0.485,1714,2280,0.752,943,2383,3326,2110,661,463,1296,2107,7959,2000-2001
11,Denver Nuggets,82,19780,2979,6877,0.433,512,1444,0.355,2467,5433,0.454,1448,1964,0.737,1044,2583,3627,1970,552,538,1136,1820,7918,2000-2001
12,San Antonio Spurs,82,19830,2884,6262,0.461,445,1094,0.407,2439,5168,0.472,1673,2340,0.715,902,2712,3614,1778,568,576,1145,1551,7886,2000-2001
13,Detroit Pistons,82,19855,2919,6880,0.424,389,1112,0.35,2530,5768,0.439,1610,2233,0.721,1108,2626,3734,1629,613,447,1304,1955,7837,2000-2001
14,Portland Trail Blazers,82,19780,3004,6417,0.468,369,1057,0.349,2635,5360,0.492,1447,1899,0.762,960,2481,3441,1963,672,419,1257,1745,7824,2000-2001
15,Philadelphia 76ers,82,19855,2902,6487,0.447,262,803,0.326,2640,5684,0.464,1697,2277,0.745,1075,2600,3675,1692,690,408,1292,1673,7763,2000-2001
16,Boston Celtics,82,19830,2773,6485,0.428,592,1633,0.363,2181,4852,0.45,1621,2190,0.74,897,2367,3264,1708,769,336,1285,1952,7759,2000-2001
17,Phoenix Suns,82,19805,2944,6757,0.436,332,1054,0.315,2612,5703,0.458,1490,1973,0.755,970,2529,3499,1905,775,429,1250,1864,7710,2000-2001
18,Washington Wizards,82,19680,2833,6453,0.439,275,848,0.324,2558,5605,0.456,1704,2245,0.759,1016,2370,3386,1647,630,383,1391,1913,7645,2000-2001
19,Indiana Pacers,82,19980,2828,6431,0.44,396,1159,0.342,2432,5272,0.461,1539,2009,0.766,921,2595,3516,1763,563,487,1244,1926,7591,2000-2001
20,Golden State Warriors,82,19780,2937,7175,0.409,282,964,0.293,2655,6211,0.427,1428,2024,0.706,1345,2385,3730,1788,742,410,1301,1727,7584,2000-2001
21,Los Angeles Clippers,82,20030,2896,6467,0.448,360,1063,0.339,2536,5404,0.469,1429,2061,0.693,962,2559,3521,1585,490,513,1293,1775,7581,2000-2001
22,Cleveland Cavaliers,82,19830,2890,6532,0.442,220,659,0.334,2670,5873,0.455,1561,2040,0.765,1015,2440,3455,1708,642,436,1350,1904,7561,2000-2001
23,New Jersey Nets,82,19730,2781,6550,0.425,361,1084,0.333,2420,5466,0.443,1629,2146,0.759,909,2337,3246,1603,649,407,1208,1982,7552,2000-2001
24,Charlotte Hornets,82,19880,2800,6501,0.431,340,984,0.346,2460,5517,0.446,1599,2146,0.745,1033,2608,3641,1900,665,455,1183,1753,7539,2000-2001
25,Vancouver Grizzlies,82,19780,2870,6539,0.439,325,947,0.343,2545,5592,0.455,1457,1892,0.77,894,2431,3325,1899,586,359,1291,1733,7522,2000-2001
26,Atlanta Hawks,82,19730,2876,6668,0.431,333,933,0.357,2543,5735,0.443,1374,1811,0.759,1028,2490,3518,1559,634,387,1368,1863,7459,2000-2001
27,Miami Heat,82,19880,2694,6258,0.43,478,1384,0.345,2216,4874,0.455,1423,1874,0.759,813,2435,3248,1630,633,304,1122,1726,7289,2000-2001
28,New York Knicks,82,19905,2755,6198,0.444,391,1115,0.351,2364,5083,0.465,1374,1727,0.796,773,2524,3297,1520,545,346,1189,1863,7275,2000-2001
29,Chicago Bulls,82,19855,2721,6411,0.424,329,950,0.346,2392,5461,0.438,1410,1909,0.739,926,2260,3186,1810,675,379,1292,1902,7181,2000-2001
1,Dallas Mavericks,82,19880,3200,6930,0.462,621,1645,0.378,2579,5285,0.488,1608,1994,0.806,918,2568,3486,1811,581,392,992,1842,8629,2001-2002
2,Sacramento Kings,82,19755,3267,7003,0.467,426,1160,0.367,2841,5843,0.486,1618,2154,0.751,1013,2702,3715,1958,741,375,1128,1560,8578,2001-2002
3,Los Angeles Lakers,82,19780,3150,6840,0.461,510,1439,0.354,2640,5401,0.489,1494,2138,0.699,1022,2607,3629,1882,625,478,1040,1823,8304,2001-2002
4,Orlando Magic,82,19830,3087,6893,0.448,620,1660,0.373,2467,5233,0.471,1446,1917,0.754,942,2440,3382,1804,665,384,1119,1700,8240,2001-2002
5,Minnesota Timberwolves,82,19805,3175,6887,0.461,396,1047,0.378,2779,5840,0.476,1399,1754,0.798,1059,2562,3621,1993,524,427,1097,1739,8145,2001-2002
6,Seattle SuperSonics,82,19830,3131,6681,0.469,489,1292,0.378,2642,5389,0.49,1263,1672,0.755,968,2333,3301,1926,698,364,1124,1732,8014,2001-2002
7,Golden State Warriors,82,19780,2998,6989,0.429,320,994,0.322,2678,5995,0.447,1693,2344,0.722,1334,2493,3827,1706,650,523,1378,1884,8009,2001-2002
8,Milwaukee Bucks,82,19905,3041,6577,0.462,593,1583,0.375,2448,4994,0.49,1321,1767,0.748,841,2557,3398,1847,596,388,1157,1788,7996,2001-2002
9,Indiana Pacers,82,19905,2935,6580,0.446,405,1195,0.339,2530,5385,0.47,1663,2155,0.772,930,2568,3498,1884,658,436,1249,1876,7938,2001-2002
10,San Antonio Spurs,82,19855,2913,6363,0.458,438,1211,0.362,2475,5152,0.48,1668,2249,0.742,907,2566,3473,1643,625,537,1180,1575,7932,2001-2002
11,Portland Trail Blazers,82,19830,3004,6671,0.45,466,1318,0.354,2538,5353,0.474,1451,1901,0.763,1085,2444,3529,1926,702,368,1172,1613,7925,2001-2002
12,Boston Celtics,82,19830,2852,6731,0.424,699,1946,0.359,2153,4785,0.45,1498,1960,0.764,891,2570,3461,1722,793,292,1114,1776,7901,2001-2002
13,New Jersey Nets,82,19830,3042,6816,0.446,403,1194,0.338,2639,5622,0.469,1402,1907,0.735,1039,2515,3554,1990,716,490,1189,1734,7889,2001-2002
14,Utah Jazz,82,19830,2869,6374,0.45,280,842,0.333,2589,5532,0.468,1853,2430,0.763,1109,2349,3458,1999,749,523,1353,1971,7871,2001-2002
15,Los Angeles Clippers,82,19805,2970,6668,0.445,408,1147,0.356,2562,5521,0.464,1498,2026,0.739,1083,2474,3557,1714,510,540,1214,1624,7846,2001-2002
16,Cleveland Cavaliers,82,19855,2948,6582,0.448,387,1026,0.377,2561,5556,0.461,1529,1980,0.772,968,2483,3451,1891,572,470,1196,1752,7812,2001-2002
17,Phoenix Suns,82,19830,3097,6934,0.447,358,1096,0.327,2739,5838,0.469,1250,1630,0.767,1072,2430,3502,1838,668,401,1205,1785,7802,2001-2002
18,Detroit Pistons,82,19680,2845,6300,0.452,567,1509,0.376,2278,4791,0.475,1478,1954,0.756,810,2366,3176,1765,648,565,1193,1695,7735,2001-2002
19,Atlanta Hawks,82,19780,2901,6610,0.439,423,1194,0.354,2478,5416,0.458,1486,1942,0.765,955,2445,3400,1656,667,350,1275,1702,7711,2001-2002
20,Charlotte Hornets,82,19755,2893,6580,0.44,346,994,0.348,2547,5586,0.456,1568,2105,0.745,1059,2505,3564,1759,653,456,1150,1747,7700,2001-2002
21,Washington Wizards,82,19730,2938,6664,0.441,305,786,0.388,2633,5878,0.448,1428,1866,0.765,1055,2393,3448,1715,570,354,1068,1763,7609,2001-2002
22,Houston Rockets,82,19980,2837,6629,0.428,496,1480,0.335,2341,5149,0.455,1402,1893,0.741,1025,2411,3436,1482,537,445,1156,1476,7572,2001-2002
23,Denver Nuggets,82,19805,2915,6870,0.424,423,1285,0.329,2492,5585,0.446,1306,1756,0.744,1117,2310,3427,1817,613,462,1205,1873,7559,2001-2002
24,New York Knicks,82,19805,2817,6520,0.432,474,1344,0.353,2343,5176,0.453,1406,1786,0.787,876,2458,3334,1720,558,288,1192,1800,7514,2001-2002
25,Toronto Raptors,82,19755,2919,6727,0.434,387,1109,0.349,2532,5618,0.451,1269,1717,0.739,1114,2336,3450,1779,688,454,1174,1771,7494,2001-2002
26,Philadelphia 76ers,82,19730,2804,6436,0.436,214,715,0.299,2590,5721,0.453,1639,2104,0.779,1092,2534,3626,1638,705,363,1256,1645,7461,2001-2002
27,Memphis Grizzlies,82,19780,2851,6535,0.436,336,1096,0.307,2515,5439,0.462,1334,1883,0.708,984,2413,3397,1785,646,488,1344,1571,7372,2001-2002
28,Chicago Bulls,82,19805,2811,6491,0.433,300,868,0.346,2511,5623,0.447,1413,1958,0.722,924,2359,3283,1817,633,361,1252,1834,7335,2001-2002
29,Miami Heat,82,19930,2801,6382,0.439,312,899,0.347,2489,5483,0.454,1236,1708,0.724,902,2544,3446,1664,547,448,1217,1846,7150,2001-2002
1,Dallas Mavericks,82,19780,3161,6982,0.453,636,1668,0.381,2525,5314,0.475,1486,1793,0.829,912,2544,3456,1837,665,449,949,1730,8444,2002-2003
2,Golden State Warriors,82,19755,3061,6941,0.441,425,1235,0.344,2636,5706,0.462,1853,2382,0.778,1284,2546,3830,1712,594,506,1295,1786,8400,2002-2003
3,Sacramento Kings,82,19830,3242,6990,0.464,491,1288,0.381,2751,5702,0.482,1367,1832,0.746,900,2751,3651,2034,736,457,1192,1666,8342,2002-2003
4,Los Angeles Lakers,82,19930,3091,6856,0.451,486,1367,0.356,2605,5489,0.475,1562,2129,0.734,1078,2554,3632,1909,639,470,1192,1874,8230,2002-2003
5,Milwaukee Bucks,82,19905,3045,6670,0.457,585,1526,0.383,2460,5144,0.478,1483,1911,0.776,876,2367,3243,1823,622,344,1044,1820,8158,2002-2003
6,Orlando Magic,82,19805,2947,6763,0.436,568,1590,0.357,2379,5173,0.46,1616,2079,0.777,958,2392,3350,1676,696,300,1177,1888,8078,2002-2003
7,Minnesota Timberwolves,82,19805,3172,6809,0.466,296,804,0.368,2876,6005,0.479,1406,1826,0.77,959,2614,3573,2070,553,433,1124,1704,8046,2002-2003
8,Memphis Grizzlies,82,19930,3049,6743,0.452,467,1279,0.365,2582,5464,0.473,1430,1936,0.739,943,2466,3409,1892,651,500,1262,1678,7995,2002-2003
9,Philadelphia 76ers,82,19855,2975,6640,0.448,245,787,0.311,2730,5853,0.466,1746,2253,0.775,1042,2415,3457,1771,844,284,1212,1804,7941,2002-2003
10,Indiana Pacers,82,19905,2911,6608,0.441,379,1119,0.339,2532,5489,0.461,1739,2271,0.766,1004,2622,3626,1910,696,443,1210,1811,7940,2002-2003
11,New York Knicks,82,19855,2967,6725,0.441,606,1582,0.383,2361,5143,0.459,1320,1620,0.815,842,2376,3218,1800,579,255,1149,1888,7860,2002-2003
12,San Antonio Spurs,82,19830,2908,6297,0.462,449,1270,0.354,2459,5027,0.489,1591,2194,0.725,939,2556,3495,1636,629,529,1295,1672,7856,2002-2003
13,Phoenix Suns,82,19805,3005,6776,0.443,394,1149,0.343,2611,5627,0.464,1430,1928,0.742,1049,2440,3489,1719,665,404,1208,1801,7834,2002-2003
14,New Jersey Nets,82,19755,2906,6585,0.441,346,1041,0.332,2560,5544,0.462,1662,2195,0.757,991,2528,3519,1887,717,374,1212,1772,7820,2002-2003
15,Portland Trail Blazers,82,19855,2987,6491,0.46,379,1150,0.33,2608,5341,0.488,1450,1947,0.745,992,2378,3370,1860,725,316,1248,1634,7803,2002-2003
16,Chicago Bulls,82,19930,2991,6714,0.445,349,997,0.35,2642,5717,0.462,1455,2014,0.722,985,2541,3526,1782,605,461,1388,2028,7786,2002-2003
17,Utah Jazz,82,19780,2894,6189,0.468,224,641,0.349,2670,5548,0.481,1750,2349,0.745,1021,2381,3402,2103,708,467,1374,1837,7762,2002-2003
18,Atlanta Hawks,82,19905,2859,6434,0.444,402,1141,0.352,2457,5293,0.464,1594,2011,0.793,937,2558,3495,1679,611,473,1367,1783,7714,2002-2003
19,New Orleans Hornets,82,19905,2914,6695,0.435,404,1075,0.376,2510,5620,0.447,1467,1910,0.768,1097,2475,3572,1807,656,394,1212,1769,7699,2002-2003
20,Los Angeles Clippers,82,19755,2835,6490,0.437,390,1178,0.331,2445,5312,0.46,1633,2177,0.75,1008,2462,3470,1605,574,461,1291,1784,7693,2002-2003
21,Houston Rockets,82,19930,2840,6461,0.44,439,1267,0.346,2401,5194,0.462,1569,2044,0.768,1024,2564,3588,1506,594,493,1276,1602,7688,2002-2003
22,Boston Celtics,82,19830,2700,6509,0.415,719,2155,0.334,1981,4354,0.455,1480,1994,0.742,849,2471,3320,1575,720,303,1147,1758,7599,2002-2003
23,Seattle SuperSonics,82,19855,2887,6599,0.437,456,1291,0.353,2431,5308,0.458,1325,1780,0.744,963,2385,3348,1775,679,295,1085,1712,7555,2002-2003
24,Washington Wizards,82,19830,2816,6394,0.44,253,811,0.312,2563,5583,0.459,1617,2077,0.779,917,2395,3312,1612,621,390,1095,1644,7502,2002-2003
25,Cleveland Cavaliers,82,19830,2850,6746,0.422,293,896,0.327,2557,5850,0.437,1502,2012,0.747,1118,2542,3660,1712,636,521,1501,1864,7495,2002-2003
26,Detroit Pistons,82,19905,2700,6277,0.43,533,1488,0.358,2167,4789,0.452,1559,2021,0.771,883,2445,3328,1620,556,468,1104,1748,7492,2002-2003
27,Toronto Raptors,82,19805,2847,6664,0.427,409,1193,0.343,2438,5471,0.446,1350,1879,0.718,1023,2355,3378,1583,609,392,1181,1761,7453,2002-2003
28,Miami Heat,82,19830,2688,6517,0.412,348,1100,0.316,2340,5417,0.432,1292,1689,0.765,948,2464,3412,1501,592,324,1167,1856,7016,2002-2003
29,Denver Nuggets,82,19730,2689,6544,0.411,229,824,0.278,2460,5720,0.43,1294,1850,0.699,1112,2363,3475,1737,712,422,1514,2056,6901,2002-2003
1,Dallas Mavericks,82,19805,3322,7230,0.459,507,1456,0.348,2815,5774,0.488,1475,1854,0.796,1174,2538,3712,1963,656,437,1000,1609,8626,2003-2004
2,Sacramento Kings,82,19780,3103,6711,0.462,601,1498,0.401,2502,5213,0.48,1626,2044,0.795,888,2492,3380,2152,710,325,1137,1586,8433,2003-2004
3,Los Angeles Lakers,82,19855,3028,6676,0.454,365,1115,0.327,2663,5561,0.479,1631,2352,0.693,1001,2535,3536,1948,682,379,1132,1732,8052,2003-2004
4,Milwaukee Bucks,82,19780,2970,6650,0.447,401,1145,0.35,2569,5505,0.467,1698,2192,0.775,960,2502,3462,1872,554,383,1110,1668,8039,2003-2004
5,Denver Nuggets,82,19730,2993,6763,0.443,331,985,0.336,2662,5778,0.461,1655,2159,0.767,1083,2387,3470,1794,745,520,1278,1804,7972,2003-2004
6,Seattle SuperSonics,82,19805,2939,6590,0.446,723,1936,0.373,2216,4654,0.476,1363,1782,0.765,907,2318,3225,1782,661,387,1188,1784,7964,2003-2004
7,Memphis Grizzlies,82,19880,2963,6657,0.445,447,1314,0.34,2516,5343,0.471,1557,2143,0.727,1047,2381,3428,1915,795,565,1226,1903,7930,2003-2004
8,Boston Celtics,82,19705,2843,6415,0.443,553,1599,0.346,2290,4816,0.475,1572,2095,0.75,851,2440,3291,1683,770,331,1332,1837,7811,2003-2004
9,Los Angeles Clippers,82,19805,2817,6579,0.428,329,1024,0.321,2488,5555,0.448,1808,2302,0.785,1149,2416,3565,1653,594,376,1344,1816,7771,2003-2004
10,Minnesota Timberwolves,82,19755,3033,6571,0.462,326,897,0.363,2707,5674,0.477,1361,1743,0.781,875,2645,3520,1890,561,462,1043,1731,7753,2003-2004
11,Phoenix Suns,82,19730,2958,6671,0.443,415,1202,0.345,2543,5469,0.465,1392,1865,0.746,924,2406,3330,1586,734,383,1249,1862,7723,2003-2004
12,Orlando Magic,82,19830,2904,6768,0.429,429,1248,0.344,2475,5520,0.448,1474,2000,0.737,1003,2350,3353,1584,547,308,1123,1744,7711,2003-2004
13,Golden State Warriors,82,19855,2875,6511,0.442,429,1283,0.334,2446,5228,0.468,1470,2028,0.725,1002,2533,3535,1681,576,389,1211,1691,7649,2003-2004
14,Cleveland Cavaliers,82,19855,2922,6753,0.433,247,786,0.314,2675,5967,0.448,1528,2030,0.753,1118,2619,3737,1808,585,537,1216,1743,7619,2003-2004
15,Atlanta Hawks,82,19905,2829,6529,0.433,419,1249,0.335,2410,5280,0.456,1534,1976,0.776,996,2507,3503,1648,627,408,1350,1826,7611,2003-2004
16,New York Knicks,82,19880,2881,6513,0.442,406,1115,0.364,2475,5398,0.459,1374,1732,0.793,950,2543,3493,1695,608,391,1289,1897,7542,2003-2004
17,New Orleans Hornets,82,19830,2772,6605,0.42,531,1666,0.319,2241,4939,0.454,1454,1937,0.751,1091,2418,3509,1716,708,346,1228,1715,7529,2003-2004
18,Washington Wizards,82,19830,2758,6556,0.421,433,1269,0.341,2325,5287,0.44,1579,2211,0.714,1115,2392,3507,1537,733,406,1439,1712,7528,2003-2004
19,San Antonio Spurs,82,19755,2842,6434,0.442,408,1140,0.358,2434,5294,0.46,1409,2069,0.681,1029,2669,3698,1676,661,537,1203,1667,7501,2003-2004
20,Indiana Pacers,82,19805,2753,6322,0.435,449,1281,0.351,2304,5041,0.457,1538,2014,0.764,965,2452,3417,1774,726,411,1182,1709,7493,2003-2004
21,Portland Trail Blazers,82,19980,2898,6467,0.448,381,1102,0.346,2517,5365,0.469,1263,1728,0.731,1040,2376,3416,1768,613,443,1213,1554,7440,2003-2004
22,Miami Heat,82,19755,2729,6417,0.425,485,1357,0.357,2244,5060,0.443,1459,1915,0.762,940,2459,3399,1565,590,313,1137,1812,7402,2003-2004
23,New Jersey Nets,82,19705,2813,6372,0.441,377,1123,0.336,2436,5249,0.464,1398,1856,0.753,862,2473,3335,2009,709,322,1209,1722,7401,2003-2004
24,Detroit Pistons,82,19780,2747,6314,0.435,333,968,0.344,2414,5346,0.452,1561,2074,0.753,1014,2492,3506,1702,659,570,1241,1664,7388,2003-2004
25,Houston Rockets,82,19930,2738,6195,0.442,515,1406,0.366,2223,4789,0.464,1371,1774,0.773,847,2647,3494,1579,560,443,1373,1762,7362,2003-2004
26,Chicago Bulls,82,19830,2798,6753,0.414,429,1256,0.342,2369,5497,0.431,1330,1834,0.725,1048,2519,3567,1793,659,396,1321,1911,7355,2003-2004
27,Utah Jazz,82,19780,2690,6172,0.436,252,786,0.321,2438,5386,0.453,1639,2196,0.746,1103,2272,3375,1671,583,494,1365,2096,7271,2003-2004
28,Philadelphia 76ers,82,19855,2682,6260,0.428,339,992,0.342,2343,5268,0.445,1512,2009,0.753,941,2408,3349,1640,654,358,1307,1701,7215,2003-2004
29,Toronto Raptors,82,19980,2654,6348,0.418,461,1294,0.356,2193,5054,0.434,1237,1650,0.75,830,2419,3249,1574,604,402,1164,1748,7006,2003-2004
1,Phoenix Suns,82,19780,3351,7018,0.477,796,2026,0.393,2555,4992,0.512,1556,2080,0.748,967,2652,3619,1927,572,453,1125,1563,9054,2004-2005
2,Sacramento Kings,82,19855,3203,6978,0.459,522,1396,0.374,2681,5582,0.48,1577,2004,0.787,1023,2455,3478,2005,674,316,1073,1685,8505,2004-2005
3,Dallas Mavericks,82,19730,3058,6691,0.457,463,1273,0.364,2595,5418,0.479,1826,2314,0.789,990,2530,3520,1610,708,461,1102,1827,8405,2004-2005
4,Miami Heat,82,19980,3097,6368,0.486,475,1260,0.377,2622,5108,0.513,1658,2466,0.672,887,2639,3526,1790,528,474,1127,1814,8327,2004-2005
5,Boston Celtics,82,19880,3046,6511,0.468,437,1252,0.349,2609,5259,0.496,1775,2323,0.764,909,2438,3347,1810,667,423,1297,2000,8304,2004-2005
6,Washington Wizards,82,19780,2966,6794,0.437,514,1498,0.343,2452,5296,0.463,1795,2476,0.725,1133,2374,3507,1563,716,347,1172,1807,8241,2004-2005
7,Toronto Raptors,82,19805,2952,6656,0.444,648,1681,0.385,2304,4975,0.463,1626,2101,0.774,844,2444,3288,1670,621,317,1087,1876,8178,2004-2005
8,Denver Nuggets,82,19755,3038,6615,0.459,320,940,0.34,2718,5675,0.479,1765,2313,0.763,967,2473,3440,1958,750,489,1224,1878,8161,2004-2005
9,Orlando Magic,82,19705,3034,6679,0.454,320,916,0.349,2714,5763,0.471,1772,2335,0.759,1038,2544,3582,1583,633,441,1322,1937,8160,2004-2005
10,Philadelphia 76ers,82,19855,2946,6736,0.437,505,1453,0.348,2441,5283,0.462,1731,2194,0.789,909,2536,3445,1710,756,321,1274,1878,8128,2004-2005
11,Seattle SuperSonics,82,19755,2882,6498,0.444,666,1824,0.365,2216,4674,0.474,1683,2131,0.79,1041,2311,3352,1487,553,338,1113,1944,8113,2004-2005
12,Los Angeles Lakers,82,19780,2895,6629,0.437,644,1813,0.355,2251,4816,0.467,1661,2137,0.777,1028,2511,3539,1672,508,344,1176,1794,8095,2004-2005
13,Golden State Warriors,82,19905,3029,7039,0.43,624,1774,0.352,2405,5265,0.457,1412,1955,0.722,1069,2436,3505,1811,642,420,1112,1833,8094,2004-2005
14,New York Knicks,82,19880,2978,6599,0.451,441,1240,0.356,2537,5359,0.473,1580,2060,0.767,965,2393,3358,1665,629,260,1204,1942,7977,2004-2005
15,Milwaukee Bucks,82,19780,2964,6580,0.45,325,925,0.351,2639,5655,0.467,1720,2229,0.772,985,2405,3390,1720,529,289,1132,1797,7973,2004-2005
16,Minnesota Timberwolves,82,19755,3045,6629,0.459,395,1145,0.345,2650,5484,0.483,1449,1820,0.796,947,2580,3527,1918,460,447,1079,1774,7934,2004-2005
17,Cleveland Cavaliers,82,19855,2990,6687,0.447,300,904,0.332,2690,5783,0.465,1634,2174,0.752,1117,2352,3469,1851,654,461,1141,1850,7914,2004-2005
18,San Antonio Spurs,82,19805,2923,6450,0.453,507,1395,0.363,2416,5055,0.478,1535,2120,0.724,987,2489,3476,1771,613,543,1126,1717,7888,2004-2005
19,Los Angeles Clippers,82,20030,2924,6368,0.459,231,669,0.345,2693,5699,0.473,1770,2274,0.778,980,2455,3435,1901,599,422,1290,1819,7849,2004-2005
20,Houston Rockets,82,19855,2846,6419,0.443,553,1521,0.364,2293,4898,0.468,1551,1986,0.781,874,2601,3475,1733,563,378,1135,1807,7796,2004-2005
21,Chicago Bulls,82,19830,2849,6592,0.432,511,1433,0.357,2338,5159,0.453,1536,2048,0.75,1001,2591,3592,1743,576,369,1371,2028,7745,2004-2005
22,Charlotte Bobcats,82,19880,2961,6859,0.432,320,881,0.363,2641,5978,0.442,1487,2096,0.709,1083,2335,3418,1794,695,440,1192,1894,7729,2004-2005
23,Memphis Grizzlies,82,19705,2802,6271,0.447,531,1486,0.357,2271,4785,0.475,1526,2024,0.754,887,2307,3194,1716,699,476,1197,1910,7661,2004-2005
24,Detroit Pistons,82,19955,2851,6421,0.444,363,1053,0.345,2488,5368,0.463,1588,2150,0.739,1054,2507,3561,1787,576,497,1133,1638,7653,2004-2005
25,Indiana Pacers,82,19905,2668,6169,0.432,542,1575,0.344,2126,4594,0.463,1748,2206,0.792,868,2418,3286,1489,615,357,1173,1890,7626,2004-2005
26,Utah Jazz,82,19780,2828,6301,0.449,250,762,0.328,2578,5539,0.465,1719,2272,0.757,1047,2243,3290,1826,541,374,1292,2189,7625,2004-2005
27,Portland Trail Blazers,82,19730,2896,6422,0.451,420,1161,0.362,2476,5261,0.471,1409,1944,0.725,970,2404,3374,1722,583,544,1308,1703,7621,2004-2005
28,Atlanta Hawks,82,19855,2942,6672,0.441,304,973,0.312,2638,5699,0.463,1417,1994,0.711,1100,2335,3435,1614,629,344,1319,2009,7605,2004-2005
29,New Jersey Nets,82,19905,2753,6419,0.429,435,1203,0.362,2318,5216,0.444,1555,2039,0.763,855,2387,3242,1772,650,308,1164,1985,7496,2004-2005
30,New Orleans Hornets,82,19930,2718,6556,0.415,415,1316,0.315,2303,5240,0.44,1401,1830,0.766,1019,2281,3300,1724,550,310,1217,1883,7252,2004-2005
1,Phoenix Suns,82,19955,3430,7167,0.479,837,2097,0.399,2593,5070,0.511,1189,1475,0.806,778,2650,3428,2179,549,412,1088,1683,8886,2005-2006
2,Seattle SuperSonics,82,19830,3077,6711,0.459,605,1631,0.371,2472,5080,0.487,1652,2104,0.785,1013,2233,3246,1696,622,306,1208,1933,8411,2005-2006
3,Washington Wizards,82,19830,2975,6656,0.447,497,1394,0.357,2478,5262,0.471,1889,2496,0.757,1035,2344,3379,1523,658,339,1143,1855,8336,2005-2006
4,Toronto Raptors,82,19955,3013,6639,0.454,608,1620,0.375,2405,5019,0.479,1653,2089,0.791,864,2291,3155,1593,529,272,1071,1965,8287,2005-2006
5,Denver Nuggets,82,19930,3078,6672,0.461,350,1076,0.325,2728,5596,0.487,1721,2312,0.744,903,2486,3389,1921,698,463,1216,1863,8227,2005-2006
6,Miami Heat,82,19755,3039,6355,0.478,497,1441,0.345,2542,4914,0.517,1616,2310,0.7,858,2675,3533,1692,522,442,1186,1871,8191,2005-2006
7,Los Angeles Lakers,82,19855,2992,6607,0.453,552,1583,0.349,2440,5024,0.486,1618,2172,0.745,970,2488,3458,1734,628,350,1143,1894,8154,2005-2006
8,Philadelphia 76ers,82,19905,3001,6546,0.458,375,1031,0.364,2626,5515,0.476,1770,2330,0.76,873,2425,3298,1653,651,404,1159,1712,8147,2005-2006
9,Dallas Mavericks,82,19880,2948,6375,0.462,416,1113,0.374,2532,5262,0.481,1818,2322,0.783,1030,2431,3461,1473,593,488,1112,1834,8130,2005-2006
10,Sacramento Kings,82,19830,2954,6500,0.454,494,1408,0.351,2460,5092,0.483,1704,2173,0.784,852,2473,3325,1825,608,299,1199,1672,8106,2005-2006
11,Golden State Warriors,82,19830,2939,6785,0.433,625,1832,0.341,2314,4953,0.467,1573,2190,0.718,980,2485,3465,1694,604,357,1156,1941,8076,2005-2006
12,Boston Celtics,82,19880,2951,6322,0.467,467,1290,0.362,2484,5032,0.494,1664,2204,0.755,813,2432,3245,1716,578,422,1359,2033,8033,2005-2006
13,Milwaukee Bucks,82,19855,2976,6566,0.453,507,1335,0.38,2469,5231,0.472,1561,2115,0.738,929,2448,3377,1769,597,270,1197,1902,8020,2005-2006
14,Chicago Bulls,82,19905,3004,6737,0.446,560,1477,0.379,2444,5260,0.465,1452,1967,0.738,906,2602,3508,1804,508,345,1224,2038,8020,2005-2006
15,Cleveland Cavaliers,82,19830,2908,6412,0.454,497,1465,0.339,2411,4947,0.487,1689,2318,0.729,959,2511,3470,1560,567,392,1137,1733,8002,2005-2006
16,Atlanta Hawks,82,19880,2946,6496,0.454,424,1154,0.367,2522,5342,0.472,1656,2207,0.75,1069,2232,3301,1625,587,394,1284,2054,7972,2005-2006
17,Los Angeles Clippers,82,19805,2993,6443,0.465,290,843,0.344,2703,5600,0.483,1694,2142,0.791,828,2704,3532,1708,534,503,1185,1872,7970,2005-2006
18,Charlotte Bobcats,82,19905,2961,6843,0.433,428,1261,0.339,2533,5582,0.454,1593,2186,0.729,990,2270,3260,1717,822,354,1167,1960,7943,2005-2006
19,Detroit Pistons,82,19830,2983,6558,0.455,557,1451,0.384,2426,5107,0.475,1418,1950,0.727,975,2347,3322,1971,580,490,931,1513,7941,2005-2006
20,New York Knicks,82,19930,2822,6206,0.455,320,884,0.362,2502,5322,0.47,1878,2587,0.726,1034,2360,3394,1468,555,271,1449,2157,7842,2005-2006
21,San Antonio Spurs,82,19805,2993,6342,0.472,524,1362,0.385,2469,4980,0.496,1327,1891,0.702,851,2548,3399,1717,543,467,1126,1714,7837,2005-2006
22,Orlando Magic,82,19905,2911,6167,0.472,299,796,0.376,2612,5371,0.486,1663,2277,0.73,892,2402,3294,1495,532,362,1240,1908,7784,2005-2006
23,Indiana Pacers,82,19730,2786,6274,0.444,536,1536,0.349,2250,4738,0.475,1591,2158,0.737,898,2559,3457,1631,598,409,1254,1821,7699,2005-2006
24,New Jersey Nets,82,19780,2778,6317,0.44,477,1447,0.33,2301,4870,0.472,1658,2187,0.758,822,2539,3361,1884,558,278,1119,1903,7691,2005-2006
25,New Orleans/Oklahoma City Hornets,82,19805,2831,6428,0.44,300,885,0.339,2531,5543,0.457,1649,2176,0.758,918,2379,3297,1519,611,311,1095,1786,7611,2005-2006
26,Utah Jazz,82,19880,2744,6207,0.442,311,925,0.336,2433,5282,0.461,1774,2466,0.719,1071,2380,3451,1772,524,492,1290,2032,7573,2005-2006
27,Memphis Grizzlies,82,19855,2746,6125,0.448,590,1578,0.374,2156,4547,0.474,1476,2077,0.711,834,2379,3213,1586,600,442,1134,1757,7558,2005-2006
28,Minnesota Timberwolves,82,19855,2888,6340,0.456,310,942,0.329,2578,5398,0.478,1436,1895,0.758,811,2422,3233,1716,559,471,1189,1889,7522,2005-2006
29,Houston Rockets,82,19830,2708,6252,0.433,469,1414,0.332,2239,4838,0.463,1502,1980,0.759,849,2565,3414,1580,588,320,1193,1863,7387,2005-2006
30,Portland Trail Blazers,82,19730,2791,6267,0.445,364,1042,0.349,2427,5225,0.464,1339,1944,0.689,886,2203,3089,1490,529,435,1205,1828,7285,2005-2006
1,Phoenix Suns,82,19905,3388,6855,0.494,785,1965,0.399,2603,4890,0.532,1476,1827,0.808,737,2583,3320,2122,553,394,1189,1659,9037,2006-2007
2,Golden State Warriors,82,19755,3261,7048,0.463,700,1967,0.356,2561,5081,0.504,1515,2113,0.717,940,2456,3396,1950,750,466,1309,1933,8737,2006-2007
3,Denver Nuggets,82,19780,3164,6805,0.465,484,1440,0.336,2680,5365,0.5,1827,2449,0.746,1001,2558,3559,1920,678,435,1352,1756,8639,2006-2007
4,Washington Wizards,82,19830,3070,6820,0.45,561,1614,0.348,2509,5206,0.482,1855,2425,0.765,998,2379,3377,1660,635,375,1133,1823,8556,2006-2007
5,Los Angeles Lakers,82,20030,3103,6664,0.466,608,1724,0.353,2495,4940,0.505,1660,2221,0.747,886,2495,3381,1850,600,421,1273,1889,8474,2006-2007
6,Memphis Grizzlies,82,19980,2998,6448,0.465,500,1362,0.367,2498,5086,0.491,1835,2410,0.761,866,2375,3241,1680,564,407,1343,1827,8331,2006-2007
7,Utah Jazz,82,19805,3069,6471,0.474,354,1056,0.335,2715,5415,0.501,1830,2462,0.743,1030,2456,3486,2024,577,339,1277,2067,8322,2006-2007
8,Sacramento Kings,82,19805,2941,6532,0.45,530,1513,0.35,2411,5019,0.48,1891,2473,0.765,797,2396,3193,1665,671,265,1194,1792,8303,2006-2007
9,Dallas Mavericks,82,19755,3010,6442,0.467,535,1404,0.381,2475,5038,0.491,1646,2045,0.805,920,2515,3435,1632,560,408,1140,1837,8201,2006-2007
10,Milwaukee Bucks,82,19855,3121,6714,0.465,524,1472,0.356,2597,5242,0.495,1406,1919,0.733,941,2272,3213,1771,587,224,1240,1821,8172,2006-2007
11,Toronto Raptors,82,19755,3032,6547,0.463,531,1464,0.363,2501,5083,0.492,1562,1982,0.788,755,2480,3235,1822,581,321,1104,1672,8157,2006-2007
12,Seattle SuperSonics,82,19830,3047,6628,0.46,525,1451,0.362,2522,5177,0.487,1511,1911,0.791,928,2322,3250,1695,631,301,1268,1801,8130,2006-2007
13,Chicago Bulls,82,19780,3046,6663,0.457,480,1237,0.388,2566,5426,0.473,1528,2083,0.734,984,2597,3581,1832,639,445,1310,1908,8100,2006-2007
14,San Antonio Spurs,82,19780,2999,6328,0.474,595,1561,0.381,2404,4767,0.504,1486,1980,0.751,761,2577,3338,1814,587,417,1137,1588,8079,2006-2007
15,New Jersey Nets,82,19880,2913,6379,0.457,609,1676,0.363,2304,4703,0.49,1566,2153,0.727,822,2525,3347,1962,499,273,1212,1869,8001,2006-2007
16,New York Knicks,82,20005,2903,6356,0.457,474,1370,0.346,2429,4986,0.487,1714,2396,0.715,1032,2516,3548,1532,543,260,1405,1932,7994,2006-2007
17,Houston Rockets,82,19855,2906,6528,0.445,705,1893,0.372,2201,4635,0.475,1436,1906,0.753,880,2673,3553,1704,583,337,1162,1710,7953,2006-2007
18,Charlotte Bobcats,82,20005,2960,6643,0.446,457,1280,0.357,2503,5363,0.467,1568,2136,0.734,920,2346,3266,1836,638,369,1224,1985,7945,2006-2007
19,Cleveland Cavaliers,82,19880,2978,6658,0.447,494,1404,0.352,2484,5254,0.473,1484,2133,0.696,1039,2529,3568,1708,625,353,1177,1781,7934,2006-2007
20,Minnesota Timberwolves,82,20005,2997,6503,0.461,384,1089,0.353,2613,5414,0.483,1499,1892,0.792,819,2474,3293,1848,532,325,1278,1758,7877,2006-2007
21,Detroit Pistons,82,19880,2942,6484,0.454,449,1305,0.344,2493,5179,0.481,1539,1988,0.774,948,2374,3322,1768,583,472,1001,1672,7872,2006-2007
22,Boston Celtics,82,19855,2858,6454,0.443,471,1283,0.367,2387,5171,0.462,1670,2178,0.767,918,2391,3309,1630,589,382,1350,1971,7857,2006-2007
23,Los Angeles Clippers,82,19730,2880,6318,0.456,314,903,0.348,2566,5415,0.474,1769,2245,0.788,888,2484,3372,1762,596,472,1239,1858,7843,2006-2007
24,Indiana Pacers,82,19780,2872,6561,0.438,481,1389,0.346,2391,5172,0.462,1615,2125,0.76,990,2441,3431,1680,599,447,1335,1912,7840,2006-2007
25,New Orleans/Oklahoma City Hornets,82,19880,2971,6674,0.445,455,1256,0.362,2516,5418,0.464,1436,1941,0.74,1025,2512,3537,1537,522,347,1187,1620,7833,2006-2007
26,Philadelphia 76ers,82,19880,2932,6408,0.458,284,823,0.345,2648,5585,0.474,1637,2135,0.767,899,2353,3252,1669,590,390,1258,1671,7785,2006-2007
27,Orlando Magic,82,19780,2875,6090,0.472,342,962,0.356,2533,5128,0.494,1679,2393,0.702,920,2418,3338,1525,565,416,1392,1904,7771,2006-2007
28,Miami Heat,82,19855,2919,6288,0.464,528,1539,0.343,2391,4749,0.503,1393,2019,0.69,817,2526,3343,1681,566,442,1201,1749,7759,2006-2007
29,Portland Trail Blazers,82,19955,2874,6392,0.45,426,1232,0.346,2448,5160,0.474,1543,2006,0.769,923,2299,3222,1513,555,380,1236,1931,7717,2006-2007
30,Atlanta Hawks,82,19880,2831,6372,0.444,341,1038,0.329,2490,5334,0.467,1677,2203,0.761,976,2312,3288,1573,609,446,1306,1970,7680,2006-2007
1,Golden State Warriors,82,19780,3403,7406,0.459,761,2185,0.348,2642,5221,0.506,1538,2044,0.752,1045,2496,3541,1833,744,377,1082,1875,9105,2007-2008
2,Denver Nuggets,82,19855,3307,7038,0.47,569,1605,0.355,2738,5433,0.504,1891,2519,0.751,918,2698,3616,2024,752,551,1203,1731,9074,2007-2008
3,Phoenix Suns,82,19780,3392,6782,0.5,694,1764,0.393,2698,5018,0.538,1548,1977,0.783,720,2683,3403,2188,532,518,1184,1633,9026,2007-2008
4,Los Angeles Lakers,82,19780,3248,6818,0.476,662,1751,0.378,2586,5067,0.51,1746,2270,0.769,898,2722,3620,2003,654,438,1156,1691,8904,2007-2008
5,Utah Jazz,82,19705,3279,6592,0.497,407,1095,0.372,2872,5497,0.522,1745,2298,0.759,942,2410,3352,2165,717,355,1200,1970,8710,2007-2008
6,Orlando Magic,82,19780,3058,6446,0.474,801,2074,0.386,2257,4372,0.516,1650,2288,0.721,768,2677,3445,1706,520,333,1173,1688,8567,2007-2008
7,Indiana Pacers,82,19755,3102,6993,0.444,755,2021,0.374,2347,4972,0.472,1568,2042,0.768,904,2633,3537,1864,623,412,1236,1921,8527,2007-2008
8,Sacramento Kings,82,19830,3043,6558,0.464,510,1367,0.373,2533,5191,0.488,1812,2272,0.798,829,2456,3285,1567,651,334,1317,1839,8408,2007-2008
9,New Orleans Hornets,82,19805,3164,6796,0.466,630,1621,0.389,2534,5175,0.49,1312,1707,0.769,937,2494,3431,1785,637,321,974,1531,8270,2007-2008
10,Memphis Grizzlies,82,19805,3060,6737,0.454,620,1779,0.349,2440,4958,0.492,1517,2097,0.723,848,2567,3415,1574,503,386,1251,1592,8257,2007-2008
11,Boston Celtics,82,19755,2986,6286,0.475,596,1564,0.381,2390,4722,0.506,1677,2176,0.771,830,2615,3445,1833,696,379,1246,1864,8245,2007-2008
12,Dallas Mavericks,82,19730,3025,6515,0.464,494,1403,0.352,2531,5112,0.495,1690,2075,0.814,883,2643,3526,1720,490,402,1037,1786,8234,2007-2008
13,Toronto Raptors,82,19830,3148,6726,0.468,572,1459,0.392,2576,5267,0.489,1347,1658,0.812,790,2496,3286,1953,570,336,959,1596,8215,2007-2008
14,Washington Wizards,82,19905,2986,6695,0.446,575,1614,0.356,2411,5081,0.475,1557,1991,0.782,1007,2404,3411,1607,632,391,1082,1606,8104,2007-2008
15,Atlanta Hawks,82,19855,2975,6552,0.454,384,1078,0.356,2591,5474,0.473,1720,2227,0.772,1008,2454,3462,1804,600,448,1223,1673,8054,2007-2008
16,Seattle SuperSonics,82,19830,3125,7032,0.444,313,939,0.333,2812,6093,0.462,1436,1866,0.77,971,2688,3659,1748,531,400,1310,1680,7999,2007-2008
17,Detroit Pistons,82,19730,2999,6551,0.458,487,1330,0.366,2512,5221,0.481,1507,1965,0.767,974,2423,3397,1831,583,472,956,1688,7992,2007-2008
18,Chicago Bulls,82,19805,2987,6861,0.435,474,1305,0.363,2513,5556,0.452,1533,2029,0.756,1050,2478,3528,1811,635,429,1197,1784,7981,2007-2008
19,Charlotte Bobcats,82,19880,2960,6554,0.452,529,1443,0.367,2431,5111,0.476,1510,2115,0.714,892,2440,3332,1748,614,402,1204,1777,7959,2007-2008
20,Milwaukee Bucks,82,19855,3026,6745,0.449,452,1313,0.344,2574,5432,0.474,1452,1980,0.733,1055,2363,3418,1760,544,361,1210,1748,7956,2007-2008
21,New York Knicks,82,19880,2967,6757,0.439,490,1454,0.337,2477,5303,0.467,1524,2095,0.727,1029,2457,3486,1530,521,213,1187,1761,7948,2007-2008
22,Houston Rockets,82,19730,3003,6698,0.448,583,1707,0.342,2420,4991,0.485,1342,1848,0.726,1002,2659,3661,1757,598,420,1125,1609,7931,2007-2008
23,Philadelphia 76ers,82,19755,3056,6648,0.46,302,952,0.317,2754,5696,0.483,1509,2137,0.706,1067,2370,3437,1673,712,400,1172,1620,7923,2007-2008
24,Cleveland Cavaliers,82,19855,2937,6697,0.439,552,1544,0.358,2385,5153,0.463,1477,2061,0.717,1092,2563,3655,1640,579,427,1145,1712,7903,2007-2008
25,New Jersey Nets,82,19830,2856,6450,0.443,498,1430,0.348,2358,5020,0.47,1647,2237,0.736,913,2520,3433,1925,521,390,1229,1855,7857,2007-2008
26,Minnesota Timberwolves,82,19730,3076,6817,0.451,441,1259,0.35,2635,5558,0.474,1246,1693,0.736,964,2428,3392,1630,616,306,1188,1885,7839,2007-2008
27,Portland Trail Blazers,82,19905,2935,6546,0.448,538,1426,0.377,2397,5120,0.468,1412,1841,0.767,901,2438,3339,1733,455,360,1056,1642,7820,2007-2008
28,San Antonio Spurs,82,19730,2938,6424,0.457,594,1610,0.369,2344,4814,0.487,1350,1774,0.761,771,2612,3383,1718,521,337,1035,1537,7820,2007-2008
29,Los Angeles Clippers,82,19805,2820,6445,0.438,350,1079,0.324,2470,5366,0.46,1702,2178,0.781,800,2491,3291,1732,557,398,1180,1745,7692,2007-2008
30,Miami Heat,82,19830,2808,6336,0.443,491,1373,0.358,2317,4963,0.467,1384,1903,0.727,743,2342,3085,1644,589,355,1202,1670,7491,2007-2008
1,Phoenix Suns,82,19755,3373,6695,0.504,553,1445,0.383,2820,5250,0.537,1675,2251,0.744,900,2520,3420,1905,589,420,1288,1691,8974,2008-2009
2,Golden State Warriors,82,19880,3231,7055,0.458,550,1475,0.373,2681,5580,0.48,1893,2392,0.791,953,2492,3445,1711,638,527,1201,1842,8905,2008-2009
3,Los Angeles Lakers,82,19780,3307,6981,0.474,547,1516,0.361,2760,5465,0.505,1607,2087,0.77,1015,2587,3602,1908,718,420,1103,1698,8768,2008-2009
4,New York Knicks,82,19805,3157,7091,0.445,823,2284,0.36,2334,4807,0.486,1490,1900,0.784,911,2545,3456,1738,610,204,1174,1672,8627,2008-2009
5,Indiana Pacers,82,19830,3220,7080,0.455,652,1725,0.378,2568,5355,0.48,1525,1890,0.807,924,2661,3585,1775,573,434,1189,1895,8617,2008-2009
6,Denver Nuggets,82,19730,3058,6510,0.47,548,1477,0.371,2510,5033,0.499,1891,2487,0.76,905,2507,3412,1820,710,492,1257,1874,8555,2008-2009
7,Utah Jazz,82,19880,3143,6623,0.475,392,1122,0.349,2751,5501,0.5,1814,2352,0.771,940,2423,3363,2024,719,374,1210,1830,8492,2008-2009
8,Chicago Bulls,82,19930,3126,6846,0.457,493,1293,0.381,2633,5553,0.474,1633,2052,0.796,970,2481,3451,1732,615,453,1192,1709,8378,2008-2009
9,Dallas Mavericks,82,19805,3128,6770,0.462,571,1632,0.35,2557,5138,0.498,1516,1852,0.819,909,2595,3504,1779,591,429,1043,1600,8343,2008-2009
10,Orlando Magic,82,19730,2929,6416,0.457,817,2147,0.381,2112,4269,0.495,1611,2253,0.715,819,2728,3547,1593,570,439,1142,1664,8286,2008-2009
11,Boston Celtics,82,19880,3075,6333,0.486,538,1355,0.397,2537,4978,0.51,1587,2075,0.765,869,2586,3455,1862,621,387,1280,1897,8275,2008-2009
12,Sacramento Kings,82,19905,2990,6685,0.447,586,1594,0.368,2404,5091,0.472,1682,2107,0.798,840,2366,3206,1619,569,349,1266,1910,8248,2008-2009
13,Cleveland Cavaliers,82,19780,3022,6454,0.468,656,1670,0.393,2366,4784,0.495,1523,2012,0.757,886,2574,3460,1663,593,435,1045,1663,8223,2008-2009
14,Portland Trail Blazers,82,19830,3018,6494,0.465,596,1555,0.383,2422,4939,0.49,1521,1988,0.765,1060,2360,3420,1667,550,402,1055,1671,8153,2008-2009
15,Milwaukee Bucks,82,19780,3009,6755,0.445,511,1408,0.363,2498,5347,0.467,1613,2067,0.78,973,2367,3340,1802,609,308,1154,1986,8142,2008-2009
16,Toronto Raptors,82,19805,3054,6673,0.458,479,1289,0.372,2575,5384,0.478,1534,1861,0.824,802,2513,3315,1835,523,390,1098,1593,8121,2008-2009
17,Houston Rockets,82,19805,2959,6526,0.453,621,1656,0.375,2338,4870,0.48,1531,1903,0.805,862,2662,3524,1662,548,355,1158,1553,8070,2008-2009
18,Miami Heat,82,19955,3034,6646,0.457,582,1631,0.357,2452,5015,0.489,1411,1871,0.754,828,2411,3239,1671,651,451,1026,1696,8061,2008-2009
19,Atlanta Hawks,82,19705,2956,6451,0.458,597,1633,0.366,2359,4818,0.49,1537,2085,0.737,870,2412,3282,1657,603,376,1048,1610,8046,2008-2009
20,New Jersey Nets,82,19830,2925,6536,0.448,652,1735,0.376,2273,4801,0.473,1542,1980,0.779,850,2415,3265,1636,559,391,1075,1838,8044,2008-2009
21,Minnesota Timberwolves,82,19805,2986,6766,0.441,543,1539,0.353,2443,5227,0.467,1504,1957,0.769,975,2442,3417,1674,512,322,1165,1785,8019,2008-2009
22,Philadelphia 76ers,82,19755,2997,6532,0.459,341,1072,0.318,2656,5460,0.486,1652,2216,0.745,1039,2336,3375,1647,658,415,1157,1650,7987,2008-2009
23,San Antonio Spurs,82,19905,3042,6534,0.466,625,1620,0.386,2417,4914,0.492,1249,1641,0.761,728,2638,3366,1736,474,329,963,1546,7958,2008-2009
24,Oklahoma City Thunder,82,19805,2999,6716,0.447,328,949,0.346,2671,5767,0.463,1626,2069,0.786,999,2497,3496,1663,608,371,1330,1655,7952,2008-2009
25,Washington Wizards,82,19705,2994,6655,0.45,395,1198,0.33,2599,5457,0.476,1494,1948,0.767,956,2330,3286,1641,619,365,1146,1679,7877,2008-2009
26,New Orleans Hornets,82,19755,2911,6366,0.457,556,1526,0.364,2355,4840,0.487,1479,1833,0.807,802,2453,3255,1609,593,338,1029,1665,7857,2008-2009
27,Los Angeles Clippers,82,19880,2955,6696,0.441,535,1513,0.354,2420,5183,0.467,1354,1839,0.736,890,2377,3267,1723,572,482,1221,1650,7799,2008-2009
28,Detroit Pistons,82,19905,2981,6559,0.454,377,1079,0.349,2604,5480,0.475,1388,1849,0.751,949,2448,3397,1689,493,377,973,1712,7727,2008-2009
29,Memphis Grizzlies,82,19805,2865,6311,0.454,398,1106,0.36,2467,5205,0.474,1570,2077,0.756,847,2337,3184,1423,615,385,1252,1777,7698,2008-2009
30,Charlotte Bobcats,82,19930,2866,6299,0.455,490,1339,0.366,2376,4960,0.479,1455,1965,0.74,886,2366,3252,1741,580,397,1279,1754,7677,2008-2009
1,Phoenix Suns,82,19730,3339,6788,0.492,730,1770,0.412,2609,5018,0.52,1631,2117,0.77,910,2616,3526,1912,479,418,1210,1713,9039,2009-2010
2,Golden State Warriors,82,19730,3329,7094,0.469,633,1687,0.375,2696,5407,0.499,1631,2085,0.782,753,2397,3150,1839,761,340,1204,1886,8922,2009-2010
3,Denver Nuggets,82,19780,3124,6678,0.468,544,1517,0.359,2580,5161,0.5,1937,2508,0.772,889,2505,3394,1719,683,417,1136,1844,8729,2009-2010
4,Utah Jazz,82,19755,3227,6575,0.491,439,1207,0.364,2788,5368,0.519,1654,2233,0.741,872,2588,3460,2187,675,400,1246,1859,8547,2009-2010
5,Toronto Raptors,82,19780,3199,6631,0.482,518,1397,0.371,2681,5234,0.512,1618,2118,0.764,806,2507,3313,1804,469,384,1100,1819,8534,2009-2010
6,Orlando Magic,82,19730,3005,6394,0.47,841,2241,0.375,2164,4153,0.521,1575,2176,0.724,810,2736,3546,1615,512,456,1155,1629,8426,2009-2010
7,Memphis Grizzlies,82,19905,3223,6875,0.469,344,1020,0.337,2879,5855,0.492,1614,2202,0.733,1070,2496,3566,1543,645,399,1248,1655,8404,2009-2010
8,Houston Rockets,82,19905,3094,6923,0.447,646,1838,0.351,2448,5085,0.481,1561,2022,0.772,971,2471,3442,1790,583,318,1188,1712,8395,2009-2010
9,New York Knicks,82,19880,3127,6876,0.455,743,2145,0.346,2384,4731,0.504,1376,1759,0.782,836,2477,3313,1772,586,305,1148,1638,8373,2009-2010
10,Cleveland Cavaliers,82,19780,3101,6391,0.485,602,1582,0.381,2499,4809,0.52,1569,2180,0.72,791,2692,3483,1835,564,425,1137,1591,8373,2009-2010
11,Dallas Mavericks,82,19880,3140,6760,0.464,558,1498,0.372,2582,5262,0.491,1526,1870,0.816,834,2586,3420,1917,624,449,1059,1563,8364,2009-2010
12,Los Angeles Lakers,82,19830,3144,6875,0.457,532,1562,0.341,2612,5313,0.492,1519,1985,0.765,973,2662,3635,1730,612,400,1096,1592,8339,2009-2010
13,Atlanta Hawks,82,19855,3181,6801,0.468,524,1455,0.36,2657,5346,0.497,1452,1914,0.759,969,2451,3420,1789,592,413,980,1632,8338,2009-2010
14,Oklahoma City Thunder,82,19805,3063,6629,0.462,418,1229,0.34,2645,5400,0.49,1778,2210,0.805,960,2607,3567,1639,654,481,1227,1743,8322,2009-2010
15,San Antonio Spurs,82,19780,3150,6659,0.473,554,1547,0.358,2596,5112,0.508,1458,1969,0.74,887,2621,3508,1829,516,381,1116,1669,8312,2009-2010
16,Indiana Pacers,82,19705,3020,6823,0.443,659,1896,0.348,2361,4927,0.479,1564,2019,0.775,785,2618,3403,1730,585,439,1232,1848,8263,2009-2010
17,New Orleans Hornets,82,19830,3178,6842,0.464,571,1572,0.363,2607,5270,0.495,1293,1661,0.778,852,2450,3302,1828,625,300,1103,1606,8220,2009-2010
18,Sacramento Kings,82,19880,3144,6895,0.456,482,1383,0.349,2662,5512,0.483,1430,1969,0.726,977,2518,3495,1679,564,366,1226,1827,8200,2009-2010
19,Boston Celtics,82,19780,3039,6294,0.483,499,1433,0.348,2540,4861,0.523,1559,2090,0.746,716,2449,3165,1930,701,402,1219,1816,8136,2009-2010
20,Minnesota Timberwolves,82,19780,3106,6923,0.449,403,1181,0.341,2703,5742,0.471,1436,1926,0.746,962,2556,3518,1626,597,306,1333,1699,8051,2009-2010
21,Portland Trail Blazers,82,19855,2974,6453,0.461,491,1388,0.354,2483,5065,0.49,1606,2033,0.79,913,2383,3296,1674,523,350,1012,1715,8045,2009-2010
22,Philadelphia 76ers,82,19805,3087,6706,0.46,474,1381,0.343,2613,5325,0.491,1366,1808,0.756,941,2421,3362,1723,667,439,1192,1677,8014,2009-2010
23,Milwaukee Bucks,82,19980,3050,6998,0.436,645,1813,0.356,2405,5185,0.464,1264,1675,0.755,965,2560,3525,1740,580,385,1085,1823,8009,2009-2010
24,Chicago Bulls,82,19905,3081,6825,0.451,352,1066,0.33,2729,5759,0.474,1479,1962,0.754,937,2715,3652,1704,531,478,1175,1648,7993,2009-2010
25,Miami Heat,82,19880,2984,6518,0.458,494,1426,0.346,2490,5092,0.489,1452,1931,0.752,875,2553,3428,1548,605,457,1079,1710,7914,2009-2010
26,Washington Wizards,82,19830,3008,6700,0.449,432,1225,0.353,2576,5475,0.471,1444,1895,0.762,966,2458,3424,1557,493,421,1219,1752,7892,2009-2010
27,Los Angeles Clippers,82,19705,3002,6601,0.455,483,1457,0.332,2519,5144,0.49,1362,1867,0.73,927,2502,3429,1810,532,466,1285,1581,7849,2009-2010
28,Charlotte Bobcats,82,19880,2858,6306,0.453,460,1331,0.346,2398,4975,0.482,1637,2180,0.751,858,2490,3348,1658,632,446,1290,1597,7813,2009-2010
29,Detroit Pistons,82,19780,2940,6602,0.445,374,1190,0.314,2566,5412,0.474,1455,1998,0.728,1053,2242,3295,1591,596,313,1100,1822,7709,2009-2010
30,New Jersey Nets,82,19780,2813,6554,0.429,377,1185,0.318,2436,5369,0.454,1572,2015,0.78,897,2358,3255,1540,573,393,1182,1643,7575,2009-2010
1,Denver Nuggets,82,19705,3145,6613,0.476,662,1704,0.388,2483,4909,0.506,1859,2429,0.765,791,2652,3443,1813,605,352,1157,1719,8811,2010-2011
2,New York Knicks,82,19780,3140,6867,0.457,765,2081,0.368,2375,4786,0.496,1689,2087,0.809,847,2470,3317,1757,625,475,1123,1743,8734,2010-2011
3,Houston Rockets,82,19880,3170,6975,0.454,677,1843,0.367,2493,5132,0.486,1668,2083,0.801,962,2549,3511,1955,581,371,1110,1641,8685,2010-2011
4,Phoenix Suns,82,20005,3219,6844,0.47,701,1857,0.377,2518,4987,0.505,1472,1939,0.759,821,2478,3299,1945,545,357,1169,1666,8611,2010-2011
5,Oklahoma City Thunder,82,20005,3066,6609,0.464,487,1403,0.347,2579,5206,0.495,1977,2401,0.823,903,2604,3507,1672,654,487,1156,1836,8596,2010-2011
6,San Antonio Spurs,82,19780,3148,6628,0.475,685,1727,0.397,2463,4901,0.503,1521,1984,0.767,829,2603,3432,1836,602,372,1101,1556,8502,2010-2011
7,Golden State Warriors,82,19830,3251,7047,0.461,685,1749,0.392,2566,5298,0.484,1290,1695,0.761,955,2370,3325,1847,737,406,1198,1806,8477,2010-2011
8,Miami Heat,82,19780,3031,6301,0.481,547,1479,0.37,2484,4822,0.515,1760,2288,0.769,790,2666,3456,1639,544,430,1142,1674,8369,2010-2011
9,Los Angeles Lakers,82,19830,3128,6757,0.463,524,1487,0.352,2604,5270,0.494,1541,1979,0.779,989,2616,3605,1801,602,422,1073,1555,8321,2010-2011
10,Minnesota Timberwolves,82,19780,3090,7014,0.441,589,1565,0.376,2501,5449,0.459,1519,1977,0.768,1085,2556,3641,1650,592,422,1398,1825,8288,2010-2011
11,Dallas Mavericks,82,19705,3069,6463,0.475,645,1768,0.365,2424,4695,0.516,1437,1850,0.777,780,2618,3398,1954,557,352,1145,1575,8220,2010-2011
12,Memphis Grizzlies,82,19880,3200,6801,0.471,309,926,0.334,2891,5875,0.492,1486,1981,0.75,970,2391,3361,1691,771,441,1145,1705,8195,2010-2011
13,Indiana Pacers,82,19780,3003,6787,0.442,585,1653,0.354,2418,5134,0.471,1592,2035,0.782,914,2657,3571,1611,584,456,1262,1782,8183,2010-2011
14,Utah Jazz,82,19880,3064,6590,0.465,435,1256,0.346,2629,5334,0.493,1590,2061,0.771,898,2338,3236,1921,629,484,1175,1865,8153,2010-2011
15,Sacramento Kings,82,19855,3134,6979,0.449,428,1277,0.335,2706,5702,0.475,1455,1981,0.734,1071,2526,3597,1675,608,391,1324,1805,8151,2010-2011
16,Orlando Magic,82,19830,2956,6411,0.461,770,2103,0.366,2186,4308,0.507,1453,2101,0.692,864,2679,3543,1636,548,384,1224,1640,8135,2010-2011
17,Toronto Raptors,82,19780,3144,6755,0.465,345,1091,0.316,2799,5664,0.494,1491,1976,0.755,963,2343,3306,1795,581,350,1206,1807,8124,2010-2011
18,Philadelphia 76ers,82,19930,3125,6776,0.461,443,1248,0.355,2682,5528,0.485,1426,1851,0.77,850,2578,3428,1861,621,355,1063,1592,8119,2010-2011
19,Los Angeles Clippers,82,19855,3015,6594,0.457,513,1519,0.338,2502,5075,0.493,1546,2187,0.707,955,2501,3456,1813,585,402,1343,1733,8089,2010-2011
20,Chicago Bulls,82,19830,3042,6587,0.462,511,1415,0.361,2531,5172,0.489,1492,2008,0.743,967,2654,3621,1827,592,468,1161,1639,8087,2010-2011
21,Washington Wizards,82,19930,3048,6888,0.443,392,1182,0.332,2656,5706,0.465,1489,1999,0.745,1013,2374,3387,1592,665,502,1258,1850,7977,2010-2011
22,Detroit Pistons,82,19880,3056,6647,0.46,472,1256,0.376,2584,5391,0.479,1367,1854,0.737,931,2236,3167,1730,595,328,1067,1629,7951,2010-2011
23,Boston Celtics,82,19780,3023,6219,0.486,408,1119,0.365,2615,5100,0.513,1459,1895,0.77,639,2542,3181,1921,676,344,1195,1678,7913,2010-2011
24,Portland Trail Blazers,82,19805,2951,6599,0.447,518,1503,0.345,2433,5096,0.477,1476,1835,0.804,996,2230,3226,1736,660,358,1070,1585,7896,2010-2011
25,Cleveland Cavaliers,82,19755,2886,6647,0.434,509,1489,0.342,2377,5158,0.461,1546,2075,0.745,856,2449,3305,1720,544,341,1166,1648,7827,2010-2011
26,Atlanta Hawks,82,19730,2971,6429,0.462,502,1427,0.352,2469,5002,0.494,1346,1728,0.779,762,2460,3222,1802,497,341,1118,1554,7790,2010-2011
27,New Orleans Hornets,82,19830,2944,6416,0.459,444,1232,0.36,2500,5184,0.482,1452,1897,0.765,824,2468,3292,1691,624,359,1069,1719,7784,2010-2011
28,New Jersey Nets,82,20005,2918,6638,0.44,459,1337,0.343,2459,5301,0.464,1427,1881,0.759,909,2440,3349,1723,458,384,1152,1807,7722,2010-2011
29,Charlotte Bobcats,82,19805,2873,6365,0.451,393,1203,0.327,2480,5162,0.48,1511,1999,0.756,848,2444,3292,1728,524,433,1192,1637,7650,2010-2011
30,Milwaukee Bucks,82,19830,2814,6544,0.43,483,1414,0.342,2331,5130,0.454,1423,1881,0.757,862,2480,3342,1545,617,399,1103,1682,7534,2010-2011
1,Denver Nuggets,66,16040,2572,5404,0.476,435,1311,0.332,2137,4093,0.522,1293,1760,0.735,738,2105,2843,1581,540,330,1015,1297,6872,2011-2012
2,San Antonio Spurs,66,15940,2611,5463,0.478,552,1405,0.393,2059,4058,0.507,1067,1427,0.748,683,2153,2836,1528,490,293,895,1143,6841,2011-2012
3,Oklahoma City Thunder,66,15990,2462,5229,0.471,472,1317,0.358,1990,3912,0.509,1406,1744,0.806,726,2157,2883,1224,498,539,1079,1352,6802,2011-2012
4,Utah Jazz,66,16165,2523,5531,0.456,273,845,0.323,2250,4686,0.48,1258,1668,0.754,861,2055,2916,1439,545,385,936,1441,6577,2011-2012
5,Milwaukee Bucks,66,15865,2502,5652,0.443,436,1265,0.345,2066,4387,0.471,1095,1415,0.774,820,1983,2803,1550,548,335,929,1273,6535,2011-2012
6,Sacramento Kings,66,15915,2490,5712,0.436,411,1301,0.316,2079,4411,0.471,1127,1532,0.736,882,1947,2829,1271,561,323,952,1287,6518,2011-2012
7,Miami Heat,66,16040,2446,5212,0.469,370,1030,0.359,2076,4182,0.496,1238,1598,0.775,686,2060,2746,1317,585,355,1002,1282,6500,2011-2012
8,Phoenix Suns,66,15840,2495,5445,0.458,444,1295,0.343,2051,4150,0.494,1058,1397,0.757,717,2035,2752,1486,431,366,928,1233,6492,2011-2012
9,Houston Rockets,66,16065,2489,5543,0.449,478,1330,0.359,2011,4213,0.477,1018,1301,0.782,769,2014,2783,1404,496,319,955,1347,6474,2011-2012
10,Minnesota Timberwolves,66,15940,2355,5434,0.433,473,1423,0.332,1882,4011,0.469,1281,1662,0.771,797,2089,2886,1290,436,293,1001,1212,6464,2011-2012
11,New York Knicks,66,15940,2365,5335,0.443,517,1538,0.336,1848,3797,0.487,1211,1634,0.741,743,2012,2755,1328,622,276,1056,1391,6458,2011-2012
12,Golden State Warriors,66,15915,2489,5443,0.457,524,1351,0.388,1965,4092,0.48,951,1235,0.77,640,1947,2587,1470,528,362,915,1410,6453,2011-2012
13,Indiana Pacers,66,15990,2354,5375,0.438,392,1064,0.368,1962,4311,0.455,1349,1724,0.782,826,2070,2896,1228,523,357,925,1430,6449,2011-2012
14,Los Angeles Clippers,66,15965,2439,5366,0.455,514,1441,0.357,1925,3925,0.49,1046,1538,0.68,800,1943,2743,1385,556,315,879,1399,6438,2011-2012
15,Los Angeles Lakers,66,16065,2429,5319,0.457,362,1112,0.326,2067,4207,0.491,1202,1589,0.756,799,2251,3050,1485,390,351,997,1109,6422,2011-2012
16,Portland Trail Blazers,66,15965,2402,5417,0.443,478,1382,0.346,1924,4035,0.477,1133,1423,0.796,735,1949,2684,1349,528,322,935,1251,6415,2011-2012
17,Atlanta Hawks,66,16165,2429,5348,0.454,492,1330,0.37,1937,4018,0.482,1025,1385,0.74,652,2066,2718,1481,536,303,921,1178,6375,2011-2012
18,Chicago Bulls,66,15940,2467,5462,0.452,419,1117,0.375,2048,4345,0.471,1006,1394,0.722,915,2165,3080,1527,456,388,923,1139,6359,2011-2012
19,Dallas Mavericks,66,16065,2398,5412,0.443,497,1464,0.339,1901,3948,0.482,1029,1334,0.771,665,2157,2822,1380,565,337,926,1226,6322,2011-2012
20,Memphis Grizzlies,66,15940,2425,5422,0.447,277,849,0.326,2148,4573,0.47,1142,1504,0.759,831,1944,2775,1290,631,345,955,1316,6269,2011-2012
21,Orlando Magic,66,15965,2275,5162,0.441,670,1785,0.375,1605,3377,0.475,995,1508,0.66,742,2060,2802,1321,451,275,984,1168,6215,2011-2012
22,Washington Wizards,66,15865,2414,5475,0.441,344,1075,0.32,2070,4400,0.47,1008,1386,0.727,775,1975,2750,1262,527,417,1008,1405,6180,2011-2012
23,Philadelphia 76ers,66,15915,2471,5516,0.448,349,963,0.362,2122,4553,0.466,889,1198,0.742,704,2144,2848,1453,526,340,738,1157,6180,2011-2012
24,New Jersey Nets,66,15890,2262,5320,0.425,507,1481,0.342,1755,3839,0.457,1113,1433,0.777,783,1879,2662,1311,493,260,995,1268,6144,2011-2012
25,Cleveland Cavaliers,66,15965,2261,5360,0.422,440,1273,0.346,1821,4087,0.446,1178,1645,0.716,841,1949,2790,1308,466,262,1017,1317,6140,2011-2012
26,Boston Celtics,66,15940,2341,5086,0.46,363,988,0.367,1978,4098,0.483,1017,1308,0.778,509,2051,2560,1557,498,362,979,1315,6062,2011-2012
27,Detroit Pistons,66,15965,2291,5232,0.438,317,916,0.346,1974,4316,0.457,1098,1461,0.752,775,1882,2657,1232,460,278,1033,1293,5997,2011-2012
28,Toronto Raptors,66,15965,2268,5154,0.44,365,1075,0.34,1903,4079,0.467,1085,1410,0.77,697,2074,2771,1382,429,321,1001,1532,5986,2011-2012
29,New Orleans Hornets,66,15940,2300,5103,0.451,259,777,0.333,2041,4326,0.472,1057,1397,0.757,724,1991,2715,1368,488,316,1024,1324,5916,2011-2012
30,Charlotte Bobcats,66,15890,2193,5293,0.414,263,892,0.295,1930,4401,0.439,1090,1462,0.746,677,1894,2571,1326,397,361,957,1249,5739,2011-2012
1,Denver Nuggets,82,19905,3339,6983,0.478,521,1518,0.343,2818,5465,0.516,1505,2148,0.701,1092,2601,3693,2002,762,533,1253,1682,8704,2012-2013
2,Houston Rockets,82,19780,3124,6782,0.461,867,2369,0.366,2257,4413,0.511,1573,2087,0.754,909,2652,3561,1902,679,359,1348,1662,8688,2012-2013
3,Oklahoma City Thunder,82,19830,3126,6504,0.481,598,1588,0.377,2528,4916,0.514,1819,2196,0.828,854,2725,3579,1753,679,624,1253,1654,8669,2012-2013
4,San Antonio Spurs,82,19880,3210,6675,0.481,663,1764,0.376,2547,4911,0.519,1365,1725,0.791,666,2721,3387,2058,695,446,1206,1427,8448,2012-2013
5,Miami Heat,82,19880,3148,6348,0.496,717,1809,0.396,2431,4539,0.536,1423,1887,0.754,676,2490,3166,1890,710,441,1143,1533,8436,2012-2013
6,Los Angeles Lakers,82,19755,3041,6640,0.458,715,2015,0.355,2326,4625,0.503,1584,2289,0.692,942,2732,3674,1818,576,429,1232,1467,8381,2012-2013
7,Golden State Warriors,82,19805,3130,6840,0.458,658,1632,0.403,2472,5208,0.475,1378,1744,0.79,885,2801,3686,1845,567,346,1236,1753,8296,2012-2013
8,Dallas Mavericks,82,19980,3182,6892,0.462,606,1628,0.372,2576,5264,0.489,1323,1669,0.793,767,2670,3437,1906,648,454,1144,1698,8293,2012-2013
9,Los Angeles Clippers,82,19730,3160,6608,0.478,627,1752,0.358,2533,4856,0.522,1342,1888,0.711,938,2475,3413,1958,784,461,1197,1716,8289,2012-2013
10,Sacramento Kings,82,19830,3086,6904,0.447,610,1681,0.363,2476,5223,0.474,1437,1869,0.769,943,2385,3328,1708,671,342,1199,1717,8219,2012-2013
11,New York Knicks,82,19730,2996,6689,0.448,891,2371,0.376,2105,4318,0.487,1313,1729,0.759,890,2436,3326,1579,672,294,988,1650,8196,2012-2013
12,Milwaukee Bucks,82,19830,3128,7197,0.435,601,1670,0.36,2527,5527,0.457,1251,1700,0.736,1068,2537,3605,1876,685,550,1156,1554,8108,2012-2013
13,Utah Jazz,82,19880,3046,6710,0.454,507,1385,0.366,2539,5325,0.477,1439,1883,0.764,989,2457,3446,1859,690,515,1210,1750,8038,2012-2013
14,Atlanta Hawks,82,19855,3084,6644,0.464,706,1901,0.371,2378,4743,0.501,1158,1619,0.715,758,2593,3351,2007,664,369,1219,1473,8032,2012-2013
15,Portland Trail Blazers,82,19855,3009,6715,0.448,673,1904,0.353,2336,4811,0.486,1304,1680,0.776,874,2474,3348,1784,538,353,1203,1518,7995,2012-2013
16,Toronto Raptors,82,19980,2979,6685,0.446,571,1665,0.343,2408,5020,0.48,1442,1831,0.788,871,2426,3297,1765,595,392,1124,1836,7971,2012-2013
17,Brooklyn Nets,82,19855,2942,6544,0.45,628,1760,0.357,2314,4784,0.484,1432,1958,0.731,1047,2460,3507,1668,599,391,1206,1500,7944,2012-2013
18,Cleveland Cavaliers,82,19730,2993,6901,0.434,547,1581,0.346,2446,5320,0.46,1380,1826,0.756,1004,2359,3363,1694,647,334,1149,1737,7913,2012-2013
19,Minnesota Timberwolves,82,19730,2943,6702,0.439,450,1475,0.305,2493,5227,0.477,1515,2042,0.742,973,2473,3446,1836,700,387,1214,1509,7851,2012-2013
20,Boston Celtics,81,19840,3001,6459,0.465,498,1390,0.358,2503,5069,0.494,1318,1698,0.776,654,2533,3187,1843,667,365,1181,1717,7818,2012-2013
21,Phoenix Suns,82,19805,3061,6917,0.443,480,1455,0.33,2581,5462,0.473,1203,1618,0.744,959,2454,3413,1855,659,434,1278,1688,7805,2012-2013
22,Detroit Pistons,82,19805,2979,6638,0.449,513,1440,0.356,2466,5198,0.474,1307,1870,0.699,991,2463,3454,1742,574,400,1241,1623,7778,2012-2013
23,Orlando Magic,82,19780,3093,6904,0.448,506,1537,0.329,2587,5367,0.482,1026,1359,0.755,890,2612,3502,1871,528,358,1191,1591,7718,2012-2013
24,New Orleans Hornets,82,19780,2955,6589,0.448,535,1474,0.363,2420,5115,0.473,1269,1636,0.776,988,2426,3414,1721,520,440,1193,1673,7714,2012-2013
25,Indiana Pacers,81,19590,2845,6525,0.436,555,1599,0.347,2290,4926,0.465,1429,1915,0.746,1043,2671,3714,1645,580,513,1227,1623,7674,2012-2013
26,Charlotte Bobcats,82,19805,2823,6649,0.425,469,1399,0.335,2354,5250,0.448,1546,2060,0.75,917,2389,3306,1587,591,479,1153,1561,7661,2012-2013
27,Memphis Grizzlies,82,19805,2964,6679,0.444,382,1107,0.345,2582,5572,0.463,1349,1746,0.773,1059,2445,3504,1715,703,436,1144,1660,7659,2012-2013
28,Washington Wizards,82,19855,2910,6693,0.435,545,1495,0.365,2365,5198,0.455,1279,1746,0.733,887,2652,3539,1775,598,376,1238,1681,7644,2012-2013
29,Chicago Bulls,82,19830,2926,6698,0.437,446,1265,0.353,2480,5433,0.456,1343,1738,0.773,1026,2514,3540,1886,588,417,1171,1617,7641,2012-2013
30,Philadelphia 76ers,82,19755,3059,6895,0.444,518,1438,0.36,2541,5457,0.466,1004,1377,0.729,896,2493,3389,1867,609,384,1070,1505,7640,2012-2013
1,Los Angeles Clippers,82,19755,3208,6761,0.474,693,1966,0.352,2515,4795,0.525,1741,2384,0.73,858,2668,3526,2016,703,397,1136,1767,8850,2013-2014
2,Houston Rockets,82,19830,3118,6603,0.472,779,2179,0.358,2339,4424,0.529,1814,2549,0.712,920,2797,3717,1755,621,461,1323,1676,8829,2013-2014
3,Minnesota Timberwolves,82,19855,3189,7175,0.444,600,1757,0.341,2589,5418,0.478,1790,2301,0.778,1024,2644,3668,1963,718,297,1142,1504,8768,2013-2014
4,Portland Trail Blazers,82,19855,3207,7134,0.45,770,2071,0.372,2437,5063,0.481,1569,1926,0.815,1022,2786,3808,1904,454,387,1125,1576,8753,2013-2014
5,Oklahoma City Thunder,82,19805,3194,6782,0.471,664,1839,0.361,2530,4943,0.512,1653,2052,0.806,887,2781,3668,1794,678,501,1256,1858,8705,2013-2014
6,San Antonio Spurs,82,19755,3326,6844,0.486,698,1757,0.397,2628,5087,0.517,1289,1642,0.785,762,2786,3548,2064,604,420,1180,1495,8639,2013-2014
7,Phoenix Suns,82,19755,3172,6845,0.463,765,2055,0.372,2407,4790,0.503,1520,2004,0.758,928,2601,3529,1563,688,374,1258,1798,8629,2013-2014
8,Dallas Mavericks,82,19830,3249,6858,0.474,721,1877,0.384,2528,4981,0.508,1378,1733,0.795,840,2514,3354,1935,704,356,1110,1636,8597,2013-2014
9,Denver Nuggets,82,19755,3147,7042,0.447,702,1959,0.358,2445,5083,0.481,1563,2154,0.726,1009,2717,3726,1838,615,459,1305,1890,8559,2013-2014
10,Golden State Warriors,82,19830,3236,7005,0.462,774,2037,0.38,2462,4968,0.496,1303,1731,0.753,896,2819,3715,1912,642,407,1247,1784,8549,2013-2014
11,Los Angeles Lakers,82,19705,3139,6980,0.45,774,2032,0.381,2365,4948,0.478,1390,1835,0.757,745,2620,3365,2006,611,446,1239,1627,8442,2013-2014
12,Miami Heat,82,19880,3142,6272,0.501,665,1829,0.364,2477,4443,0.558,1431,1884,0.76,627,2397,3024,1847,732,367,1212,1596,8380,2013-2014
13,Toronto Raptors,82,19955,2992,6718,0.445,713,1917,0.372,2279,4801,0.475,1608,2055,0.782,935,2552,3487,1737,577,343,1159,1882,8305,2013-2014
14,Detroit Pistons,82,19780,3182,7124,0.447,507,1580,0.321,2675,5544,0.483,1415,2111,0.67,1196,2525,3721,1714,687,395,1193,1666,8286,2013-2014
15,Atlanta Hawks,82,19830,3061,6688,0.458,768,2116,0.363,2293,4572,0.502,1392,1782,0.781,713,2565,3278,2041,680,326,1251,1577,8282,2013-2014
16,Washington Wizards,82,20055,3177,6920,0.459,647,1704,0.38,2530,5216,0.485,1253,1715,0.731,886,2573,3459,1909,668,377,1204,1675,8254,2013-2014
17,Sacramento Kings,82,19830,3026,6766,0.447,491,1475,0.333,2535,5291,0.479,1698,2237,0.759,990,2656,3646,1547,587,318,1249,1849,8241,2013-2014
18,New Orleans Pelicans,82,19855,3101,6761,0.459,486,1303,0.373,2615,5458,0.479,1489,1936,0.769,933,2486,3419,1745,647,523,1129,1857,8177,2013-2014
19,Philadelphia 76ers,82,19855,3108,7150,0.435,577,1847,0.312,2531,5303,0.477,1362,1918,0.71,949,2556,3505,1791,765,330,1384,1844,8155,2013-2014
20,New York Knicks,82,19855,3027,6739,0.449,759,2038,0.372,2268,4701,0.482,1271,1670,0.761,870,2437,3307,1641,631,367,1063,1815,8084,2013-2014
21,Brooklyn Nets,82,19880,2931,6391,0.459,709,1922,0.369,2222,4469,0.497,1508,2002,0.753,721,2407,3128,1714,705,311,1191,1777,8079,2013-2014
22,Cleveland Cavaliers,82,19930,3036,6955,0.437,584,1640,0.356,2452,5315,0.461,1398,1861,0.751,989,2629,3618,1738,579,304,1163,1640,8054,2013-2014
23,Charlotte Bobcats,82,19905,2976,6730,0.442,516,1471,0.351,2460,5259,0.468,1474,2000,0.737,776,2724,3500,1778,499,421,1010,1493,7942,2013-2014
24,Indiana Pacers,82,19780,2949,6573,0.449,550,1542,0.357,2399,5031,0.477,1485,1907,0.779,834,2831,3665,1651,550,446,1237,1675,7933,2013-2014
25,Orlando Magic,82,19955,3022,6784,0.445,563,1596,0.353,2459,5188,0.474,1307,1714,0.763,794,2654,3448,1726,630,350,1222,1678,7914,2013-2014
26,Boston Celtics,82,19730,2996,6883,0.435,575,1729,0.333,2421,5154,0.47,1325,1706,0.777,980,2505,3485,1726,584,343,1261,1743,7892,2013-2014
27,Memphis Grizzlies,82,19805,3122,6723,0.464,405,1147,0.353,2717,5576,0.487,1235,1666,0.741,950,2526,3476,1792,631,375,1124,1568,7884,2013-2014
28,Milwaukee Bucks,82,19880,2952,6737,0.438,548,1553,0.353,2404,5184,0.464,1377,1843,0.747,971,2399,3370,1760,541,403,1238,1713,7829,2013-2014
29,Utah Jazz,82,19780,2951,6652,0.444,543,1577,0.344,2408,5075,0.474,1346,1803,0.747,904,2477,3381,1664,570,366,1200,1699,7791,2013-2014
30,Chicago Bulls,82,19930,2843,6577,0.432,508,1459,0.348,2335,5118,0.456,1486,1908,0.779,937,2683,3620,1860,594,424,1223,1565,7680,2013-2014
1,Golden State Warriors,82,19730,3410,7137,0.478,883,2217,0.398,2527,4920,0.514,1313,1709,0.768,853,2814,3667,2248,762,496,1185,1628,9016,2014-2015
2,Los Angeles Clippers,82,19730,3228,6830,0.473,827,2202,0.376,2401,4628,0.519,1468,2067,0.71,784,2711,3495,2031,640,409,1012,1749,8751,2014-2015
3,Dallas Mavericks,82,19880,3255,7036,0.463,732,2082,0.352,2523,4954,0.509,1386,1843,0.752,858,2608,3466,1846,663,371,1062,1644,8628,2014-2015
4,Toronto Raptors,82,19855,3108,6829,0.455,726,2060,0.352,2382,4769,0.499,1585,2014,0.787,881,2526,3407,1701,615,357,1057,1712,8527,2014-2015
5,Oklahoma City Thunder,82,19830,3184,7119,0.447,632,1864,0.339,2552,5255,0.486,1524,2020,0.754,1052,2844,3896,1681,598,454,1205,1829,8524,2014-2015
6,Houston Rockets,82,19805,3032,6832,0.444,933,2680,0.348,2099,4152,0.506,1525,2133,0.715,958,2624,3582,1820,777,407,1366,1803,8522,2014-2015
7,San Antonio Spurs,82,19955,3208,6854,0.468,677,1847,0.367,2531,5007,0.505,1368,1754,0.78,806,2772,3578,2000,657,444,1146,1564,8461,2014-2015
8,Cleveland Cavaliers,82,19780,3089,6739,0.458,826,2253,0.367,2263,4486,0.504,1453,1934,0.751,911,2612,3523,1814,603,340,1171,1510,8457,2014-2015
9,Portland Trail Blazers,82,19855,3175,7049,0.45,807,2231,0.362,2368,4818,0.491,1272,1589,0.801,879,2881,3760,1799,525,372,1117,1494,8429,2014-2015
10,Atlanta Hawks,82,19730,3121,6699,0.466,818,2152,0.38,2303,4547,0.506,1349,1735,0.778,715,2611,3326,2111,744,380,1167,1457,8409,2014-2015
11,Phoenix Suns,82,19880,3178,7038,0.452,698,2048,0.341,2480,4990,0.497,1343,1767,0.76,896,2643,3539,1659,700,385,1238,1744,8397,2014-2015
12,Denver Nuggets,82,19880,3099,7158,0.433,660,2032,0.325,2439,5126,0.476,1462,1991,0.734,1012,2653,3665,1788,641,367,1166,1882,8320,2014-2015
13,Boston Celtics,82,19880,3193,7211,0.443,660,2021,0.327,2533,5190,0.488,1266,1678,0.754,910,2685,3595,2009,674,294,1133,1738,8312,2014-2015
14,Sacramento Kings,82,19855,3010,6617,0.455,461,1350,0.341,2549,5267,0.484,1829,2400,0.762,895,2728,3623,1667,550,324,1333,1696,8310,2014-2015
15,Chicago Bulls,82,19880,3001,6797,0.442,645,1825,0.353,2356,4972,0.474,1618,2067,0.783,959,2792,3751,1781,514,476,1145,1495,8265,2014-2015
16,New Orleans Pelicans,82,19780,3108,6795,0.457,586,1583,0.37,2522,5212,0.484,1345,1790,0.751,942,2621,3563,1806,553,510,1087,1530,8147,2014-2015
17,Washington Wizards,82,19955,3139,6790,0.462,497,1381,0.36,2642,5409,0.488,1305,1758,0.742,862,2801,3663,1969,601,378,1233,1707,8080,2014-2015
18,Detroit Pistons,82,19830,3041,7038,0.432,703,2043,0.344,2338,4995,0.468,1292,1838,0.703,1051,2630,3681,1771,623,383,1099,1559,8077,2014-2015
19,Los Angeles Lakers,82,19930,3054,7020,0.435,532,1546,0.344,2522,5474,0.461,1433,1935,0.741,952,2647,3599,1715,578,366,1086,1741,8073,2014-2015
20,Memphis Grizzlies,82,19905,3097,6763,0.458,423,1246,0.339,2674,5517,0.485,1445,1869,0.773,856,2634,3490,1777,700,347,1094,1567,8062,2014-2015
21,Brooklyn Nets,82,19930,3069,6804,0.451,541,1633,0.331,2528,5171,0.489,1359,1817,0.748,846,2627,3473,1716,576,340,1133,1579,8038,2014-2015
22,Milwaukee Bucks,82,19930,3083,6722,0.459,545,1500,0.363,2538,5222,0.486,1312,1734,0.757,876,2574,3450,1932,789,403,1373,1814,8023,2014-2015
23,Minnesota Timberwolves,82,19805,2986,6820,0.438,406,1223,0.332,2580,5597,0.461,1638,2110,0.776,949,2406,3355,1771,668,327,1231,1571,8016,2014-2015
24,Indiana Pacers,82,19855,2998,6824,0.439,612,1740,0.352,2386,5084,0.469,1373,1817,0.756,856,2822,3678,1757,505,375,1147,1742,7981,2014-2015
25,Orlando Magic,82,19755,3076,6792,0.453,554,1598,0.347,2522,5194,0.486,1141,1565,0.729,822,2607,3429,1692,647,314,1221,1714,7847,2014-2015
26,Utah Jazz,82,19705,2900,6492,0.447,610,1781,0.343,2290,4711,0.486,1391,1929,0.721,988,2617,3605,1632,623,489,1256,1583,7801,2014-2015
27,Miami Heat,82,19730,2885,6330,0.456,556,1659,0.335,2329,4671,0.499,1438,1940,0.741,747,2461,3208,1626,642,372,1214,1636,7764,2014-2015
28,Charlotte Hornets,82,19905,2913,6932,0.42,498,1566,0.318,2415,5366,0.45,1397,1867,0.748,820,2793,3613,1654,499,448,976,1494,7721,2014-2015
29,Philadelphia 76ers,82,19805,2765,6777,0.408,692,2160,0.32,2073,4617,0.449,1320,1953,0.676,978,2536,3514,1683,789,487,1453,1778,7542,2014-2015
30,New York Knicks,82,19855,2882,6726,0.428,560,1614,0.347,2322,5112,0.454,1211,1575,0.769,867,2443,3310,1746,575,382,1206,1768,7535,2014-2015
1,Golden State Warriors,82,19880,3489,7159,0.487,1077,2592,0.416,2412,4567,0.528,1366,1790,0.763,816,2972,3788,2373,689,498,1245,1701,9421,2015-2016
2,Oklahoma City Thunder,82,19830,3372,7082,0.476,678,1945,0.349,2694,5137,0.524,1616,2067,0.782,1071,2916,3987,1883,603,487,1305,1691,9038,2015-2016
3,Sacramento Kings,82,19805,3283,7083,0.464,660,1839,0.359,2623,5244,0.5,1514,2089,0.725,868,2760,3628,2009,733,368,1326,1676,8740,2015-2016
4,Houston Rockets,82,19830,3094,6847,0.452,878,2533,0.347,2216,4314,0.514,1671,2407,0.694,930,2601,3531,1821,821,430,1307,1790,8737,2015-2016
5,Boston Celtics,82,19780,3216,7318,0.439,717,2142,0.335,2499,5176,0.483,1520,1929,0.788,950,2733,3683,1981,752,348,1127,1796,8669,2015-2016
6,Portland Trail Blazers,82,19805,3167,7040,0.45,864,2336,0.37,2303,4704,0.49,1424,1889,0.754,948,2782,3730,1748,562,380,1200,1782,8622,2015-2016
7,Los Angeles Clippers,82,19830,3141,6759,0.465,797,2190,0.364,2344,4569,0.513,1490,2152,0.692,721,2727,3448,1873,709,460,1063,1746,8569,2015-2016
8,Cleveland Cavaliers,82,19855,3171,6888,0.46,880,2428,0.362,2291,4460,0.514,1333,1783,0.748,873,2777,3650,1861,551,317,1114,1666,8555,2015-2016
9,Washington Wizards,82,19755,3238,7033,0.46,709,1983,0.358,2529,5050,0.501,1349,1849,0.73,743,2688,3431,2005,708,323,1186,1708,8534,2015-2016
10,San Antonio Spurs,82,19705,3289,6797,0.484,570,1518,0.375,2719,5279,0.515,1342,1672,0.803,770,2831,3601,2010,677,485,1071,1433,8490,2015-2016
11,Charlotte Hornets,82,19855,3036,6922,0.439,873,2410,0.362,2163,4512,0.479,1534,1941,0.79,734,2869,3603,1778,595,438,1029,1487,8479,2015-2016
12,Atlanta Hawks,82,19830,3168,6923,0.458,815,2326,0.35,2353,4597,0.512,1282,1638,0.783,679,2772,3451,2100,747,486,1226,1570,8433,2015-2016
13,New Orleans Pelicans,82,19780,3153,7040,0.448,702,1951,0.36,2451,5089,0.482,1415,1823,0.776,782,2712,3494,1818,633,342,1102,1713,8423,2015-2016
14,Toronto Raptors,82,19780,3006,6669,0.451,708,1915,0.37,2298,4754,0.483,1702,2190,0.777,836,2724,3560,1536,636,449,1073,1610,8422,2015-2016
15,Minnesota Timberwolves,82,19880,3095,6668,0.464,455,1347,0.338,2640,5321,0.496,1753,2213,0.792,821,2587,3408,1916,656,375,1231,1696,8398,2015-2016
16,Dallas Mavericks,82,20005,3064,6900,0.444,806,2342,0.344,2258,4558,0.495,1454,1831,0.794,751,2781,3532,1813,560,306,1047,1595,8388,2015-2016
17,Indiana Pacers,82,19880,3142,6985,0.45,663,1889,0.351,2479,5096,0.486,1430,1872,0.764,847,2779,3626,1741,742,391,1219,1641,8377,2015-2016
18,Orlando Magic,82,19905,3242,7120,0.455,636,1818,0.35,2606,5302,0.492,1249,1649,0.757,843,2709,3552,1933,673,417,1155,1701,8369,2015-2016
19,Detroit Pistons,82,19880,3111,7087,0.439,740,2148,0.345,2371,4939,0.48,1399,2095,0.668,1021,2777,3798,1594,573,304,1110,1557,8361,2015-2016
20,Denver Nuggets,82,19830,3093,7003,0.442,656,1943,0.338,2437,5060,0.482,1513,1974,0.766,941,2718,3659,1858,609,395,1202,1723,8355,2015-2016
21,Chicago Bulls,82,19905,3165,7170,0.441,651,1753,0.371,2514,5417,0.464,1354,1720,0.787,907,2889,3796,1870,495,470,1141,1545,8335,2015-2016
22,Phoenix Suns,82,19705,3051,7018,0.435,738,2118,0.348,2313,4900,0.472,1431,1905,0.751,943,2733,3676,1701,632,313,1410,1858,8271,2015-2016
23,Miami Heat,82,19830,3150,6697,0.47,498,1480,0.336,2652,5217,0.508,1406,1889,0.744,807,2811,3618,1709,553,531,1155,1502,8204,2015-2016
24,Memphis Grizzlies,82,19830,3019,6859,0.44,504,1521,0.331,2515,5338,0.471,1584,2024,0.783,916,2497,3413,1697,724,350,1090,1783,8126,2015-2016
25,Milwaukee Bucks,82,19830,3145,6740,0.467,440,1277,0.345,2705,5463,0.495,1392,1863,0.747,858,2559,3417,1895,672,475,1247,1695,8122,2015-2016
26,Brooklyn Nets,82,19755,3136,6920,0.453,531,1508,0.352,2605,5412,0.481,1286,1699,0.757,863,2614,3477,1829,627,332,1212,1476,8089,2015-2016
27,New York Knicks,82,19805,3022,6886,0.439,610,1762,0.346,2412,5124,0.471,1411,1753,0.805,850,2788,3638,1682,467,466,1099,1616,8065,2015-2016
28,Utah Jazz,82,19955,2957,6593,0.449,694,1956,0.355,2263,4637,0.488,1402,1885,0.744,880,2665,3545,1555,631,425,1224,1655,8010,2015-2016
29,Philadelphia 76ers,82,19805,2970,6887,0.431,764,2255,0.339,2206,4632,0.476,1284,1850,0.694,777,2605,3382,1765,680,495,1343,1780,7988,2015-2016
30,Los Angeles Lakers,82,19730,2880,6956,0.414,639,2016,0.317,2241,4940,0.454,1583,2028,0.781,878,2645,3523,1478,593,337,1124,1662,7982,2015-2016
1,Golden State Warriors,82,19780,3532,7140,0.495,982,2562,0.383,2550,4578,0.557,1457,1850,0.788,770,2873,3643,2491,785,555,1211,1585,9503,2016-2017
2,Houston Rockets,82,19780,3305,7152,0.462,1181,3306,0.357,2124,3846,0.552,1667,2177,0.766,892,2746,3638,2070,670,352,1240,1634,9458,2016-2017
3,Denver Nuggets,82,19755,3377,7194,0.469,870,2365,0.368,2507,4829,0.519,1537,1986,0.774,966,2837,3803,2077,568,323,1226,1567,9161,2016-2017
4,Cleveland Cavaliers,82,19880,3275,6963,0.47,1067,2779,0.384,2208,4184,0.528,1431,1913,0.748,766,2821,3587,1858,539,327,1121,1486,9048,2016-2017
5,Washington Wizards,82,19855,3388,7137,0.475,756,2030,0.372,2632,5107,0.515,1421,1812,0.784,843,2671,3514,1956,693,336,1162,1745,8953,2016-2017
6,Los Angeles Clippers,82,19755,3242,6820,0.475,841,2245,0.375,2401,4575,0.525,1586,2128,0.745,738,2790,3528,1848,612,347,1062,1626,8911,2016-2017
7,Boston Celtics,82,19755,3168,6978,0.454,985,2742,0.359,2183,4236,0.515,1536,1903,0.807,744,2698,3442,2069,617,340,1088,1686,8857,2016-2017
8,Portland Trail Blazers,82,19930,3243,7059,0.459,852,2272,0.375,2391,4787,0.499,1513,1940,0.78,830,2750,3580,1733,574,408,1126,1736,8851,2016-2017
9,Phoenix Suns,82,19830,3270,7260,0.45,615,1854,0.332,2655,5406,0.491,1676,2159,0.776,976,2712,3688,1604,673,399,1265,2030,8831,2016-2017
10,Toronto Raptors,82,19780,3211,6918,0.464,725,1996,0.363,2486,4922,0.505,1615,2028,0.796,871,2676,3547,1517,677,400,1041,1708,8762,2016-2017
11,Oklahoma City Thunder,82,19805,3237,7169,0.452,692,2116,0.327,2545,5053,0.504,1575,2113,0.745,1002,2821,3823,1721,648,408,1230,1715,8741,2016-2017
12,Brooklyn Nets,82,19755,3102,6987,0.444,877,2591,0.338,2225,4396,0.506,1592,2020,0.788,721,2879,3600,1756,593,387,1356,1726,8673,2016-2017
13,Minnesota Timberwolves,82,19805,3235,6922,0.467,601,1723,0.349,2634,5199,0.507,1586,1986,0.799,938,2540,3478,1940,654,370,1150,1646,8657,2016-2017
14,San Antonio Spurs,82,19805,3222,6864,0.469,753,1927,0.391,2469,4937,0.5,1440,1806,0.797,821,2777,3598,1954,655,484,1101,1498,8637,2016-2017
15,Indiana Pacers,82,19855,3221,6931,0.465,709,1885,0.376,2512,5046,0.498,1467,1811,0.81,742,2702,3444,1844,669,409,1130,1597,8618,2016-2017
16,Charlotte Hornets,82,19830,3093,7000,0.442,824,2347,0.351,2269,4653,0.488,1591,1953,0.815,721,2853,3574,1891,571,390,942,1360,8601,2016-2017
17,Los Angeles Lakers,82,19705,3224,7164,0.45,730,2110,0.346,2494,5054,0.493,1397,1853,0.754,933,2636,3569,1716,674,320,1243,1698,8575,2016-2017
18,New Orleans Pelicans,82,19905,3210,7130,0.45,768,2196,0.35,2442,4934,0.495,1368,1825,0.75,703,2879,3582,1869,638,453,1054,1490,8556,2016-2017
19,New York Knicks,82,19855,3244,7256,0.447,704,2022,0.348,2540,5234,0.485,1364,1731,0.788,983,2723,3706,1786,581,455,1139,1668,8556,2016-2017
20,Milwaukee Bucks,82,19780,3182,6715,0.474,720,1946,0.37,2462,4769,0.516,1413,1839,0.768,723,2589,3312,1984,666,436,1145,1660,8497,2016-2017
21,Miami Heat,82,19780,3202,7037,0.455,808,2213,0.365,2394,4824,0.496,1248,1768,0.706,872,2705,3577,1742,588,469,1102,1680,8460,2016-2017
22,Atlanta Hawks,82,19880,3123,6918,0.451,729,2137,0.341,2394,4781,0.501,1484,2039,0.728,842,2793,3635,1938,672,397,1294,1491,8459,2016-2017
23,Chicago Bulls,82,19780,3169,7141,0.444,623,1831,0.34,2546,5310,0.479,1474,1848,0.798,999,2797,3796,1851,643,393,1112,1455,8435,2016-2017
24,Sacramento Kings,82,19880,3105,6734,0.461,737,1960,0.376,2368,4774,0.496,1483,1913,0.775,715,2652,3367,1844,627,324,1201,1667,8430,2016-2017
25,Philadelphia 76ers,82,19830,3088,6992,0.442,831,2443,0.34,2257,4549,0.496,1393,1806,0.771,807,2706,3513,1949,692,420,1366,1793,8400,2016-2017
26,Detroit Pistons,82,19805,3269,7282,0.449,631,1915,0.33,2638,5367,0.492,1140,1586,0.719,908,2838,3746,1732,574,310,973,1467,8309,2016-2017
27,Orlando Magic,82,19805,3139,7133,0.44,701,2139,0.328,2438,4994,0.488,1309,1753,0.747,807,2734,3541,1820,580,396,1091,1584,8288,2016-2017
28,Utah Jazz,82,19755,3033,6515,0.466,791,2128,0.372,2242,4387,0.511,1401,1875,0.747,771,2774,3545,1651,550,410,1118,1545,8258,2016-2017
29,Memphis Grizzlies,82,19905,2984,6854,0.435,767,2169,0.354,2217,4685,0.473,1504,1918,0.784,886,2621,3507,1744,653,344,1059,1840,8239,2016-2017
30,Dallas Mavericks,82,19780,2968,6750,0.44,878,2473,0.355,2090,4277,0.489,1215,1516,0.801,647,2516,3163,1705,614,307,972,1567,8029,2016-2017
1,Golden State Warriors,82,19730,3509,6981,0.503,926,2370,0.391,2583,4611,0.56,1360,1668,0.815,691,2877,3568,2402,656,612,1265,1607,9304,2017-2018
2,Houston Rockets,82,19755,3174,6906,0.46,1256,3470,0.362,1918,3436,0.558,1609,2061,0.781,739,2825,3564,1767,699,392,1135,1597,9213,2017-2018
3,New Orleans Pelicans,82,19955,3500,7241,0.483,837,2312,0.362,2663,4929,0.54,1324,1716,0.772,712,2924,3636,2195,657,485,1223,1570,9161,2017-2018
4,Toronto Raptors,82,19830,3383,7169,0.472,968,2705,0.358,2415,4464,0.541,1422,1790,0.794,800,2807,3607,1995,626,500,1095,1783,9156,2017-2018
5,Cleveland Cavaliers,82,19730,3311,6950,0.476,981,2636,0.372,2330,4314,0.54,1488,1909,0.779,694,2761,3455,1916,582,312,1126,1524,9091,2017-2018
6,Denver Nuggets,82,19880,3338,7102,0.47,940,2536,0.371,2398,4566,0.525,1404,1830,0.767,902,2748,3650,2059,627,404,1226,1533,9020,2017-2018
7,Philadelphia 76ers,82,19780,3349,7098,0.472,901,2445,0.369,2448,4653,0.526,1405,1868,0.752,893,2996,3889,2221,682,420,1353,1811,9004,2017-2018
8,Minnesota Timberwolves,82,19805,3365,7063,0.476,658,1845,0.357,2707,5218,0.519,1592,1980,0.804,848,2593,3441,1861,689,345,1021,1495,8980,2017-2018
9,Los Angeles Clippers,82,19705,3302,7004,0.471,777,2196,0.354,2525,4808,0.525,1556,2095,0.743,832,2766,3598,1832,628,373,1204,1638,8937,2017-2018
10,Charlotte Hornets,82,19780,3197,7106,0.45,824,2233,0.369,2373,4873,0.487,1656,2216,0.747,827,2901,3728,1770,559,373,1041,1409,8874,2017-2018
11,Los Angeles Lakers,82,19905,3338,7248,0.461,822,2384,0.345,2516,4864,0.517,1364,1910,0.714,876,2927,3803,1949,633,388,1295,1736,8862,2017-2018
12,Oklahoma City Thunder,82,19830,3271,7221,0.453,881,2491,0.354,2390,4730,0.505,1421,1985,0.716,1024,2671,3695,1750,743,412,1147,1653,8844,2017-2018
13,Washington Wizards,82,19855,3275,7018,0.467,814,2173,0.375,2461,4845,0.508,1378,1786,0.772,823,2713,3536,2065,645,353,1196,1746,8742,2017-2018
14,Brooklyn Nets,82,19855,3136,7114,0.441,1041,2924,0.356,2095,4190,0.5,1428,1850,0.772,792,2852,3644,1941,512,390,1245,1688,8741,2017-2018
15,Milwaukee Bucks,82,19830,3257,6807,0.478,718,2024,0.355,2539,4783,0.531,1499,1915,0.783,688,2579,3267,1905,722,443,1135,1752,8731,2017-2018
16,Portland Trail Blazers,82,19755,3222,7132,0.452,845,2308,0.366,2377,4824,0.493,1372,1715,0.8,835,2893,3728,1599,573,423,1109,1599,8661,2017-2018
17,Indiana Pacers,82,19755,3345,7083,0.472,741,2010,0.369,2604,5073,0.513,1225,1573,0.779,788,2684,3472,1819,721,340,1088,1544,8656,2017-2018
18,New York Knicks,82,19830,3334,7193,0.464,673,1914,0.352,2661,5279,0.504,1225,1557,0.787,859,2752,3611,1912,552,421,1208,1682,8566,2017-2018
19,Utah Jazz,82,19755,3139,6797,0.462,887,2425,0.366,2252,4372,0.515,1375,1766,0.779,740,2807,3547,1839,708,420,1205,1608,8540,2017-2018
20,Boston Celtics,82,19805,3141,6975,0.45,939,2492,0.377,2202,4483,0.491,1308,1697,0.771,767,2878,3645,1842,604,373,1149,1618,8529,2017-2018
21,Phoenix Suns,82,19705,3153,7141,0.442,763,2286,0.334,2390,4855,0.492,1453,1962,0.741,842,2776,3618,1743,569,370,1289,1807,8522,2017-2018
22,Detroit Pistons,82,19805,3208,7129,0.45,886,2373,0.373,2322,4756,0.488,1207,1621,0.745,830,2756,3586,1868,628,317,1102,1508,8509,2017-2018
23,Miami Heat,82,19930,3184,6997,0.455,903,2506,0.36,2281,4491,0.508,1209,1601,0.755,763,2801,3564,1862,620,437,1178,1648,8480,2017-2018
24,Orlando Magic,82,19730,3182,7042,0.452,844,2405,0.351,2338,4637,0.504,1271,1678,0.757,722,2692,3414,1921,622,400,1192,1579,8479,2017-2018
25,Atlanta Hawks,82,19705,3130,7015,0.446,917,2544,0.36,2213,4471,0.495,1298,1654,0.785,743,2693,3436,1946,638,348,1275,1606,8475,2017-2018
26,Chicago Bulls,82,19855,3170,7285,0.435,906,2549,0.355,2264,4736,0.478,1194,1574,0.759,790,2873,3663,1923,626,289,1147,1571,8440,2017-2018
27,San Antonio Spurs,82,19730,3202,6999,0.457,696,1977,0.352,2506,5022,0.499,1324,1715,0.772,849,2777,3626,1868,628,460,1078,1408,8424,2017-2018
28,Dallas Mavericks,82,19805,3128,7042,0.444,967,2688,0.36,2161,4354,0.496,1167,1530,0.763,666,2717,3383,1858,578,310,1007,1578,8390,2017-2018
29,Memphis Grizzlies,82,19705,3013,6788,0.444,758,2152,0.352,2255,4636,0.486,1361,1732,0.786,779,2544,3323,1767,613,396,1227,1900,8145,2017-2018
30,Sacramento Kings,82,19755,3179,7063,0.45,738,1967,0.375,2441,5096,0.479,1008,1371,0.735,777,2578,3355,1768,643,340,1125,1639,8104,2017-2018
1,Milwaukee Bucks,82,19780,3555,7471,0.476,1105,3134,0.353,2450,4337,0.565,1471,1904,0.773,762,3316,4078,2136,615,486,1137,1608,9686,2018-2019
2,Golden State Warriors,82,19805,3612,7361,0.491,1087,2824,0.385,2525,4537,0.557,1339,1672,0.801,797,2990,3787,2413,625,525,1169,1757,9650,2018-2019
3,New Orleans Pelicans,82,19755,3581,7563,0.473,842,2449,0.344,2739,5114,0.536,1462,1921,0.761,909,2969,3878,2216,610,441,1215,1732,9466,2018-2019
4,Philadelphia 76ers,82,19805,3407,7233,0.471,889,2474,0.359,2518,4759,0.529,1742,2258,0.771,892,3025,3917,2207,606,432,1223,1745,9445,2018-2019
5,Los Angeles Clippers,82,19830,3384,7178,0.471,821,2118,0.388,2563,5060,0.507,1853,2340,0.792,796,2936,3732,1970,561,385,1193,1913,9442,2018-2019
6,Portland Trail Blazers,82,19855,3470,7427,0.467,904,2520,0.359,2566,4907,0.523,1558,1914,0.814,967,2968,3935,1887,546,413,1135,1669,9402,2018-2019
7,Oklahoma City Thunder,82,19855,3497,7706,0.454,932,2677,0.348,2565,5029,0.51,1461,2049,0.713,1031,2911,3942,1917,766,425,1145,1839,9387,2018-2019
8,Toronto Raptors,82,19880,3460,7305,0.474,1015,2771,0.366,2445,4534,0.539,1449,1803,0.804,786,2920,3706,2085,680,437,1150,1724,9384,2018-2019
9,Sacramento Kings,82,19730,3541,7637,0.464,927,2455,0.378,2614,5182,0.504,1354,1865,0.726,906,2819,3725,2083,679,363,1095,1751,9363,2018-2019
10,Washington Wizards,82,19930,3456,7387,0.468,930,2731,0.341,2526,4656,0.543,1508,1963,0.768,794,2679,3473,2154,683,379,1154,1701,9350,2018-2019
11,Houston Rockets,82,19830,3218,7163,0.449,1323,3721,0.356,1895,3442,0.551,1582,2001,0.791,836,2613,3449,1741,700,405,1094,1803,9341,2018-2019
12,Atlanta Hawks,82,19855,3392,7524,0.451,1067,3034,0.352,2325,4490,0.518,1443,1918,0.752,955,2825,3780,2118,675,419,1397,1932,9294,2018-2019
13,Minnesota Timberwolves,82,19830,3413,7483,0.456,827,2357,0.351,2586,5126,0.504,1570,1995,0.787,923,2750,3673,2018,683,411,1074,1664,9223,2018-2019
14,Boston Celtics,82,19780,3451,7423,0.465,1032,2829,0.365,2419,4594,0.527,1282,1598,0.802,804,2849,3653,2155,706,435,1052,1670,9216,2018-2019
15,Brooklyn Nets,82,19980,3301,7358,0.449,1047,2965,0.353,2254,4393,0.513,1555,2088,0.745,900,2919,3819,1954,539,339,1236,1763,9204,2018-2019
16,Los Angeles Lakers,82,19780,3491,7425,0.47,847,2541,0.333,2644,4884,0.541,1336,1910,0.699,835,2985,3820,2096,618,440,1284,1701,9165,2018-2019
17,Utah Jazz,82,19755,3314,7082,0.468,993,2789,0.356,2321,4293,0.541,1540,2092,0.736,820,2981,3801,2133,663,483,1240,1728,9161,2018-2019
18,San Antonio Spurs,82,19805,3468,7248,0.478,812,2071,0.392,2656,5177,0.513,1408,1720,0.819,757,2910,3667,2013,501,386,992,1487,9156,2018-2019
19,Charlotte Hornets,82,19830,3297,7362,0.448,977,2783,0.351,2320,4579,0.507,1510,1895,0.797,814,2778,3592,1905,591,405,1001,1550,9081,2018-2019
20,Denver Nuggets,82,19730,3439,7384,0.466,903,2571,0.351,2536,4813,0.527,1294,1714,0.755,972,2832,3804,2245,634,363,1102,1644,9075,2018-2019
21,Dallas Mavericks,82,19780,3182,7122,0.447,1022,3002,0.34,2160,4120,0.524,1541,2076,0.742,832,2884,3716,1918,533,351,1167,1650,8927,2018-2019
22,Indiana Pacers,82,19705,3390,7135,0.475,779,2081,0.374,2611,5054,0.517,1298,1727,0.752,762,2766,3528,2128,713,404,1122,1594,8857,2018-2019
23,Phoenix Suns,82,19880,3289,7164,0.459,790,2400,0.329,2499,4764,0.525,1447,1858,0.779,748,2563,3311,1957,735,418,1279,1932,8815,2018-2019
24,Orlando Magic,82,19780,3316,7307,0.454,937,2633,0.356,2379,4674,0.509,1231,1575,0.782,822,2902,3724,2095,543,445,1082,1526,8800,2018-2019
25,Detroit Pistons,82,19855,3185,7238,0.44,993,2854,0.348,2192,4384,0.5,1415,1893,0.747,936,2752,3688,1845,569,331,1135,1811,8778,2018-2019
26,Miami Heat,82,19730,3251,7218,0.45,928,2658,0.349,2323,4560,0.509,1238,1782,0.695,921,2879,3800,1991,627,448,1208,1712,8668,2018-2019
27,Chicago Bulls,82,19905,3266,7205,0.453,745,2123,0.351,2521,5082,0.496,1328,1695,0.783,718,2799,3517,1796,603,351,1159,1663,8605,2018-2019
28,New York Knicks,82,19780,3134,7241,0.433,823,2421,0.34,2311,4820,0.479,1484,1956,0.759,857,2811,3668,1646,557,422,1151,1713,8575,2018-2019
29,Cleveland Cavaliers,82,19755,3189,7184,0.444,847,2388,0.355,2342,4796,0.488,1342,1694,0.792,879,2619,3498,1698,534,195,1106,1642,8567,2018-2019
30,Memphis Grizzlies,82,19880,3113,6924,0.45,811,2368,0.342,2302,4556,0.505,1453,1882,0.772,723,2703,3426,1963,684,448,1147,1801,8490,2018-2019
1,Dallas Mavericks,75,18175,3124,6772,0.461,1136,3095,0.367,1988,3677,0.541,1392,1787,0.779,791,2729,3520,1849,460,363,953,1462,8776,2019-2020
2,Milwaukee Bucks,73,17595,3160,6638,0.476,1007,2840,0.355,2153,3798,0.567,1336,1800,0.742,691,3083,3774,1889,526,429,1102,1431,8663,2019-2020
3,Portland Trail Blazers,74,17835,3122,6749,0.463,952,2525,0.377,2170,4224,0.514,1312,1632,0.804,754,2599,3353,1525,465,451,946,1606,8508,2019-2020
4,Houston Rockets,72,17380,2936,6512,0.451,1126,3261,0.345,1810,3251,0.557,1484,1876,0.791,704,2484,3188,1557,627,371,1057,1566,8482,2019-2020
5,Los Angeles Clippers,72,17380,2992,6425,0.466,895,2410,0.371,2097,4015,0.522,1498,1894,0.791,767,2664,3431,1708,511,338,1051,1594,8377,2019-2020
6,New Orleans Pelicans,72,17430,3065,6598,0.465,982,2656,0.37,2083,3942,0.528,1229,1687,0.729,797,2551,3348,1932,539,358,1181,1524,8341,2019-2020
7,Phoenix Suns,73,17595,3006,6429,0.468,831,2320,0.358,2175,4109,0.529,1451,1740,0.834,712,2465,3177,1987,559,290,1077,1609,8294,2019-2020
8,Washington Wizards,72,17355,2990,6544,0.457,864,2345,0.368,2126,4199,0.506,1394,1770,0.788,732,2295,3027,1801,574,309,1020,1634,8238,2019-2020
9,Memphis Grizzlies,73,17570,3106,6634,0.468,798,2297,0.347,2308,4337,0.532,1212,1589,0.763,754,2643,3397,1965,576,398,1113,1546,8222,2019-2020
10,Boston Celtics,72,17430,2971,6448,0.461,905,2487,0.364,2066,3961,0.522,1336,1668,0.801,768,2549,3317,1655,595,406,995,1553,8183,2019-2020
11,Miami Heat,73,17745,2880,6160,0.468,979,2584,0.379,1901,3576,0.532,1440,1840,0.783,620,2619,3239,1892,547,332,1088,1501,8179,2019-2020
12,Denver Nuggets,73,17745,3069,6488,0.473,801,2234,0.359,2268,4254,0.533,1185,1526,0.777,786,2436,3222,1952,586,337,1005,1485,8124,2019-2020
13,Toronto Raptors,72,17380,2897,6331,0.458,995,2663,0.374,1902,3668,0.519,1329,1670,0.796,685,2583,3268,1816,636,358,1067,1559,8118,2019-2020
14,San Antonio Spurs,71,17215,2995,6350,0.472,760,2021,0.376,2235,4329,0.516,1348,1664,0.81,640,2530,3170,1751,518,390,895,1377,8098,2019-2020
15,Philadelphia 76ers,73,17595,3000,6417,0.468,848,2307,0.368,2152,4110,0.524,1236,1638,0.755,764,2553,3317,1884,586,389,1037,1529,8084,2019-2020
16,Los Angeles Lakers,71,17090,3006,6269,0.48,782,2242,0.349,2224,4027,0.552,1260,1728,0.729,757,2490,3247,1803,612,468,1077,1471,8054,2019-2020
17,Brooklyn Nets,72,17480,2908,6498,0.448,941,2746,0.343,1967,3752,0.524,1291,1732,0.745,766,2683,3449,1761,464,323,1099,1510,8048,2019-2020
18,Utah Jazz,72,17355,2886,6130,0.471,963,2537,0.38,1923,3593,0.535,1278,1641,0.779,656,2577,3233,1615,438,292,1089,1468,8013,2019-2020
19,Indiana Pacers,73,17620,3075,6457,0.476,743,2046,0.363,2332,4411,0.529,1096,1393,0.787,636,2489,3125,1888,543,376,967,1445,7989,2019-2020
20,Oklahoma City Thunder,72,17430,2879,6156,0.468,770,2171,0.355,2109,3985,0.529,1422,1787,0.796,593,2495,3088,1562,550,353,986,1390,7950,2019-2020
21,Sacramento Kings,72,17455,2943,6364,0.462,914,2511,0.364,2029,3853,0.527,1127,1464,0.77,695,2372,3067,1713,556,293,1043,1595,7927,2019-2020
22,Orlando Magic,73,17570,2871,6468,0.444,807,2354,0.343,2064,4114,0.502,1282,1656,0.774,751,2498,3249,1747,599,396,937,1336,7831,2019-2020
23,Atlanta Hawks,67,16280,2723,6067,0.449,805,2416,0.333,1918,3651,0.525,1237,1566,0.79,661,2237,2898,1605,523,341,1086,1548,7488,2019-2020
24,Minnesota Timberwolves,64,15560,2586,5865,0.441,853,2540,0.336,1733,3325,0.521,1223,1624,0.753,675,2193,2868,1525,555,362,981,1370,7248,2019-2020
25,Detroit Pistons,66,15965,2595,5658,0.459,791,2157,0.367,1804,3501,0.515,1097,1476,0.743,644,2109,2753,1589,490,299,1008,1299,7078,2019-2020
26,New York Knicks,66,15965,2638,5896,0.447,631,1872,0.337,2007,4024,0.499,1076,1550,0.694,795,2274,3069,1456,504,313,946,1464,6983,2019-2020
27,Cleveland Cavaliers,65,15725,2619,5715,0.458,727,2070,0.351,1892,3645,0.519,983,1296,0.758,704,2172,2876,1500,447,211,1073,1188,6948,2019-2020
28,Chicago Bulls,65,15675,2573,5762,0.447,793,2282,0.348,1780,3480,0.511,1006,1332,0.755,680,2041,2721,1510,652,265,1005,1417,6945,2019-2020
29,Golden State Warriors,65,15725,2510,5730,0.438,678,2032,0.334,1832,3698,0.495,1214,1511,0.803,647,2138,2785,1663,534,299,969,1304,6912,2019-2020
30,Charlotte Hornets,65,15750,2425,5586,0.434,785,2231,0.352,1640,3355,0.489,1052,1406,0.748,715,2066,2781,1549,428,268,949,1223,6687,2019-2020
1,Milwaukee Bucks,72,17330,3221,6610,0.487,1038,2669,0.389,2183,3941,0.554,1169,1539,0.76,741,2724,3465,1834,585,334,995,1244,8649,2020-2021
2,Brooklyn Nets,72,17405,3106,6289,0.494,1020,2600,0.392,2086,3689,0.565,1305,1623,0.804,640,2559,3199,1929,484,379,975,1371,8537,2020-2021
3,Washington Wizards,72,17405,3108,6547,0.475,733,2088,0.351,2375,4459,0.533,1449,1884,0.769,697,2557,3254,1835,528,297,1037,1555,8398,2020-2021
4,Utah Jazz,72,17355,2971,6344,0.468,1205,3098,0.389,1766,3246,0.544,1235,1546,0.799,765,2709,3474,1703,474,371,1023,1335,8382,2020-2021
5,Portland Trail Blazers,72,17305,2973,6558,0.453,1132,2939,0.385,1841,3619,0.509,1282,1558,0.823,766,2441,3207,1531,496,363,799,1362,8360,2020-2021
6,Indiana Pacers,72,17455,3115,6567,0.474,889,2445,0.364,2226,4122,0.54,1183,1493,0.792,648,2424,3072,1973,611,460,975,1453,8302,2020-2021
7,Phoenix Suns,72,17480,3118,6357,0.49,940,2490,0.378,2178,3867,0.563,1124,1347,0.834,630,2462,3092,1939,517,312,902,1374,8300,2020-2021
8,Denver Nuggets,72,17480,3114,6422,0.485,927,2462,0.377,2187,3960,0.552,1129,1406,0.803,758,2442,3200,1933,582,323,972,1374,8284,2020-2021
9,New Orleans Pelicans,72,17430,3060,6412,0.477,762,2190,0.348,2298,4222,0.544,1369,1878,0.729,845,2568,3413,1872,545,315,1052,1295,8251,2020-2021
10,Los Angeles Clippers,72,17280,3009,6242,0.482,1027,2498,0.411,1982,3744,0.529,1164,1387,0.839,678,2501,3179,1756,509,295,950,1383,8209,2020-2021
11,Sacramento Kings,72,17305,3067,6382,0.481,874,2400,0.364,2193,3982,0.551,1181,1585,0.745,674,2307,2981,1836,543,358,963,1400,8189,2020-2021
12,Golden State Warriors,72,17305,2973,6347,0.468,1048,2789,0.376,1925,3558,0.541,1193,1520,0.785,574,2524,3098,1991,587,342,1080,1526,8187,2020-2021
13,Atlanta Hawks,72,17405,2937,6281,0.468,895,2402,0.373,2042,3879,0.526,1417,1745,0.812,760,2525,3285,1737,503,342,953,1392,8186,2020-2021
14,Philadelphia 76ers,72,17430,2981,6257,0.476,811,2169,0.374,2170,4088,0.531,1409,1836,0.767,722,2522,3244,1706,655,447,1040,1456,8182,2020-2021
15,Memphis Grizzlies,72,17405,3085,6608,0.467,803,2258,0.356,2282,4350,0.525,1184,1536,0.771,803,2543,3346,1938,655,364,957,1349,8157,2020-2021
16,Boston Celtics,72,17380,2985,6401,0.466,979,2618,0.374,2006,3783,0.53,1160,1496,0.775,765,2421,3186,1689,556,383,1012,1471,8109,2020-2021
17,Dallas Mavericks,72,17305,2958,6287,0.47,994,2744,0.362,1964,3543,0.554,1186,1524,0.778,657,2463,3120,1647,450,311,869,1396,8096,2020-2021
18,Minnesota Timberwolves,72,17405,2932,6546,0.448,944,2706,0.349,1988,3840,0.518,1265,1662,0.761,757,2376,3133,1846,632,398,1027,1507,8073,2020-2021
19,Toronto Raptors,72,17305,2859,6383,0.448,1041,2831,0.368,1818,3552,0.512,1252,1536,0.815,680,2314,2994,1735,618,389,952,1526,8011,2020-2021
20,San Antonio Spurs,72,17480,3014,6518,0.462,716,2046,0.35,2298,4472,0.514,1254,1584,0.792,669,2489,3158,1759,505,366,821,1293,7998,2020-2021
21,Chicago Bulls,72,17380,3035,6380,0.476,904,2446,0.37,2131,3934,0.542,995,1258,0.791,693,2544,3237,1927,482,304,1089,1362,7969,2020-2021
22,Los Angeles Lakers,72,17455,2925,6197,0.472,796,2248,0.354,2129,3949,0.539,1241,1679,0.739,695,2490,3185,1775,562,386,1095,1377,7887,2020-2021
23,Charlotte Hornets,72,17355,2875,6324,0.455,985,2666,0.369,1890,3658,0.517,1146,1505,0.761,762,2389,3151,1933,565,344,1069,1298,7881,2020-2021
24,Houston Rockets,72,17305,2826,6372,0.444,992,2923,0.339,1834,3449,0.532,1189,1606,0.74,671,2396,3067,1699,546,361,1060,1407,7833,2020-2021
25,Miami Heat,72,17380,2824,6029,0.468,932,2606,0.358,1892,3423,0.553,1201,1520,0.79,579,2409,2988,1895,569,286,1013,1363,7781,2020-2021
26,New York Knicks,72,17430,2839,6225,0.456,847,2163,0.392,1992,4062,0.49,1181,1506,0.784,696,2554,3250,1541,507,365,932,1473,7706,2020-2021
27,Detroit Pistons,72,17430,2783,6162,0.452,832,2370,0.351,1951,3792,0.515,1278,1683,0.759,694,2381,3075,1743,531,371,1075,1477,7676,2020-2021
28,Oklahoma City Thunder,72,17355,2795,6338,0.441,857,2529,0.339,1938,3809,0.509,1113,1536,0.725,715,2568,3283,1588,504,316,1162,1305,7560,2020-2021
29,Orlando Magic,72,17330,2754,6423,0.429,784,2288,0.343,1970,4135,0.476,1196,1543,0.775,747,2525,3272,1571,496,318,924,1237,7488,2020-2021
30,Cleveland Cavaliers,72,17430,2778,6175,0.45,720,2141,0.336,2058,4034,0.51,1200,1614,0.743,751,2327,3078,1716,559,325,1114,1308,7476,2020-2021
1,Minnesota Timberwolves,82,19780,3411,7458,0.457,1211,3386,0.358,2200,4072,0.54,1474,1894,0.778,921,2700,3621,2106,721,460,1175,1786,9507,2021-2022
2,Memphis Grizzlies,82,19780,3571,7739,0.461,945,2679,0.353,2626,5060,0.519,1393,1898,0.734,1159,2873,4032,2131,800,533,1082,1620,9480,2021-2022
3,Milwaukee Bucks,82,19755,3429,7331,0.468,1153,3151,0.366,2276,4180,0.544,1459,1881,0.776,840,2990,3830,1960,623,326,1100,1494,9470,2021-2022
4,Charlotte Hornets,82,19880,3508,7497,0.468,1143,3130,0.365,2365,4367,0.542,1298,1753,0.74,888,2767,3655,2302,707,402,1087,1629,9457,2021-2022
5,Phoenix Suns,82,19730,3581,7389,0.485,951,2616,0.364,2630,4773,0.551,1303,1635,0.797,801,2913,3714,2244,702,359,1060,1633,9416,2021-2022
6,Atlanta Hawks,82,19705,3401,7241,0.47,1056,2821,0.374,2345,4420,0.531,1485,1829,0.812,823,2783,3606,2017,587,348,972,1534,9343,2021-2022
7,Utah Jazz,82,19730,3327,7067,0.471,1192,3308,0.36,2135,3759,0.568,1470,1916,0.767,884,2916,3800,1836,588,402,1149,1547,9316,2021-2022
8,San Antonio Spurs,82,19805,3546,7601,0.467,925,2626,0.352,2621,4975,0.527,1262,1673,0.754,901,2815,3716,2289,626,403,1043,1483,9279,2021-2022
9,Brooklyn Nets,82,19755,3442,7251,0.475,940,2602,0.361,2502,4649,0.538,1434,1781,0.805,844,2796,3640,2071,582,448,1153,1670,9258,2021-2022
10,Denver Nuggets,82,19805,3416,7079,0.483,1039,2944,0.353,2377,4135,0.575,1372,1725,0.795,752,2865,3617,2279,592,305,1189,1639,9243,2021-2022
11,Los Angeles Lakers,82,19980,3415,7279,0.469,982,2826,0.347,2433,4453,0.546,1380,1884,0.732,782,2826,3608,1968,626,425,1191,1654,9192,2021-2022
12,Boston Celtics,82,19905,3341,7167,0.466,1085,3044,0.356,2256,4123,0.547,1397,1713,0.816,863,2915,3778,2036,591,478,1118,1521,9164,2021-2022
13,Chicago Bulls,82,19730,3422,7127,0.48,872,2364,0.369,2550,4763,0.535,1436,1766,0.813,711,2760,3471,1958,585,336,1053,1540,9152,2021-2022
14,Indiana Pacers,82,19880,3398,7338,0.463,997,2899,0.344,2401,4439,0.541,1347,1754,0.768,925,2671,3596,2081,582,457,1183,1675,9140,2021-2022
15,Golden State Warriors,82,19730,3323,7087,0.469,1176,3231,0.364,2147,3856,0.557,1280,1665,0.769,800,2930,3730,2223,719,372,1221,1723,9102,2021-2022
16,Sacramento Kings,82,19805,3321,7223,0.46,937,2722,0.344,2384,4501,0.53,1466,1908,0.768,784,2737,3521,1943,588,369,1156,1552,9045,2021-2022
17,Miami Heat,82,19855,3246,6954,0.467,1114,2936,0.379,2132,4018,0.531,1416,1753,0.808,807,2778,3585,2090,606,265,1194,1679,9022,2021-2022
18,Philadelphia 76ers,82,19805,3230,6932,0.466,950,2608,0.364,2280,4324,0.527,1605,1955,0.821,700,2770,3470,1945,633,435,1027,1590,9015,2021-2022
19,Houston Rockets,82,19755,3229,7083,0.456,1105,3170,0.349,2124,3913,0.543,1434,2010,0.713,786,2660,3446,1932,600,382,1351,1692,8997,2021-2022
20,Toronto Raptors,82,19855,3332,7489,0.445,979,2808,0.349,2353,4681,0.503,1327,1749,0.759,1095,2622,3717,1809,738,376,1021,1607,8970,2021-2022
21,New Orleans Pelicans,82,19755,3294,7212,0.457,873,2629,0.332,2421,4583,0.528,1501,1903,0.789,981,2726,3707,2047,680,328,1153,1612,8962,2021-2022
22,Washington Wizards,82,19830,3327,7056,0.472,860,2512,0.342,2467,4544,0.543,1393,1778,0.783,737,2798,3535,2052,522,406,1077,1545,8907,2021-2022
23,Los Angeles Clippers,82,19780,3285,7170,0.458,1047,2802,0.374,2238,4368,0.512,1273,1606,0.793,747,2860,3607,1969,608,406,1126,1528,8890,2021-2022
24,Dallas Mavericks,82,19755,3222,6982,0.461,1073,3063,0.35,2149,3919,0.548,1341,1739,0.771,759,2769,3528,1918,552,325,1025,1612,8858,2021-2022
25,Cleveland Cavaliers,82,19730,3255,6940,0.469,953,2686,0.355,2302,4254,0.541,1376,1810,0.76,837,2786,3623,2064,580,343,1181,1433,8839,2021-2022
26,New York Knicks,82,19780,3088,7069,0.437,1082,3029,0.357,2006,4040,0.497,1473,1980,0.744,941,2841,3782,1793,570,399,1087,1672,8731,2021-2022
27,Portland Trail Blazers,82,19730,3161,7144,0.442,1043,3017,0.346,2118,4127,0.513,1346,1771,0.76,854,2661,3515,1880,657,366,1187,1728,8711,2021-2022
28,Detroit Pistons,82,19780,3129,7267,0.431,925,2838,0.326,2204,4429,0.498,1413,1806,0.782,900,2625,3525,1924,630,393,1163,1799,8596,2021-2022
29,Orlando Magic,82,19780,3139,7240,0.434,999,3022,0.331,2140,4218,0.507,1270,1614,0.787,746,2885,3631,1947,555,367,1188,1612,8547,2021-2022
30,Oklahoma City Thunder,82,19805,3141,7310,0.43,991,3066,0.323,2150,4244,0.507,1233,1632,0.756,854,2887,3741,1822,622,380,1145,1497,8506,2021-2022
1,Sacramento Kings,82,19830,3573,7232,0.494,1128,3060,0.369,2445,4172,0.586,1624,2055,0.79,782,2699,3481,2237,574,275,1106,1616,9898,2022-2023
2,Golden State Warriors,82,19830,3538,7393,0.479,1363,3540,0.385,2175,3853,0.564,1314,1655,0.794,864,2793,3657,2446,588,323,1336,1757,9753,2022-2023
3,Atlanta Hawks,82,19855,3658,7574,0.483,882,2505,0.352,2776,5069,0.548,1513,1850,0.818,920,2719,3639,2049,580,401,1060,1541,9711,2022-2023
4,Boston Celtics,82,19980,3460,7278,0.475,1315,3492,0.377,2145,3786,0.567,1436,1769,0.812,796,2921,3717,2186,521,430,1095,1542,9671,2022-2023
5,Oklahoma City Thunder,82,19855,3533,7590,0.465,995,2797,0.356,2538,4793,0.53,1572,1944,0.809,934,2645,3579,2002,676,341,1069,1722,9633,2022-2023
6,Los Angeles Lakers,82,19880,3516,7298,0.482,885,2558,0.346,2631,4740,0.555,1691,2182,0.775,818,2930,3748,2072,526,378,1154,1466,9608,2022-2023
7,Utah Jazz,82,19805,3485,7365,0.473,1094,3099,0.353,2391,4266,0.56,1536,1955,0.786,968,2794,3762,2129,500,429,1259,1679,9600,2022-2023
8,Milwaukee Bucks,82,19830,3504,7411,0.473,1217,3306,0.368,2287,4105,0.557,1364,1837,0.743,914,3074,3988,2115,521,403,1199,1481,9589,2022-2023
9,Memphis Grizzlies,82,19780,3585,7551,0.475,985,2807,0.351,2600,4744,0.548,1432,1954,0.733,988,2835,3823,2135,680,473,1116,1643,9587,2022-2023
10,Indiana Pacers,82,19755,3444,7345,0.469,1112,3030,0.367,2332,4315,0.54,1535,1944,0.79,832,2575,3407,2213,631,478,1225,1741,9535,2022-2023
11,New York Knicks,82,19955,3444,7328,0.47,1037,2930,0.354,2407,4398,0.547,1589,2087,0.761,1031,2790,3821,1880,527,340,1065,1666,9514,2022-2023
12,Denver Nuggets,82,19755,3574,7088,0.504,969,2559,0.379,2605,4529,0.575,1378,1834,0.751,828,2699,3527,2368,618,368,1192,1525,9495,2022-2023
13,Minnesota Timberwolves,82,19830,3515,7167,0.49,997,2731,0.365,2518,4436,0.568,1467,1942,0.755,749,2686,3435,2145,657,444,1258,1768,9494,2022-2023
14,Philadelphia 76ers,82,19880,3347,6870,0.487,1035,2675,0.387,2312,4195,0.551,1719,2058,0.835,715,2641,3356,2063,635,389,1121,1675,9448,2022-2023
15,New Orleans Pelicans,82,19855,3447,7180,0.48,899,2468,0.364,2548,4712,0.541,1585,2000,0.793,866,2717,3583,2122,681,337,1196,1678,9378,2022-2023
16,Dallas Mavericks,82,19930,3283,6909,0.475,1246,3362,0.371,2037,3547,0.574,1554,2057,0.755,625,2556,3181,1880,514,304,1002,1697,9366,2022-2023
17,Phoenix Suns,82,19780,3453,7388,0.467,1001,2674,0.374,2452,4714,0.52,1412,1781,0.793,971,2657,3628,2235,585,432,1110,1739,9319,2022-2023
18,Los Angeles Clippers,82,19830,3370,7059,0.477,1041,2735,0.381,2329,4324,0.539,1533,1962,0.781,803,2742,3545,1959,580,364,1167,1598,9314,2022-2023
19,Portland Trail Blazers,82,19730,3317,7001,0.474,1056,2893,0.365,2261,4108,0.55,1609,2021,0.796,774,2551,3325,1981,553,376,1185,1643,9299,2022-2023
20,Brooklyn Nets,82,19730,3399,6978,0.487,1048,2771,0.378,2351,4207,0.559,1449,1811,0.8,674,2648,3322,2093,585,506,1127,1730,9295,2022-2023
21,Washington Wizards,82,19755,3456,7127,0.485,925,2601,0.356,2531,4526,0.559,1442,1838,0.785,774,2804,3578,2083,561,424,1158,1539,9279,2022-2023
22,Chicago Bulls,82,19905,3488,7116,0.49,854,2367,0.361,2634,4749,0.555,1446,1788,0.809,694,2779,3473,2006,644,371,1097,1551,9276,2022-2023
23,San Antonio Spurs,82,19855,3533,7593,0.465,911,2640,0.345,2622,4953,0.529,1292,1739,0.743,965,2619,3584,2232,572,322,1253,1630,9269,2022-2023
24,Toronto Raptors,82,19805,3434,7489,0.459,880,2626,0.335,2554,4863,0.525,1506,1922,0.784,1043,2485,3528,1961,772,424,956,1641,9254,2022-2023
25,Cleveland Cavaliers,82,19880,3408,6984,0.488,950,2589,0.367,2458,4395,0.559,1439,1844,0.78,795,2574,3369,2045,586,384,1094,1560,9205,2022-2023
26,Orlando Magic,82,19780,3323,7074,0.47,883,2551,0.346,2440,4523,0.539,1607,2050,0.784,833,2713,3546,1906,603,382,1236,1652,9136,2022-2023
27,Charlotte Hornets,82,19830,3385,7413,0.457,881,2669,0.33,2504,4744,0.528,1447,1933,0.749,901,2751,3652,2062,634,425,1164,1661,9098,2022-2023
28,Houston Rockets,82,19755,3329,7287,0.457,856,2619,0.327,2473,4668,0.53,1567,2078,0.754,1100,2695,3795,1835,600,374,1332,1679,9081,2022-2023
29,Detroit Pistons,82,19805,3244,7140,0.454,934,2659,0.351,2310,4481,0.516,1623,2106,0.771,916,2564,3480,1884,574,308,1237,1813,9045,2022-2023
30,Miami Heat,82,19805,3215,6991,0.46,980,2852,0.344,2235,4139,0.54,1567,1885,0.831,796,2533,3329,1955,655,243,1106,1516,8977,2022-2023
1,Indiana Pacers,82,19705,3855,7599,0.507,1082,2891,0.374,2773,4708,0.589,1318,1685,0.782,827,2578,3405,2522,631,481,1059,1756,10110,2023-2024
2,Boston Celtics,82,19830,3601,7396,0.487,1351,3482,0.388,2250,3914,0.575,1334,1654,0.807,876,2923,3799,2207,557,538,979,1326,9887,2023-2024
3,Oklahoma City Thunder,82,19805,3653,7324,0.499,1090,2805,0.389,2563,4519,0.567,1451,1759,0.825,722,2725,3447,2223,694,538,1039,1545,9847,2023-2024
4,Milwaukee Bucks,82,19805,3538,7258,0.487,1163,3122,0.373,2375,4136,0.574,1517,1960,0.774,772,2850,3622,2176,558,413,1059,1574,9756,2023-2024
5,Atlanta Hawks,82,19855,3529,7584,0.465,1125,3092,0.364,2404,4492,0.535,1520,1906,0.797,1024,2639,3663,2180,615,369,1110,1522,9703,2023-2024
6,Los Angeles Lakers,82,19855,3580,7177,0.499,969,2572,0.377,2611,4605,0.567,1550,1983,0.782,676,2859,3535,2340,605,453,1146,1283,9679,2023-2024
7,Dallas Mavericks,82,19705,3535,7352,0.481,1197,3242,0.369,2338,4110,0.569,1397,1842,0.758,797,2724,3521,2106,563,406,1027,1500,9664,2023-2024
8,Golden State Warriors,82,19830,3582,7515,0.477,1211,3191,0.38,2371,4324,0.548,1282,1644,0.78,996,2834,3830,2402,572,377,1174,1598,9657,2023-2024
9,Sacramento Kings,82,19855,3553,7455,0.477,1178,3219,0.366,2375,4236,0.561,1274,1710,0.745,888,2719,3607,2324,625,342,1078,1632,9558,2023-2024
10,Phoenix Suns,82,19780,3482,7063,0.493,1020,2671,0.382,2462,4392,0.561,1548,1915,0.808,831,2783,3614,2218,610,492,1221,1475,9532,2023-2024
11,Utah Jazz,82,19805,3443,7371,0.467,1060,2993,0.354,2383,4378,0.544,1538,1853,0.83,1002,2725,3727,2232,537,458,1285,1523,9484,2023-2024
12,Los Angeles Clippers,82,19705,3473,7108,0.489,1036,2719,0.381,2437,4389,0.555,1499,1817,0.825,822,2701,3523,2097,640,413,1078,1519,9481,2023-2024
13,New Orleans Pelicans,82,19705,3484,7165,0.486,1023,2673,0.383,2461,4492,0.548,1445,1873,0.771,852,2753,3605,2210,684,378,1067,1508,9436,2023-2024
14,Denver Nuggets,82,19705,3610,7279,0.496,958,2560,0.374,2652,4719,0.562,1240,1628,0.762,881,2763,3644,2415,585,457,1036,1489,9418,2023-2024
15,Philadelphia 76ers,82,19780,3404,7331,0.464,992,2733,0.363,2412,4598,0.525,1597,1934,0.826,906,2616,3522,2041,694,492,984,1668,9397,2023-2024
16,Houston Rockets,82,19855,3425,7459,0.459,1043,2964,0.352,2382,4495,0.53,1482,1916,0.773,940,2787,3727,2035,639,375,1045,1702,9375,2023-2024
17,Washington Wizards,82,19730,3523,7493,0.47,1015,2915,0.348,2508,4578,0.548,1266,1657,0.764,755,2613,3368,2288,623,415,1147,1637,9327,2023-2024
18,Minnesota Timberwolves,82,19805,3383,6974,0.485,1037,2681,0.387,2346,4293,0.546,1461,1881,0.777,770,2807,3577,2184,647,497,1162,1544,9264,2023-2024
19,New York Knicks,82,19730,3385,7272,0.465,1083,2936,0.369,2302,4336,0.531,1396,1789,0.78,1039,2665,3704,1998,612,336,1085,1447,9249,2023-2024
20,Cleveland Cavaliers,82,19805,3425,7148,0.479,1108,3016,0.367,2317,4132,0.561,1278,1671,0.765,807,2742,3549,2299,605,380,1112,1436,9236,2023-2024
21,Toronto Raptors,82,19805,3466,7356,0.471,942,2712,0.347,2524,4644,0.543,1339,1772,0.756,891,2607,3498,2335,634,388,1147,1509,9213,2023-2024
22,Chicago Bulls,82,19980,3448,7339,0.47,941,2630,0.358,2507,4709,0.532,1369,1731,0.791,916,2677,3593,2048,638,394,1004,1541,9206,2023-2024
23,San Antonio Spurs,82,19830,3438,7436,0.462,1036,2983,0.347,2402,4453,0.539,1280,1637,0.782,849,2778,3627,2449,584,520,1242,1414,9192,2023-2024
24,Orlando Magic,82,19780,3318,6964,0.476,903,2568,0.352,2415,4396,0.549,1519,2002,0.759,861,2608,3469,2023,669,423,1206,1618,9058,2023-2024
25,Brooklyn Nets,82,19805,3334,7307,0.456,1089,3010,0.362,2245,4297,0.522,1293,1711,0.756,938,2675,3613,2102,556,424,1076,1516,9050,2023-2024
26,Miami Heat,82,19755,3266,7022,0.465,1022,2765,0.37,2244,4257,0.527,1478,1806,0.818,766,2702,3468,2116,617,280,1038,1415,9032,2023-2024
27,Detroit Pistons,82,19755,3353,7236,0.463,906,2602,0.348,2447,4634,0.528,1398,1780,0.785,861,2692,3553,2088,531,384,1248,1688,9010,2023-2024
28,Charlotte Hornets,82,19730,3281,7133,0.46,989,2788,0.355,2292,4345,0.528,1189,1512,0.786,765,2538,3303,2033,562,371,1129,1472,8740,2023-2024
29,Portland Trail Blazers,82,19880,3227,7356,0.439,939,2723,0.345,2288,4633,0.494,1329,1680,0.791,1036,2469,3505,1894,627,354,1249,1654,8722,2023-2024
30,Memphis Grizzlies,82,19780,3145,7230,0.435,1071,3097,0.346,2074,4133,0.502,1316,1722,0.764,896,2598,3494,2025,673,501,1236,1563,8677,2023-2024
