Season,Team,Pos,G,GS,MP,FG,FGA,FG%,3P,3PA,3P%,2P,2PA,2P%,eFG%,FT,FTA,FT%,ORB,DRB,TRB,AST,STL,BLK,TOV,PF,PTS,Name
2020-21,MIA,PF,61,4,737,124,228,.544,0,1,.000,124,227,.546,.544,56,110,.509,73,135,208,29,20,28,43,91,304,Precious Achiuwa
2021-22,TOR,C,73,28,1725,265,603,.439,56,156,.359,209,447,.468,.486,78,131,.595,146,327,473,82,37,41,84,151,664,Precious Achiuwa
2022-23,TOR,C,55,12,1140,196,404,.485,29,108,.269,167,296,.564,.521,87,124,.702,100,228,328,50,31,30,59,102,508,Precious Achiuwa
2023-24,2TM,PF,74,18,1624,235,469,.501,26,97,.268,209,372,.562,.529,69,112,.616,191,296,487,97,46,68,83,143,565,Precious Achiuwa
2023-24,TOR,C,25,0,437,78,170,.459,13,47,.277,65,123,.528,.497,24,42,.571,50,86,136,44,16,12,29,40,193,Precious Achiuwa
2023-24,NYK,PF,49,18,1187,157,299,.525,13,50,.260,144,249,.578,.547,45,70,.643,141,210,351,53,30,56,54,103,372,Precious Achiuwa
2024-25,NYK,PF,10,1,195,21,46,.457,3,9,.333,18,37,.486,.489,7,14,.500,24,46,70,13,8,9,10,14,52,Precious Achiuwa
2013-14,OKC,C,81,20,1197,93,185,.503,0,0,,93,185,.503,.503,79,136,.581,142,190,332,43,40,57,71,203,265,Steven Adams
2014-15,OKC,C,70,67,1771,217,399,.544,0,2,.000,217,397,.547,.544,103,205,.502,199,324,523,66,38,86,99,222,537,Steven Adams
2015-16,OKC,C,80,80,2014,261,426,.613,0,0,,261,426,.613,.613,114,196,.582,219,314,533,62,42,89,84,223,636,Steven Adams
2016-17,OKC,C,80,80,2389,374,655,.571,0,1,.000,374,654,.572,.571,157,257,.611,281,332,613,86,89,78,146,195,905,Steven Adams
2017-18,OKC,C,76,76,2487,448,712,.629,0,2,.000,448,710,.631,.629,160,286,.559,384,301,685,88,92,78,128,215,1056,Steven Adams
2018-19,OKC,C,80,80,2669,481,809,.595,0,2,.000,481,807,.596,.595,146,292,.500,391,369,760,124,117,76,135,204,1108,Steven Adams
2019-20,OKC,C,63,63,1680,283,478,.592,1,3,.333,282,475,.594,.593,117,201,.582,207,376,583,146,51,67,94,122,684,Steven Adams
2020-21,NOP,C,58,58,1605,189,308,.614,0,3,.000,189,305,.620,.614,60,135,.444,213,301,514,111,54,38,78,113,438,Steven Adams
2021-22,MEM,C,76,75,1999,210,384,.547,0,1,.000,210,383,.548,.547,108,199,.543,349,411,760,256,65,60,115,153,528,Steven Adams
2022-23,MEM,C,42,42,1133,157,263,.597,0,1,.000,157,262,.599,.597,47,129,.364,214,271,485,97,36,46,79,98,361,Steven Adams
2024-25,HOU,C,18,0,186,17,28,.607,0,0,,17,28,.607,.607,10,27,.370,28,38,66,19,5,4,21,19,44,Steven Adams
2017-18,MIA,C,69,19,1368,174,340,.512,0,7,.000,174,333,.523,.512,129,179,.721,118,263,381,101,32,41,66,138,477,Bam Adebayo
2018-19,MIA,C,82,28,1913,280,486,.576,3,15,.200,277,471,.588,.579,166,226,.735,165,432,597,184,71,65,121,203,729,Bam Adebayo
2019-20,MIA,PF,72,72,2417,440,790,.557,2,14,.143,438,776,.564,.558,264,382,.691,176,559,735,368,82,93,204,182,1146,Bam Adebayo
2020-21,MIA,C,64,64,2143,456,800,.570,2,8,.250,454,792,.573,.571,283,354,.799,142,431,573,346,75,66,169,145,1197,Bam Adebayo
2021-22,MIA,C,56,56,1825,406,729,.557,0,6,.000,406,723,.562,.557,256,340,.753,137,427,564,190,80,44,148,171,1068,Bam Adebayo
2022-23,MIA,C,75,75,2598,602,1114,.540,1,12,.083,601,1102,.545,.541,324,402,.806,184,504,688,240,88,61,187,208,1529,Bam Adebayo
2023-24,MIA,C,71,71,2416,530,1017,.521,15,42,.357,515,975,.528,.529,292,387,.755,159,578,737,278,81,66,162,159,1367,Bam Adebayo
2024-25,MIA,C,28,28,976,173,382,.453,23,77,.299,150,305,.492,.483,86,120,.717,68,210,278,137,39,24,60,57,455,Bam Adebayo
2022-23,UTA,SG,59,22,1209,165,386,.427,81,228,.355,84,158,.532,.532,56,69,.812,43,78,121,67,16,15,41,99,467,Ochai Agbaji
2023-24,2TM,SG,78,28,1641,178,433,.411,62,211,.294,116,222,.523,.483,37,56,.661,74,142,216,83,47,44,64,117,455,Ochai Agbaji
2023-24,UTA,SG,51,10,1003,106,249,.426,47,142,.331,59,107,.551,.520,15,20,.750,35,91,126,47,27,29,34,66,274,Ochai Agbaji
2023-24,TOR,SG,27,18,638,72,184,.391,15,69,.217,57,115,.496,.432,22,36,.611,39,51,90,36,20,15,30,51,181,Ochai Agbaji
2024-25,TOR,SG,31,29,945,144,279,.516,53,127,.417,91,152,.599,.611,17,26,.654,27,96,123,57,28,15,24,71,358,Ochai Agbaji
2021-22,MEM,PF,32,0,360,53,132,.402,6,48,.125,47,84,.560,.424,20,32,.625,33,54,87,21,6,10,16,36,132,Santi Aldama
2022-23,MEM,PF,77,20,1682,247,525,.470,94,266,.353,153,259,.591,.560,108,144,.750,85,286,371,97,45,48,60,143,696,Santi Aldama
2023-24,MEM,PF,61,35,1618,247,568,.435,106,304,.349,141,264,.534,.528,54,87,.621,72,280,352,138,43,54,69,89,654,Santi Aldama
2024-25,MEM,PF,31,11,797,158,311,.508,54,139,.388,104,172,.605,.595,33,43,.767,48,178,226,92,28,17,38,32,403,Santi Aldama
2024-25,DEN,SG,10,0,48,3,12,.250,1,6,.167,2,6,.333,.292,2,2,1.000,0,1,1,3,0,1,1,3,9,Trey Alexander
2020-21,PHO,SG,15,0,47,3,12,.250,2,9,.222,1,3,.333,.333,1,2,.500,2,8,10,6,0,1,3,2,9,Ty-Shon Alexander
2019-20,NOP,SG,47,1,591,98,266,.368,46,133,.346,52,133,.391,.455,25,37,.676,9,75,84,89,17,8,54,57,267,Nickeil Alexander-Walker
2020-21,NOP,SG,46,13,1007,192,458,.419,76,219,.347,116,239,.485,.502,48,66,.727,13,131,144,102,47,22,69,88,508,Nickeil Alexander-Walker
2021-22,2TM,SG,65,21,1466,253,680,.372,105,338,.311,148,342,.433,.449,81,109,.743,37,150,187,156,46,23,93,103,692,Nickeil Alexander-Walker
2021-22,NOP,SG,50,19,1317,237,632,.375,95,305,.311,142,327,.434,.450,70,97,.722,36,128,164,139,41,19,85,88,639,Nickeil Alexander-Walker
2021-22,UTA,SG,15,2,149,16,48,.333,10,33,.303,6,15,.400,.438,11,12,.917,1,22,23,17,5,4,8,15,53,Nickeil Alexander-Walker
2022-23,2TM,SG,59,3,884,131,295,.444,61,159,.384,70,136,.515,.547,40,60,.667,15,86,101,108,32,21,55,88,363,Nickeil Alexander-Walker
2022-23,UTA,SG,36,3,528,83,170,.488,35,87,.402,48,83,.578,.591,27,39,.692,8,51,59,76,24,14,45,58,228,Nickeil Alexander-Walker
2022-23,MIN,SG,23,0,356,48,125,.384,26,72,.361,22,53,.415,.488,13,21,.619,7,35,42,32,8,7,10,30,135,Nickeil Alexander-Walker
2023-24,MIN,SG,82,20,1921,236,538,.439,131,335,.391,105,203,.517,.560,52,65,.800,35,132,167,204,64,42,76,143,655,Nickeil Alexander-Walker
2024-25,MIN,SG,30,2,709,104,209,.498,51,118,.432,53,91,.582,.620,26,34,.765,17,66,83,76,26,9,40,48,285,Nickeil Alexander-Walker
2018-19,CHI,SG,10,1,120,13,39,.333,3,12,.250,10,27,.370,.372,8,12,.667,11,15,26,13,1,0,8,7,37,Rawle Alkins
2018-19,UTA,SG,38,2,416,67,178,.376,32,99,.323,35,79,.443,.466,45,60,.750,3,20,23,25,6,6,33,47,211,Grayson Allen
2019-20,MEM,SG,38,0,718,117,251,.466,57,141,.404,60,110,.545,.580,39,45,.867,8,77,85,52,10,2,33,53,330,Grayson Allen
2020-21,MEM,SG,50,38,1259,173,414,.418,107,274,.391,66,140,.471,.547,79,91,.868,19,141,160,108,46,8,48,71,532,Grayson Allen
2021-22,MIL,SG,66,61,1805,255,569,.448,159,389,.409,96,180,.533,.588,64,74,.865,32,190,222,100,46,18,43,96,733,Grayson Allen
2022-23,MIL,SG,72,70,1972,245,557,.440,146,366,.399,99,191,.518,.571,114,126,.905,61,176,237,163,62,14,72,117,750,Grayson Allen
2023-24,PHO,SG,75,74,2513,340,682,.499,205,445,.461,135,237,.570,.649,129,147,.878,48,247,295,227,69,45,95,157,1014,Grayson Allen
2024-25,PHO,SG,23,1,550,74,183,.404,50,133,.376,24,50,.480,.541,42,50,.840,16,58,74,42,20,7,24,34,240,Grayson Allen
2017-18,BRK,C,72,31,1441,234,397,.589,5,15,.333,229,382,.599,.596,114,147,.776,144,244,388,49,28,88,82,147,587,Jarrett Allen
2018-19,BRK,C,80,80,2096,335,568,.590,6,45,.133,329,523,.629,.595,197,278,.709,191,481,672,110,43,120,103,184,873,Jarrett Allen
2019-20,BRK,C,70,64,1852,302,465,.649,0,6,.000,302,459,.658,.649,171,270,.633,216,455,671,110,40,92,77,162,775,Jarrett Allen
2020-21,2TM,C,63,45,1864,298,482,.618,6,19,.316,292,463,.631,.624,204,290,.703,196,435,631,106,32,90,100,96,806,Jarrett Allen
2020-21,BRK,C,12,5,320,44,65,.677,0,0,,44,65,.677,.677,46,61,.754,38,87,125,20,7,19,22,21,134,Jarrett Allen
2020-21,CLE,C,51,40,1544,254,417,.609,6,19,.316,248,398,.623,.616,158,229,.690,158,348,506,86,25,71,78,75,672,Jarrett Allen
2021-22,CLE,C,56,56,1810,369,545,.677,1,10,.100,368,535,.688,.678,165,233,.708,192,410,602,92,44,75,94,97,904,Jarrett Allen
2022-23,CLE,C,68,68,2220,403,626,.644,1,10,.100,402,616,.653,.645,162,221,.733,221,445,666,113,54,84,93,153,969,Jarrett Allen
2023-24,CLE,C,77,77,2442,519,819,.634,0,6,.000,519,813,.638,.634,233,314,.742,243,568,811,210,53,81,121,147,1271,Jarrett Allen
2024-25,CLE,C,31,31,909,167,243,.687,0,1,.000,167,242,.690,.687,78,106,.736,70,240,310,59,32,24,34,38,412,Jarrett Allen
2023-24,MEM,SF,5,0,125,6,23,.261,0,7,.000,6,16,.375,.261,1,2,.500,4,13,17,5,4,0,2,18,13,Timmy Allen
2021-22,NOP,PG,54,1,834,131,294,.446,32,110,.291,99,184,.538,.500,36,53,.679,25,75,100,152,71,7,40,73,330,Jose Alvarado
2022-23,NOP,PG,61,10,1310,201,489,.411,83,247,.336,118,242,.488,.496,65,80,.813,28,113,141,186,67,10,81,125,550,Jose Alvarado
2023-24,NOP,PG,56,0,1028,142,345,.412,78,207,.377,64,138,.464,.525,35,52,.673,25,103,128,117,59,15,40,89,397,Jose Alvarado
2024-25,NOP,PG,11,7,282,40,101,.396,24,60,.400,16,41,.390,.515,14,17,.824,6,18,24,49,17,3,14,26,118,Jose Alvarado
2015-16,DAL,SF,55,9,647,71,175,.406,22,83,.265,49,92,.533,.469,44,55,.800,18,114,132,29,19,25,24,45,208,Justin Anderson
2016-17,2TM,SF,75,10,1228,186,439,.424,58,194,.299,128,245,.522,.490,102,129,.791,69,176,245,66,41,23,66,109,532,Justin Anderson
2016-17,DAL,SF,51,2,710,111,277,.401,37,122,.303,74,155,.477,.468,70,88,.795,39,110,149,32,28,16,40,64,329,Justin Anderson
2016-17,PHI,SF,24,8,518,75,162,.463,21,72,.292,54,90,.600,.528,32,41,.780,30,66,96,34,13,7,26,45,203,Justin Anderson
2017-18,PHI,SF,38,0,519,87,202,.431,34,103,.330,53,99,.535,.515,28,38,.737,25,68,93,25,15,7,16,54,236,Justin Anderson
2018-19,ATL,SF,48,4,463,64,157,.408,24,77,.312,40,80,.500,.484,26,35,.743,24,60,84,23,22,13,23,48,178,Justin Anderson
2019-20,BRK,SG,10,1,107,10,38,.263,6,29,.207,4,9,.444,.342,2,4,.500,1,20,21,8,0,6,4,13,28,Justin Anderson
2021-22,2TM,SF,16,6,316,36,95,.379,15,59,.254,21,36,.583,.458,15,19,.789,4,42,46,33,8,6,8,22,102,Justin Anderson
2021-22,CLE,SF,3,0,47,4,8,.500,2,6,.333,2,2,1.000,.625,3,4,.750,0,6,6,6,1,0,2,4,13,Justin Anderson
2021-22,IND,SF,13,6,269,32,87,.368,13,53,.245,19,34,.559,.443,12,15,.800,4,36,40,27,7,6,6,18,89,Justin Anderson
2014-15,SAS,SF,33,8,358,31,89,.348,3,11,.273,28,78,.359,.365,9,14,.643,5,67,72,28,15,7,10,28,74,Kyle Anderson
2015-16,SAS,SF,78,11,1245,138,295,.468,12,37,.324,126,258,.488,.488,62,83,.747,25,219,244,123,60,29,59,97,350,Kyle Anderson
2016-17,SAS,SF,72,14,1020,93,209,.445,15,40,.375,78,169,.462,.481,45,57,.789,33,175,208,91,51,26,39,63,246,Kyle Anderson
2017-18,SAS,SF,74,67,1978,231,438,.527,19,57,.333,212,381,.556,.549,104,146,.712,84,312,396,202,115,60,94,114,585,Kyle Anderson
2018-19,MEM,SF,43,40,1281,150,276,.543,9,34,.265,141,242,.583,.560,37,64,.578,48,203,251,128,54,37,58,112,346,Kyle Anderson
2019-20,MEM,SF,67,28,1330,157,331,.474,24,85,.282,133,246,.541,.511,52,78,.667,58,227,285,162,54,37,66,111,390,Kyle Anderson
2020-21,MEM,PF,69,69,1887,308,658,.468,94,261,.360,214,397,.539,.540,144,184,.783,52,344,396,250,84,57,86,120,854,Kyle Anderson
2021-22,MEM,PF,69,11,1484,209,469,.446,36,109,.330,173,360,.481,.484,67,105,.638,69,299,368,183,77,45,71,108,521,Kyle Anderson
2022-23,MIN,PF,69,46,1957,252,495,.509,43,105,.410,209,390,.536,.553,100,136,.735,66,302,368,335,78,63,103,146,647,Kyle Anderson
2023-24,MIN,PF,79,10,1782,199,433,.460,11,48,.229,188,385,.488,.472,97,137,.708,60,213,273,331,71,47,91,128,506,Kyle Anderson
2024-25,GSW,PF,26,2,378,51,123,.415,15,42,.357,36,81,.444,.476,13,20,.650,16,62,78,58,20,12,13,28,130,Kyle Anderson
2013-14,MIL,SF,77,23,1897,173,418,.414,41,118,.347,132,300,.440,.463,138,202,.683,78,261,339,150,60,61,122,173,525,Giannis Antetokounmpo
2014-15,MIL,SG,81,71,2541,383,780,.491,7,44,.159,376,736,.511,.496,257,347,.741,100,442,542,207,73,85,173,254,1030,Giannis Antetokounmpo
2015-16,MIL,PG,80,79,2823,513,1013,.506,28,109,.257,485,904,.537,.520,296,409,.724,113,499,612,345,94,113,208,258,1350,Giannis Antetokounmpo
2016-17,MIL,SF,80,80,2845,656,1259,.521,49,180,.272,607,1079,.563,.541,471,612,.770,142,558,700,434,131,151,234,246,1832,Giannis Antetokounmpo
2017-18,MIL,PF,75,75,2756,742,1402,.529,43,140,.307,699,1262,.554,.545,487,641,.760,156,597,753,361,109,106,223,231,2014,Giannis Antetokounmpo
2018-19,MIL,PF,72,72,2358,721,1247,.578,52,203,.256,669,1044,.641,.599,500,686,.729,159,739,898,424,92,110,268,232,1994,Giannis Antetokounmpo
2019-20,MIL,PF,63,63,1917,685,1238,.553,89,293,.304,596,945,.631,.589,398,629,.633,140,716,856,354,61,66,230,195,1857,Giannis Antetokounmpo
2020-21,MIL,PF,61,61,2013,626,1100,.569,67,221,.303,559,879,.636,.600,398,581,.685,97,574,671,357,72,73,207,168,1717,Giannis Antetokounmpo
2021-22,MIL,PF,67,67,2204,689,1245,.553,71,242,.293,618,1003,.616,.582,553,766,.722,134,644,778,388,72,91,219,212,2002,Giannis Antetokounmpo
2022-23,MIL,PF,63,63,2024,707,1278,.553,47,171,.275,660,1107,.596,.572,498,772,.645,137,605,742,359,52,51,246,197,1959,Giannis Antetokounmpo
2023-24,MIL,PF,73,73,2567,837,1369,.611,34,124,.274,803,1245,.645,.624,514,782,.657,196,645,841,476,87,79,250,210,2222,Giannis Antetokounmpo
2024-25,MIL,PF,24,24,840,307,501,.613,4,18,.222,303,483,.627,.617,167,272,.614,48,230,278,144,17,36,82,56,785,Giannis Antetokounmpo
2018-19,DAL,PF,2,0,11,0,3,.000,0,0,0,3,.000,.000,2,4,.500,0,1,1,0,2,0,1,0,2,0,Kostas Antetokounmpo
2019-20,LAL,PF,5,0,20,3,3,1.000,0,0,3,3,1.000,1.000,1,2,.500,2,1,3,2,0,0,1,2,7,0,Kostas Antetokounmpo
2020-21,LAL,PF,15,0,56,3,10,.300,0,0,3,10,.300,.300,6,13,.462,4,15,19,1,2,4,11,8,12,0,Kostas Antetokounmpo
2015-16,NYK,SF,2,0,6,3,4,.750,0,1,.000,3,3,1.000,.750,0,0,,0,1,1,0,0,0,0,2,6,Thanasis Antetokounmpo
2019-20,MIL,SF,20,2,129,24,48,.500,0,10,.000,24,38,.632,.500,7,17,.412,12,12,24,15,7,2,12,18,55,Thanasis Antetokounmpo
2020-21,MIL,SF,57,3,551,67,137,.489,7,29,.241,60,108,.556,.515,25,49,.510,54,70,124,46,22,10,43,74,166,Thanasis Antetokounmpo
2021-22,MIL,SF,48,6,473,70,128,.547,2,14,.143,68,114,.596,.555,29,46,.630,40,61,101,22,16,12,26,68,171,Thanasis Antetokounmpo
2022-23,MIL,PF,37,0,206,20,46,.435,0,8,.000,20,38,.526,.435,11,22,.500,15,29,44,15,3,3,12,22,51,Thanasis Antetokounmpo
2023-24,MIL,PF,34,0,155,16,30,.533,0,1,.000,16,29,.552,.533,0,2,.000,7,6,13,17,7,4,14,24,32,Thanasis Antetokounmpo
2020-21,ORL,PG,47,34,1273,219,552,.397,58,172,.337,161,380,.424,.449,109,131,.832,38,183,221,192,30,18,106,98,605,Cole Anthony
2021-22,ORL,PG,65,65,2059,357,912,.391,132,391,.338,225,521,.432,.464,216,253,.854,32,316,348,369,46,17,170,171,1062,Cole Anthony
2022-23,ORL,PG,60,4,1552,277,610,.454,75,206,.364,202,404,.500,.516,152,170,.894,47,241,288,235,37,31,91,158,781,Cole Anthony
2023-24,ORL,PG,81,0,1817,332,763,.435,93,275,.338,239,488,.490,.496,180,218,.826,64,247,311,236,64,37,126,175,937,Cole Anthony
2024-25,ORL,PG,30,0,350,65,164,.396,20,67,.299,45,97,.464,.457,32,41,.780,11,55,66,67,11,5,45,47,182,Cole Anthony
2017-18,TOR,SF,74,62,1481,163,346,.471,73,197,.371,90,149,.604,.577,39,62,.629,44,140,184,55,52,14,45,130,438,OG Anunoby
2018-19,TOR,SF,67,6,1352,183,404,.453,67,202,.332,116,202,.574,.536,36,62,.581,58,139,197,47,46,22,55,140,469,OG Anunoby
2019-20,TOR,SF,69,68,2066,286,566,.505,89,228,.390,197,338,.583,.584,72,102,.706,80,284,364,108,96,45,79,167,733,OG Anunoby
2020-21,TOR,SF,43,43,1433,249,519,.480,104,261,.398,145,258,.562,.580,80,102,.784,54,183,237,94,66,32,75,114,682,OG Anunoby
2021-22,TOR,SF,48,48,1728,309,697,.443,115,317,.363,194,380,.511,.526,89,118,.754,74,190,264,125,71,25,80,131,822,OG Anunoby
2022-23,TOR,SF,67,67,2386,421,885,.476,142,367,.387,279,518,.539,.556,140,167,.838,95,237,332,131,128,50,132,200,1124,OG Anunoby
2023-24,2TM,SF,50,50,1702,282,577,.489,102,267,.382,180,310,.581,.577,67,89,.753,47,161,208,107,68,36,81,119,733,OG Anunoby
2023-24,TOR,SF,27,27,900,157,321,.489,61,163,.374,96,158,.608,.584,33,46,.717,24,82,106,72,28,13,43,62,408,OG Anunoby
2023-24,NYK,SF,23,23,802,125,256,.488,41,104,.394,84,152,.553,.568,34,43,.791,23,79,102,35,40,23,38,57,325,OG Anunoby
2024-25,NYK,PF,31,31,1122,195,407,.479,65,183,.355,130,224,.580,.559,58,73,.795,37,119,156,63,47,31,42,78,513,OG Anunoby
2017-18,CHI,PG,24,0,304,17,41,.415,9,31,.290,8,10,.800,.524,5,6,.833,1,24,25,35,13,0,13,18,48,Ryan Arcidiacono
2018-19,CHI,PG,81,32,1961,187,418,.447,81,217,.373,106,201,.527,.544,89,102,.873,27,192,219,269,65,4,63,171,544,Ryan Arcidiacono
2019-20,CHI,PG,58,4,930,90,220,.409,54,138,.391,36,82,.439,.532,27,38,.711,20,90,110,96,27,3,37,96,261,Ryan Arcidiacono
2020-21,CHI,PG,44,0,450,49,117,.419,25,67,.373,24,50,.480,.526,13,20,.650,5,62,67,56,9,0,10,47,136,Ryan Arcidiacono
2021-22,NYK,PG,10,0,76,6,12,.500,4,9,.444,2,3,.667,.667,0,0,,0,8,8,4,1,0,3,5,16,Ryan Arcidiacono
2022-23,2TM,PG,20,4,172,9,37,.243,8,23,.348,1,14,.071,.351,0,0,,0,15,15,23,5,0,7,17,26,Ryan Arcidiacono
2022-23,NYK,PG,11,0,26,1,5,.200,1,3,.333,0,2,.000,.300,0,0,,0,4,4,2,2,0,1,3,3,Ryan Arcidiacono
2022-23,POR,PG,9,4,146,8,32,.250,7,20,.350,1,12,.083,.359,0,0,,0,11,11,21,3,0,6,14,23,Ryan Arcidiacono
2023-24,NYK,PG,20,0,45,0,6,.000,0,6,.000,0,0,,.000,0,0,,0,8,8,4,2,0,2,5,0,Ryan Arcidiacono
2020-21,WAS,SF,54,32,1257,130,312,.417,53,168,.315,77,144,.535,.502,29,45,.644,22,240,262,63,32,15,33,140,342,Deni Avdija
2021-22,WAS,SF,82,8,1984,250,579,.432,82,259,.317,168,320,.525,.503,103,136,.757,52,373,425,167,59,44,87,190,685,Deni Avdija
2022-23,WAS,SF,76,40,2020,253,579,.437,69,232,.297,184,347,.530,.497,122,165,.739,74,413,487,211,65,29,123,209,697,Deni Avdija
2023-24,WAS,SF,75,75,2257,406,803,.506,88,235,.374,318,568,.560,.560,202,273,.740,84,456,540,286,60,36,160,185,1102,Deni Avdija
2024-25,POR,SF,30,12,794,128,287,.446,44,121,.364,84,166,.506,.523,91,117,.778,39,135,174,95,28,22,62,65,391,Deni Avdija
2021-22,WAS,SG,7,0,20,1,6,.167,0,1,.000,1,5,.200,.167,0,0,1,2,3,4,0,0,0,0,2,0,Joel Ayayi
2018-19,PHO,C,71,70,2183,509,870,.585,0,4,.000,509,866,.588,.585,141,189,.746,223,506,729,125,61,67,126,209,1159,Deandre Ayton
2019-20,PHO,C,38,32,1236,310,568,.546,3,13,.231,307,555,.553,.548,67,89,.753,147,289,436,72,26,58,80,117,690,Deandre Ayton
2020-21,PHO,C,69,69,2115,430,687,.626,4,20,.200,426,667,.639,.629,133,173,.769,228,499,727,99,41,81,103,196,997,Deandre Ayton
2021-22,PHO,C,58,58,1713,442,697,.634,7,19,.368,435,678,.642,.639,106,142,.746,149,444,593,84,40,40,91,142,997,Deandre Ayton
2022-23,PHO,C,67,67,2035,522,887,.589,7,24,.292,515,863,.597,.592,152,200,.760,172,495,667,115,37,53,120,190,1203,Deandre Ayton
2023-24,POR,C,55,55,1784,427,749,.570,1,10,.100,426,739,.576,.571,65,79,.823,176,433,609,90,56,42,99,109,920,Deandre Ayton
2024-25,POR,C,21,21,637,142,254,.559,6,23,.261,136,231,.589,.571,15,24,.625,62,150,212,29,19,19,34,49,305,Deandre Ayton
2020-21,UTA,C,15,0,57,4,9,.444,0,0,4,9,.444,.444,8,10,.800,4,9,13,0,1,4,3,9,16,0,Udoka Azubuike
2021-22,UTA,C,17,6,195,37,49,.755,0,0,37,49,.755,.755,6,11,.545,18,53,71,0,1,11,12,25,80,0,Udoka Azubuike
2022-23,UTA,C,36,4,359,59,72,.819,0,0,59,72,.819,.819,7,20,.350,31,88,119,11,6,15,18,34,125,0,Udoka Azubuike
2023-24,PHO,C,16,0,113,16,23,.696,0,0,16,23,.696,.696,3,13,.231,11,21,32,3,1,6,4,17,35,0,Udoka Azubuike
2023-24,POR,C,22,1,226,14,22,.636,0,0,14,22,.636,.636,6,12,.500,20,31,51,13,3,20,15,46,34,0,Ibou Badji
2018-19,SAC,PF,62,4,1567,356,706,.504,30,96,.313,326,610,.534,.525,181,262,.691,162,309,471,62,33,59,98,120,923,Marvin Bagley III
2019-20,SAC,C,13,6,334,78,167,.467,4,22,.182,74,145,.510,.479,25,31,.806,29,68,97,10,6,12,18,43,185,Marvin Bagley III
2020-21,SAC,PF,43,42,1112,247,490,.504,37,108,.343,210,382,.550,.542,77,134,.575,106,212,318,43,21,21,59,100,608,Marvin Bagley III
2021-22,2TM,PF,48,25,1153,225,446,.504,23,97,.237,202,349,.579,.530,67,101,.663,105,233,338,36,22,18,39,93,540,Marvin Bagley III
2021-22,SAC,PF,30,17,663,114,246,.463,15,62,.242,99,184,.538,.494,35,47,.745,67,148,215,17,9,11,21,50,278,Marvin Bagley III
2021-22,DET,PF,18,8,490,111,200,.555,8,35,.229,103,165,.624,.575,32,54,.593,38,85,123,19,13,7,18,43,262,Marvin Bagley III
2022-23,DET,C,42,25,990,202,382,.529,19,66,.288,183,316,.579,.554,81,108,.750,94,175,269,36,19,30,46,81,504,Marvin Bagley III
2023-24,2TM,C,50,25,1053,239,408,.586,9,23,.391,230,385,.597,.597,96,126,.762,130,182,312,55,20,33,59,81,583,Marvin Bagley III
2023-24,DET,C,26,10,478,107,181,.591,1,6,.167,106,175,.606,.594,50,61,.820,46,72,118,27,5,14,29,40,265,Marvin Bagley III
2023-24,WAS,C,24,15,575,132,227,.581,8,17,.471,124,210,.590,.599,46,65,.708,84,110,194,28,15,19,30,41,318,Marvin Bagley III
2024-25,WAS,C,19,1,166,38,71,.535,2,10,.200,36,61,.590,.549,15,23,.652,27,29,56,7,7,5,11,12,93,Marvin Bagley III
2023-24,CHO,PG,10,0,65,8,24,.333,1,8,.125,7,16,.438,.354,6,7,.857,6,3,9,7,3,0,4,2,23,Amari Bailey
2022-23,GSW,SF,31,0,226,43,109,.394,32,84,.381,11,25,.440,.541,4,6,.667,1,39,40,11,6,4,11,14,122,Patrick Baldwin Jr.
2023-24,WAS,SF,38,7,493,59,155,.381,31,97,.320,28,58,.483,.481,19,28,.679,17,106,123,29,18,15,19,56,168,Patrick Baldwin Jr.
2024-25,WAS,SF,13,0,59,10,20,.500,5,11,.455,5,9,.556,.625,2,4,.500,3,9,12,1,2,2,2,4,27,Patrick Baldwin Jr.
2020-21,CHO,PG,51,31,1469,293,672,.436,92,261,.352,201,411,.489,.504,125,165,.758,63,239,302,313,81,18,145,136,803,LaMelo Ball
2021-22,CHO,PG,75,75,2422,538,1254,.429,220,565,.389,318,689,.462,.517,212,243,.872,108,393,501,571,119,30,245,237,1508,LaMelo Ball
2022-23,CHO,PG,36,36,1268,296,721,.411,144,383,.376,152,338,.450,.510,102,122,.836,42,189,231,304,46,11,129,118,838,LaMelo Ball
2023-24,CHO,PG,22,22,711,183,423,.433,70,197,.355,113,226,.500,.515,90,104,.865,29,84,113,176,40,4,83,79,526,LaMelo Ball
2024-25,CHO,PG,22,22,742,230,541,.425,99,286,.346,131,255,.514,.517,103,122,.844,19,98,117,163,29,5,90,82,662,LaMelo Ball
2017-18,LAL,PG,52,50,1780,203,564,.360,90,295,.305,113,269,.420,.440,32,71,.451,69,291,360,376,88,43,136,117,528,Lonzo Ball
2018-19,LAL,PG,47,45,1423,185,456,.406,75,228,.329,110,228,.482,.488,20,48,.417,54,197,251,255,69,19,103,114,465,Lonzo Ball
2019-20,NOP,PG,63,54,2025,277,687,.403,148,395,.375,129,292,.442,.511,43,76,.566,71,312,383,438,88,38,193,128,745,Lonzo Ball
2020-21,NOP,PG,55,55,1747,290,700,.414,172,455,.378,118,245,.482,.537,50,64,.781,33,230,263,316,82,31,123,103,802,Lonzo Ball
2021-22,CHI,PG,35,35,1212,162,383,.423,110,260,.423,52,123,.423,.567,21,28,.750,35,155,190,178,64,31,82,85,455,Lonzo Ball
2024-25,CHI,PG,12,0,210,20,64,.313,15,53,.283,5,11,.455,.430,7,7,1.000,4,33,37,43,13,7,12,14,62,Lonzo Ball
2018-19,ORL,C,47,1,766,117,243,.481,21,70,.300,96,173,.555,.525,37,63,.587,64,169,233,39,13,64,43,102,292,Mo Bamba
2019-20,ORL,C,62,0,878,132,286,.462,37,107,.346,95,179,.531,.526,31,46,.674,100,202,302,42,23,86,42,116,332,Mo Bamba
2020-21,ORL,C,46,5,725,142,301,.472,38,118,.322,104,183,.568,.535,45,66,.682,76,189,265,35,14,58,36,87,367,Mo Bamba
2021-22,ORL,C,71,69,1824,296,617,.480,107,281,.381,189,336,.563,.566,57,73,.781,148,424,572,85,38,118,77,182,756,Mo Bamba
2022-23,2TM,C,49,7,769,117,241,.485,48,124,.387,69,117,.590,.585,41,62,.661,58,167,225,46,13,43,30,105,323,Mo Bamba
2022-23,ORL,C,40,6,681,106,214,.495,43,108,.398,63,106,.594,.596,35,51,.686,47,137,184,42,12,38,22,86,290,Mo Bamba
2022-23,LAL,C,9,1,88,11,27,.407,5,16,.313,6,11,.545,.500,6,11,.545,11,30,41,4,1,5,8,19,33,Mo Bamba
2023-24,PHI,C,57,17,740,97,198,.490,25,64,.391,72,134,.537,.553,34,50,.680,77,161,238,41,22,60,39,101,253,Mo Bamba
2024-25,LAC,C,16,0,205,23,58,.397,6,27,.222,17,31,.548,.448,9,13,.692,11,49,60,11,8,19,10,33,61,Mo Bamba
2022-23,ORL,PF,72,72,2430,479,1122,.427,85,285,.298,394,837,.471,.465,394,534,.738,84,413,497,269,60,39,200,160,1437,Paolo Banchero
2023-24,ORL,PF,80,80,2799,640,1407,.455,119,351,.339,521,1056,.493,.497,405,559,.725,82,472,554,431,71,47,247,153,1804,Paolo Banchero
2024-25,ORL,PF,5,5,182,48,97,.495,11,32,.344,37,65,.569,.552,38,59,.644,12,32,44,28,3,4,11,13,145,Paolo Banchero
2020-21,MEM,SG,68,17,1519,234,499,.469,117,271,.432,117,228,.513,.586,40,49,.816,31,179,210,118,41,16,59,125,625,Desmond Bane
2021-22,MEM,SG,76,76,2266,508,1101,.461,228,523,.436,280,578,.484,.565,140,155,.903,46,288,334,208,92,29,111,196,1384,Desmond Bane
2022-23,MEM,SG,58,58,1841,450,939,.479,166,407,.408,284,532,.534,.568,181,205,.883,43,248,291,254,56,22,126,150,1247,Desmond Bane
2023-24,MEM,SG,42,42,1443,360,776,.464,137,360,.381,223,416,.536,.552,140,161,.870,36,149,185,230,43,22,112,120,997,Desmond Bane
2024-25,MEM,SG,24,23,676,137,296,.463,48,136,.353,89,160,.556,.544,48,56,.857,20,120,140,116,29,11,53,63,370,Desmond Bane
2021-22,TOR,PG,64,1,696,83,202,.411,13,51,.255,70,151,.464,.443,26,44,.591,38,86,124,99,28,10,53,68,205,Dalano Banton
2022-23,TOR,PG,31,2,279,55,130,.423,15,51,.294,40,79,.506,.481,17,24,.708,11,34,45,36,13,13,18,34,142,Dalano Banton
2023-24,2TM,PG,54,9,1047,202,500,.404,59,199,.296,143,301,.475,.463,94,120,.783,41,137,178,127,33,20,77,64,557,Dalano Banton
2023-24,BOS,PG,24,1,171,19,51,.373,2,16,.125,17,35,.486,.392,16,20,.800,12,23,35,19,5,3,10,20,56,Dalano Banton
2023-24,POR,PG,30,8,876,183,449,.408,57,183,.311,126,266,.474,.471,78,100,.780,29,114,143,108,28,17,67,44,501,Dalano Banton
2024-25,POR,PG,25,0,413,85,202,.421,31,87,.356,54,115,.470,.498,37,56,.661,9,47,56,66,22,13,43,27,238,Dalano Banton
2021-22,ATL,PG,3,0,13,0,4,.000,0,0,0,4,.000,.000,0,4,.000,1,2,3,3,0,0,1,1,0,0,Cat Barber
2022-23,SAS,PF,28,0,408,46,86,.535,0,4,.000,46,82,.561,.535,18,25,.720,46,56,102,24,10,19,15,56,110,Dominick Barlow
2023-24,SAS,PF,33,1,420,56,113,.496,3,9,.333,53,104,.510,.509,29,42,.690,45,68,113,36,12,14,9,47,144,Dominick Barlow
2024-25,ATL,SF,3,0,16,1,2,.500,1,1,1.000,0,1,.000,.750,1,2,.500,0,1,1,0,1,0,0,2,4,Dominick Barlow
2012-13,GSW,SF,81,81,2058,276,628,.439,52,145,.359,224,483,.464,.481,144,190,.758,53,280,333,98,52,14,101,140,748,Harrison Barnes
2013-14,GSW,SF,78,24,2204,271,679,.399,66,190,.347,205,489,.419,.448,130,181,.718,66,245,311,116,65,20,84,158,738,Harrison Barnes
2014-15,GSW,SF,82,82,2318,316,656,.482,87,215,.405,229,441,.519,.548,108,150,.720,117,336,453,116,61,19,71,146,827,Harrison Barnes
2015-16,GSW,SF,66,59,2042,295,633,.466,82,214,.383,213,419,.508,.531,102,134,.761,77,248,325,117,41,10,57,136,774,Harrison Barnes
2016-17,DAL,PF,79,79,2803,599,1280,.468,78,222,.351,521,1058,.492,.498,242,281,.861,93,301,394,116,65,15,102,128,1518,Harrison Barnes
2017-18,DAL,PF,77,77,2634,537,1208,.445,119,333,.357,418,875,.478,.494,259,313,.827,77,391,468,152,49,14,118,94,1452,Harrison Barnes
2018-19,2TM,PF,77,77,2533,431,1027,.420,174,441,.395,257,586,.439,.504,229,278,.824,57,304,361,115,50,13,98,122,1265,Harrison Barnes
2018-19,DAL,PF,49,49,1584,290,717,.404,121,311,.389,169,406,.416,.489,165,198,.833,36,171,207,62,33,11,68,79,866,Harrison Barnes
2018-19,SAC,SF,28,28,949,141,310,.455,53,130,.408,88,180,.489,.540,64,80,.800,21,133,154,53,17,2,30,43,399,Harrison Barnes
2019-20,SAC,PF,72,72,2482,365,793,.460,102,268,.381,263,525,.501,.525,214,267,.801,77,278,355,159,43,12,88,93,1046,Harrison Barnes
2020-21,SAC,PF,58,58,2102,319,642,.497,100,256,.391,219,386,.567,.575,195,235,.830,64,321,385,201,43,11,93,75,933,Harrison Barnes
2021-22,SAC,PF,77,77,2580,391,834,.469,142,360,.394,249,474,.525,.554,341,413,.826,82,350,432,186,53,14,118,94,1265,Harrison Barnes
2022-23,SAC,PF,82,82,2662,374,791,.473,132,353,.374,242,438,.553,.556,350,413,.847,87,279,366,128,57,10,86,103,1230,Harrison Barnes
2023-24,SAC,PF,82,82,2381,347,732,.474,149,385,.387,198,347,.571,.576,157,196,.801,67,182,249,99,54,12,58,98,1000,Harrison Barnes
2024-25,SAS,PF,31,31,853,105,225,.467,42,105,.400,63,120,.525,.560,66,84,.786,47,71,118,47,9,6,22,25,318,Harrison Barnes
2021-22,TOR,PF,74,74,2617,459,932,.492,58,193,.301,401,739,.543,.524,158,215,.735,195,362,557,256,80,55,136,192,1134,Scottie Barnes
2022-23,TOR,SF,77,76,2678,463,1016,.456,63,224,.281,400,792,.505,.487,190,246,.772,179,333,512,371,83,61,154,170,1179,Scottie Barnes
2023-24,TOR,SG,60,60,2094,447,942,.475,101,296,.341,346,646,.536,.528,196,251,.781,141,353,494,363,75,88,165,118,1191,Scottie Barnes
2024-25,TOR,PF,18,18,612,133,296,.449,30,106,.283,103,190,.542,.500,64,88,.727,33,107,140,130,23,12,63,43,360,Scottie Barnes
2019-20,NYK,SG,56,55,1704,292,727,.402,63,197,.320,229,530,.432,.445,156,254,.614,50,229,279,143,55,17,124,122,803,RJ Barrett
2020-21,NYK,SG,72,72,2511,467,1060,.441,124,309,.401,343,751,.457,.499,206,276,.746,68,346,414,217,53,20,139,188,1264,RJ Barrett
2021-22,NYK,SF,70,70,2417,487,1194,.408,138,404,.342,349,790,.442,.466,290,406,.714,66,342,408,208,43,16,151,142,1402,RJ Barrett
2022-23,NYK,SG,73,73,2475,510,1176,.434,121,390,.310,389,786,.495,.485,290,392,.740,60,308,368,201,31,15,164,179,1431,RJ Barrett
2023-24,2TM,SG,58,58,1838,436,880,.495,90,250,.360,346,630,.549,.547,208,291,.715,53,262,315,193,31,22,126,129,1170,RJ Barrett
2023-24,NYK,SG,26,26,766,164,388,.423,43,130,.331,121,258,.469,.478,103,124,.831,19,92,111,63,12,9,47,45,474,RJ Barrett
2023-24,TOR,SG,32,32,1072,272,492,.553,47,120,.392,225,372,.605,.601,105,167,.629,34,170,204,130,19,13,79,84,696,RJ Barrett
2024-25,TOR,SG,26,26,891,224,486,.461,51,146,.349,173,340,.509,.513,116,160,.725,25,152,177,163,18,11,88,65,615,RJ Barrett
2021-22,PHO,SF,2,0,7,2,6,.333,0,2,.000,2,4,.500,.333,2,2,1.000,2,2,4,0,1,0,2,2,6,Paris Bass
2021-22,PHI,C,23,0,168,30,47,.638,0,4,.000,30,43,.698,.638,9,12,.750,22,40,62,7,5,17,8,32,69,Charles Bassey
2022-23,SAS,C,35,2,508,87,135,.644,3,8,.375,84,127,.661,.656,22,37,.595,75,118,193,48,16,33,41,74,199,Charles Bassey
2023-24,SAS,C,19,0,205,29,40,.725,0,1,.000,29,39,.744,.725,5,6,.833,23,53,76,21,8,17,15,31,63,Charles Bassey
2024-25,SAS,C,20,0,219,43,75,.573,0,0,,43,75,.573,.573,13,23,.565,32,56,88,9,7,22,15,27,99,Charles Bassey
2023-24,CLE,SF,15,0,133,15,49,.306,10,33,.303,5,16,.313,.408,1,4,.250,1,13,14,10,1,2,8,5,41,Emoni Bates
2018-19,MIN,SF,30,3,503,60,142,.423,13,52,.250,47,90,.522,.468,18,28,.643,16,67,83,17,18,14,14,29,151,Keita Bates-Diop
2019-20,2TM,SF,44,0,744,100,234,.427,34,103,.330,66,131,.504,.500,54,75,.720,25,102,127,30,19,24,17,43,288,Keita Bates-Diop
2019-20,MIN,PF,37,0,646,87,206,.422,31,94,.330,56,112,.500,.498,46,65,.708,21,89,110,30,17,20,14,36,251,Keita Bates-Diop
2019-20,DEN,SF,7,0,98,13,28,.464,3,9,.333,10,19,.526,.518,8,10,.800,4,13,17,0,2,4,3,7,37,Keita Bates-Diop
2020-21,SAS,SF,30,0,245,30,67,.448,5,17,.294,25,50,.500,.485,14,21,.667,9,40,49,12,11,5,7,11,79,Keita Bates-Diop
2021-22,SAS,SF,59,14,957,136,263,.517,17,55,.309,119,208,.572,.549,46,61,.754,62,169,231,41,27,14,45,61,335,Keita Bates-Diop
2022-23,SAS,PF,67,42,1452,236,465,.508,56,142,.394,180,323,.557,.568,119,150,.793,65,183,248,103,46,20,56,63,647,Keita Bates-Diop
2023-24,2TM,SF,53,8,665,72,166,.434,21,69,.304,51,97,.526,.497,32,42,.762,31,79,110,38,25,22,15,35,197,Keita Bates-Diop
2023-24,PHO,SF,39,8,597,64,150,.427,20,64,.313,44,86,.512,.493,26,36,.722,30,71,101,34,22,20,13,33,174,Keita Bates-Diop
2023-24,BRK,SF,14,0,68,8,16,.500,1,5,.200,7,11,.636,.531,6,6,1.000,1,8,9,4,3,2,2,2,23,Keita Bates-Diop
2024-25,TOR,SF,28,0,391,59,124,.476,39,93,.419,20,31,.645,.633,12,14,.857,16,38,54,28,4,4,11,34,169,Jamison Battle
2008-09,POR,SF,79,76,1454,161,361,.446,62,168,.369,99,193,.513,.532,42,52,.808,84,136,220,74,50,40,50,139,426,Nicolas Batum
2009-10,POR,SF,37,25,918,139,268,.519,54,132,.409,85,136,.625,.619,43,51,.843,32,109,141,44,24,25,27,83,375,Nicolas Batum
2010-11,POR,SF,80,67,2522,367,807,.455,118,342,.345,249,465,.535,.528,138,164,.841,109,252,361,123,68,49,83,194,990,Nicolas Batum
2011-12,POR,SF,59,34,1791,289,641,.451,107,274,.391,182,367,.496,.534,133,159,.836,81,190,271,84,57,60,90,105,818,Nicolas Batum
2012-13,POR,SF,73,73,2807,352,833,.423,165,444,.372,187,389,.481,.522,178,210,.848,97,315,412,360,91,83,190,139,1047,Nicolas Batum
2013-14,POR,SF,82,82,2956,381,819,.465,145,402,.361,236,417,.566,.554,163,203,.803,116,495,611,420,75,57,208,156,1070,Nicolas Batum
2014-15,POR,SF,71,71,2380,240,600,.400,100,309,.324,140,291,.481,.483,84,98,.857,62,354,416,341,78,40,132,106,664,Nicolas Batum
2015-16,CHO,SF,70,70,2448,372,873,.426,139,399,.348,233,474,.492,.506,163,192,.849,55,373,428,403,65,43,205,114,1046,Nicolas Batum
2016-17,CHO,SG,77,77,2617,393,975,.403,135,405,.333,258,570,.453,.472,243,284,.856,46,435,481,456,86,29,194,109,1164,Nicolas Batum
2017-18,CHO,SG,64,64,1981,270,650,.415,92,274,.336,178,376,.473,.486,108,130,.831,57,249,306,349,65,23,131,72,740,Nicolas Batum
2018-19,CHO,SF,75,72,2354,253,562,.450,116,298,.389,137,264,.519,.553,77,89,.865,71,319,390,247,71,43,117,140,699,Nicolas Batum
2019-20,CHO,SF,22,3,505,28,81,.346,14,49,.286,14,32,.438,.432,9,10,.900,25,75,100,66,17,8,22,41,79,Nicolas Batum
2020-21,LAC,SF,67,38,1835,191,412,.464,110,272,.404,81,140,.579,.597,48,58,.828,50,266,316,148,69,37,53,102,540,Nicolas Batum
2021-22,LAC,PF,59,54,1463,179,387,.463,108,270,.400,71,117,.607,.602,25,38,.658,29,225,254,100,58,42,40,80,491,Nicolas Batum
2022-23,LAC,PF,78,19,1709,160,381,.420,124,317,.391,36,64,.563,.583,34,48,.708,62,237,299,121,54,44,50,149,478,Nicolas Batum
2023-24,2TM,PF,60,38,1529,116,256,.453,73,185,.395,43,71,.606,.596,15,21,.714,70,178,248,128,48,38,40,109,320,Nicolas Batum
2023-24,LAC,PF,3,0,54,3,8,.375,2,7,.286,1,1,1.000,.500,0,0,,0,7,7,5,3,4,1,5,8,Nicolas Batum
2023-24,PHI,PF,57,38,1475,113,248,.456,71,178,.399,42,70,.600,.599,15,21,.714,70,171,241,123,45,34,39,104,312,Nicolas Batum
2024-25,LAC,PF,31,1,573,37,96,.385,30,78,.385,7,18,.389,.542,10,13,.769,21,65,86,50,15,14,17,43,114,Nicolas Batum
2012-13,GSW,SG,61,0,267,43,116,.371,10,34,.294,33,82,.402,.414,27,44,.614,5,17,22,22,17,4,18,27,123,Kent Bazemore
2013-14,2TM,SG,67,15,911,147,343,.429,43,128,.336,104,215,.484,.491,66,109,.606,10,107,117,91,43,13,79,102,403,Kent Bazemore
2013-14,GSW,SG,44,0,268,36,97,.371,10,39,.256,26,58,.448,.423,19,36,.528,5,35,40,20,12,6,28,42,101,Kent Bazemore
2013-14,LAL,SG,23,15,643,111,246,.451,33,89,.371,78,157,.497,.518,47,73,.644,5,72,77,71,31,7,51,60,302,Kent Bazemore
2014-15,ATL,SG,75,10,1324,141,331,.426,48,132,.364,93,199,.467,.498,60,100,.600,21,201,222,78,52,33,73,127,390,Kent Bazemore
2015-16,ATL,SF,75,68,2083,320,725,.441,109,305,.357,211,420,.502,.517,123,151,.815,28,351,379,171,98,38,138,176,872,Kent Bazemore
2016-17,ATL,SF,73,64,1963,295,721,.409,92,266,.346,203,455,.446,.473,119,168,.708,45,186,231,177,91,52,125,165,801,Kent Bazemore
2017-18,ATL,SG,65,65,1789,284,676,.420,108,274,.394,176,402,.438,.500,160,201,.796,25,223,248,228,100,45,157,147,836,Kent Bazemore
2018-19,ATL,SG,67,35,1643,278,691,.402,96,300,.320,182,391,.465,.472,127,175,.726,37,224,261,152,89,42,121,170,779,Kent Bazemore
2019-20,2TM,SF,68,21,1688,200,534,.375,84,244,.344,116,290,.400,.453,113,147,.769,27,267,294,93,74,40,91,196,597,Kent Bazemore
2019-20,POR,SF,43,21,1111,113,326,.347,56,171,.327,57,155,.368,.433,58,72,.806,13,159,172,61,45,31,60,121,340,Kent Bazemore
2019-20,SAC,SF,25,0,577,87,208,.418,28,73,.384,59,135,.437,.486,55,75,.733,14,108,122,32,29,9,31,75,257,Kent Bazemore
2020-21,GSW,SF,67,18,1333,176,392,.449,75,184,.408,101,208,.486,.545,54,78,.692,26,203,229,108,69,33,82,158,481,Kent Bazemore
2021-22,LAL,SF,39,14,545,45,139,.324,29,80,.363,16,59,.271,.428,13,17,.765,13,56,69,34,25,9,21,70,132,Kent Bazemore
2019-20,OKC,PF,61,9,1130,125,317,.394,49,141,.348,76,176,.432,.472,43,62,.694,30,216,246,41,23,41,45,55,342,Darius Bazley
2020-21,OKC,PF,55,55,1714,273,690,.396,83,286,.290,190,404,.470,.456,125,178,.702,51,345,396,99,29,25,122,60,754,Darius Bazley
2021-22,OKC,PF,69,53,1924,274,649,.422,80,269,.297,194,380,.511,.484,117,170,.688,71,365,436,97,58,70,90,68,745,Darius Bazley
2022-23,2TM,C,43,1,616,83,183,.454,20,53,.377,63,130,.485,.508,38,70,.543,34,104,138,38,22,34,27,44,224,Darius Bazley
2022-23,OKC,C,36,1,555,71,158,.449,18,45,.400,53,113,.469,.506,36,65,.554,29,93,122,32,19,29,22,35,196,Darius Bazley
2022-23,PHO,C,7,0,61,12,25,.480,2,8,.250,10,17,.588,.520,2,5,.400,5,11,16,6,3,5,5,9,28,Darius Bazley
2023-24,2TM,PF,9,0,152,18,30,.600,2,8,.250,16,22,.727,.633,10,12,.833,8,20,28,7,6,7,8,3,48,Darius Bazley
2023-24,PHI,PF,3,0,10,0,1,.000,0,0,,0,1,.000,.000,0,0,,0,1,1,2,0,0,1,0,0,Darius Bazley
2023-24,UTA,PF,6,0,142,18,29,.621,2,8,.250,16,21,.762,.655,10,12,.833,8,19,27,5,6,7,7,3,48,Darius Bazley
2012-13,WAS,SG,56,46,1745,282,687,.410,91,236,.386,191,451,.424,.477,125,159,.786,43,168,211,137,50,29,90,113,780,Bradley Beal
2013-14,WAS,SG,73,73,2530,481,1149,.419,138,343,.402,343,806,.426,.479,149,189,.788,54,219,273,243,71,18,128,153,1249,Bradley Beal
2014-15,WAS,SG,63,59,2107,363,851,.427,106,259,.409,257,592,.434,.489,130,166,.783,57,184,241,194,76,18,123,136,962,Bradley Beal
2015-16,WAS,SG,55,35,1708,359,799,.449,105,271,.387,254,528,.481,.515,135,176,.767,41,147,188,162,54,11,112,117,958,Bradley Beal
2016-17,WAS,SG,77,77,2684,637,1322,.482,223,552,.404,414,770,.538,.566,282,342,.825,53,187,240,267,83,21,156,169,1779,Bradley Beal
2017-18,WAS,SG,82,82,2977,683,1484,.460,199,530,.375,484,954,.507,.527,292,369,.791,61,302,363,373,96,36,214,160,1857,Bradley Beal
2018-19,WAS,SG,82,82,3028,764,1609,.475,209,596,.351,555,1013,.548,.540,362,448,.808,89,322,411,448,121,58,224,226,2099,Bradley Beal
2019-20,WAS,SG,57,57,2053,593,1303,.455,170,481,.353,423,822,.515,.520,385,457,.842,52,190,242,347,71,23,194,126,1741,Bradley Beal
2020-21,WAS,SG,60,60,2147,670,1382,.485,130,373,.349,540,1009,.535,.532,408,459,.889,72,211,283,265,69,22,187,140,1878,Bradley Beal
2021-22,WAS,SG,40,40,1439,348,771,.451,63,210,.300,285,561,.508,.492,169,203,.833,38,151,189,265,36,15,135,95,928,Bradley Beal
2022-23,WAS,SG,50,50,1673,444,878,.506,80,219,.365,364,659,.552,.551,192,228,.842,41,155,196,271,45,33,145,107,1160,Bradley Beal
2023-24,PHO,SG,53,53,1767,377,735,.513,101,235,.430,276,500,.552,.582,109,134,.813,54,178,232,265,52,27,131,127,964,Bradley Beal
2024-25,PHO,SG,20,20,683,144,292,.493,45,115,.391,99,177,.559,.570,37,48,.771,15,61,76,64,24,14,48,56,370,Bradley Beal
2016-17,DEN,SG,22,1,165,33,73,.452,9,28,.321,24,45,.533,.514,8,10,.800,5,12,17,11,7,0,8,10,83,Malik Beasley
2017-18,DEN,SG,62,0,583,73,178,.410,28,82,.341,45,96,.469,.489,22,33,.667,14,57,71,31,15,7,24,36,196,Malik Beasley
2018-19,DEN,SG,81,18,1879,349,737,.474,163,405,.402,186,332,.560,.584,56,66,.848,35,165,200,97,55,10,55,116,917,Malik Beasley
2019-20,2TM,SG,55,14,1209,227,534,.425,107,276,.388,120,258,.465,.525,54,66,.818,18,130,148,75,40,8,57,77,615,Malik Beasley
2019-20,DEN,SG,41,0,746,117,301,.389,58,161,.360,59,140,.421,.485,33,38,.868,9,68,77,48,31,6,36,50,325,Malik Beasley
2019-20,MIN,SG,14,14,463,110,233,.472,49,115,.426,61,118,.517,.577,21,28,.750,9,62,71,27,9,2,21,27,290,Malik Beasley
2020-21,MIN,SG,37,36,1214,264,600,.440,128,321,.399,136,279,.487,.547,68,80,.850,28,134,162,88,30,7,60,62,724,Malik Beasley
2021-22,MIN,SG,79,18,1976,332,850,.391,240,637,.377,92,213,.432,.532,49,60,.817,26,201,227,116,43,12,43,88,953,Malik Beasley
2022-23,2TM,SG,81,27,2093,370,937,.395,235,658,.357,135,279,.484,.520,50,65,.769,35,248,283,124,65,9,90,107,1025,Malik Beasley
2022-23,UTA,SG,55,13,1472,265,669,.396,169,471,.359,96,198,.485,.522,37,44,.841,27,170,197,93,44,8,60,75,736,Malik Beasley
2022-23,LAL,SG,26,14,621,105,268,.392,66,187,.353,39,81,.481,.515,13,21,.619,8,78,86,31,21,1,30,32,289,Malik Beasley
2023-24,MIL,SG,79,77,2337,320,722,.443,224,542,.413,96,180,.533,.598,25,35,.714,41,249,290,108,59,9,54,158,889,Malik Beasley
2024-25,DET,SG,31,8,882,182,420,.433,122,290,.421,60,130,.462,.579,33,46,.717,17,78,95,59,25,2,32,40,519,Malik Beasley
2022-23,MIL,SF,52,11,701,96,243,.395,47,142,.331,49,101,.485,.492,27,37,.730,38,77,115,35,21,7,45,71,266,MarJon Beauchamp
2023-24,MIL,SF,48,1,608,81,166,.488,30,75,.400,51,91,.560,.578,19,28,.679,22,77,99,31,13,7,27,54,211,MarJon Beauchamp
2024-25,MIL,SF,14,0,53,9,22,.409,3,11,.273,6,11,.545,.477,5,6,.833,2,11,13,2,1,0,11,4,26,MarJon Beauchamp
2024-25,2TM,PG,6,0,23,1,4,.250,0,2,.000,1,2,.500,.250,0,0,1,0,1,2,1,0,2,3,2,0,Reece Beekman
2024-25,GSW,PG,2,0,4,1,1,1.000,0,0,,1,1,1.000,1.000,0,0,1,0,1,1,1,0,0,1,2,0,Reece Beekman
2024-25,BRK,PG,4,0,19,0,3,.000,0,2,.000,0,1,.000,.000,0,0,0,0,0,1,0,0,2,2,0,0,Reece Beekman
2017-18,GSW,C,57,13,809,116,185,.627,0,4,.000,116,181,.641,.627,30,44,.682,60,147,207,102,35,56,51,92,262,Jordan Bell
2018-19,GSW,C,68,3,788,99,192,.516,0,2,.000,99,190,.521,.516,25,41,.610,55,129,184,76,20,51,42,80,223,Jordan Bell
2019-20,2TM,C,29,0,256,35,67,.522,4,12,.333,31,55,.564,.552,19,31,.613,30,51,81,16,3,10,21,19,93,Jordan Bell
2019-20,MIN,C,27,0,235,32,60,.533,2,9,.222,30,51,.588,.550,17,29,.586,28,50,78,14,2,10,18,17,83,Jordan Bell
2019-20,MEM,C,2,0,21,3,7,.429,2,3,.667,1,4,.250,.571,2,2,1.000,2,1,3,2,1,0,3,2,10,Jordan Bell
2020-21,2TM,C,6,1,82,7,22,.318,0,2,.000,7,20,.350,.318,1,2,.500,7,17,24,7,3,5,4,7,15,Jordan Bell
2020-21,WAS,C,5,1,67,7,20,.350,0,2,.000,7,18,.389,.350,0,0,,6,13,19,5,3,3,3,5,14,Jordan Bell
2020-21,GSW,C,1,0,15,0,2,.000,0,0,,0,2,.000,.000,1,2,.500,1,4,5,2,0,2,1,2,1,Jordan Bell
2021-22,CHI,C,1,0,2,0,0,,0,0,,0,0,,,0,0,,1,0,1,0,1,0,0,2,0,Jordan Bell
2016-17,ATL,SF,38,1,371,47,98,.480,1,18,.056,46,80,.575,.485,6,16,.375,14,45,59,28,8,5,16,21,101,DeAndre' Bembry
2017-18,ATL,SF,26,3,455,53,128,.414,11,30,.367,42,98,.429,.457,19,33,.576,8,64,72,49,21,12,47,38,136,DeAndre' Bembry
2018-19,ATL,SG,82,15,1931,275,616,.446,50,173,.289,225,443,.508,.487,87,136,.640,54,304,358,202,105,41,142,190,687,DeAndre' Bembry
2019-20,ATL,SG,43,4,915,104,228,.456,15,65,.231,89,163,.546,.489,26,48,.542,34,118,152,81,55,19,60,84,249,DeAndre' Bembry
2020-21,TOR,SF,51,12,972,117,228,.513,14,53,.264,103,175,.589,.544,45,66,.682,33,113,146,107,53,18,71,87,293,DeAndre' Bembry
2021-22,2TM,SF,56,20,1026,124,221,.561,15,36,.417,109,185,.589,.595,21,35,.600,42,121,163,66,49,25,31,113,284,DeAndre' Bembry
2021-22,BRK,SF,48,20,949,121,213,.568,15,36,.417,106,177,.599,.603,21,35,.600,38,114,152,60,47,25,30,104,278,DeAndre' Bembry
2021-22,MIL,SF,8,0,77,3,8,.375,0,0,,3,8,.375,.375,0,0,,4,7,11,6,2,0,1,9,6,DeAndre' Bembry
2023-24,WAS,SG,19,0,149,29,64,.453,11,29,.379,18,35,.514,.539,5,9,.556,10,16,26,16,3,1,8,14,74,Jules Bernard
2016-17,SAS,PF,67,6,808,103,234,.440,69,173,.399,34,61,.557,.588,28,34,.824,22,76,98,46,20,28,32,75,303,Dāvis Bertāns
2017-18,SAS,PF,77,10,1086,161,366,.440,94,252,.373,67,114,.588,.568,40,49,.816,18,135,153,74,26,28,36,93,456,Dāvis Bertāns
2018-19,SAS,PF,76,12,1632,204,453,.450,145,338,.429,59,115,.513,.610,53,60,.883,23,241,264,100,35,33,43,133,606,Dāvis Bertāns
2019-20,WAS,PF,54,4,1583,265,610,.434,200,472,.424,65,138,.471,.598,104,122,.852,35,210,245,92,37,33,59,139,834,Dāvis Bertāns
2020-21,WAS,PF,57,7,1464,193,478,.404,169,428,.395,24,50,.480,.581,100,115,.870,18,150,168,49,33,13,33,136,655,Dāvis Bertāns
2021-22,2TM,PF,56,0,807,99,275,.360,77,230,.335,22,45,.489,.500,36,40,.900,12,105,117,31,17,12,19,85,311,Dāvis Bertāns
2021-22,WAS,PF,34,0,501,60,171,.351,46,144,.319,14,27,.519,.485,28,30,.933,6,55,61,16,11,6,14,55,194,Dāvis Bertāns
2021-22,DAL,PF,22,0,306,39,104,.375,31,86,.360,8,18,.444,.524,8,10,.800,6,50,56,15,6,6,5,30,117,Dāvis Bertāns
2022-23,DAL,PF,45,1,492,69,160,.431,55,141,.390,14,19,.737,.603,13,15,.867,10,43,53,21,11,8,10,53,206,Dāvis Bertāns
2023-24,2TM,PF,43,1,674,92,234,.393,76,200,.380,16,34,.471,.556,30,33,.909,9,52,61,35,26,12,18,56,290,Dāvis Bertāns
2023-24,OKC,PF,15,0,91,10,26,.385,10,24,.417,0,2,.000,.577,14,15,.933,2,8,10,9,3,3,1,10,44,Dāvis Bertāns
2023-24,CHO,PF,28,1,583,82,208,.394,66,176,.375,16,32,.500,.553,16,18,.889,7,44,51,26,23,9,17,46,246,Dāvis Bertāns
2012-13,HOU,PG,41,0,713,79,189,.418,36,96,.375,43,93,.462,.513,34,41,.829,45,64,109,117,37,21,44,83,228,Patrick Beverley
2013-14,HOU,PG,56,55,1751,199,481,.414,92,255,.361,107,226,.473,.509,83,102,.814,72,124,196,151,77,23,66,174,573,Patrick Beverley
2014-15,HOU,PG,56,55,1727,204,532,.383,115,323,.356,89,209,.426,.492,45,60,.750,67,170,237,192,59,23,83,182,568,Patrick Beverley
2015-16,HOU,PG,71,63,2041,258,594,.434,124,310,.400,134,284,.472,.539,60,88,.682,73,177,250,239,94,26,91,234,700,Patrick Beverley
2016-17,HOU,SG,67,67,2058,228,543,.420,110,288,.382,118,255,.463,.521,73,95,.768,95,298,393,281,99,25,100,222,639,Patrick Beverley
2017-18,LAC,SG,11,11,334,48,119,.403,24,60,.400,24,59,.407,.504,14,17,.824,16,29,45,32,19,5,25,34,134,Patrick Beverley
2018-19,LAC,PG,78,49,2137,194,477,.407,112,282,.397,82,195,.421,.524,96,123,.780,76,312,388,300,67,43,85,265,596,Patrick Beverley
2019-20,LAC,PG,51,50,1342,147,341,.431,80,206,.388,67,135,.496,.548,31,47,.660,57,209,266,183,54,25,66,156,405,Patrick Beverley
2020-21,LAC,PG,37,34,832,93,220,.423,56,141,.397,37,79,.468,.550,36,45,.800,29,90,119,76,29,28,34,108,278,Patrick Beverley
2021-22,MIN,PG,58,54,1476,177,436,.406,83,242,.343,94,194,.485,.501,96,133,.722,62,178,240,268,67,52,73,174,533,Patrick Beverley
2022-23,2TM,PG,67,67,1816,144,360,.400,80,239,.335,64,121,.529,.511,47,65,.723,44,203,247,194,63,41,60,187,415,Patrick Beverley
2022-23,LAL,SG,45,45,1211,97,241,.402,55,158,.348,42,83,.506,.517,39,50,.780,24,116,140,118,40,25,42,124,288,Patrick Beverley
2022-23,CHI,PG,22,22,605,47,119,.395,25,81,.309,22,38,.579,.500,8,15,.533,20,87,107,76,23,16,18,63,127,Patrick Beverley
2023-24,2TM,PG,73,13,1462,158,379,.417,61,181,.337,97,198,.490,.497,74,90,.822,49,190,239,212,43,31,65,128,451,Patrick Beverley
2023-24,PHI,PG,47,5,919,104,241,.432,35,109,.321,69,132,.523,.504,51,63,.810,30,115,145,144,24,18,49,83,294,Patrick Beverley
2023-24,MIL,PG,26,8,543,54,138,.391,26,72,.361,28,66,.424,.486,23,27,.852,19,75,94,68,19,13,16,45,157,Patrick Beverley
2020-21,DET,SF,70,53,1909,279,691,.404,175,460,.380,104,231,.450,.530,124,147,.844,43,275,318,95,52,14,60,110,857,Saddiq Bey
2021-22,DET,SF,82,82,2704,450,1136,.396,211,610,.346,239,526,.454,.489,210,254,.827,107,334,441,233,73,16,96,128,1321,Saddiq Bey
2022-23,2TM,SF,77,37,2129,353,836,.422,151,418,.361,202,418,.483,.513,205,238,.861,98,264,362,118,70,13,71,123,1062,Saddiq Bey
2022-23,DET,SF,52,30,1500,245,606,.404,101,293,.345,144,313,.460,.488,180,209,.861,59,183,242,84,50,12,54,86,771,Saddiq Bey
2022-23,ATL,SF,25,7,629,108,230,.470,50,125,.400,58,105,.552,.578,25,29,.862,39,81,120,34,20,1,17,37,291,Saddiq Bey
2023-24,ATL,SF,63,51,2062,290,697,.416,113,358,.316,177,339,.522,.497,170,203,.837,167,244,411,92,51,11,54,88,863,Saddiq Bey
2020-21,DAL,SF,18,0,71,7,22,.318,1,4,.250,6,18,.333,.341,3,5,.600,8,11,19,3,0,1,3,6,18,Tyler Bey
2017-18,ORL,C,42,0,578,68,126,.540,0,0,,68,126,.540,.540,42,61,.689,70,110,180,34,15,21,21,56,178,Khem Birch
2018-19,ORL,C,50,1,643,91,151,.603,0,1,.000,91,150,.607,.603,58,83,.699,79,111,190,38,18,29,20,72,240,Khem Birch
2019-20,ORL,C,48,24,922,73,143,.510,0,1,.000,73,142,.514,.510,66,101,.653,91,129,220,50,20,23,31,91,212,Khem Birch
2020-21,2TM,C,67,22,1529,189,380,.497,13,52,.250,176,328,.537,.514,91,129,.705,174,213,387,89,48,50,44,113,482,Khem Birch
2020-21,ORL,C,48,5,952,94,209,.450,4,21,.190,90,188,.479,.459,63,85,.741,117,126,243,53,32,28,23,67,255,Khem Birch
2020-21,TOR,C,19,17,577,95,171,.556,9,31,.290,86,140,.614,.582,28,44,.636,57,87,144,36,16,22,21,46,227,Khem Birch
2021-22,TOR,C,55,28,991,97,200,.485,0,14,.000,97,186,.522,.485,53,71,.746,122,117,239,56,30,26,29,104,247,Khem Birch
2022-23,TOR,C,20,0,162,19,32,.594,1,2,.500,18,30,.600,.609,4,5,.800,8,17,25,7,5,5,8,24,43,Khem Birch
2019-20,IND,C,54,2,471,70,150,.467,8,42,.190,62,108,.574,.493,24,33,.727,25,81,106,23,10,37,28,65,172,Goga Bitadze
2020-21,IND,C,45,3,561,83,194,.428,20,79,.253,63,115,.548,.479,45,61,.738,60,90,150,37,9,60,17,94,231,Goga Bitadze
2021-22,IND,C,50,16,729,131,252,.520,23,80,.288,108,172,.628,.565,64,94,.681,79,98,177,55,21,42,46,107,349,Goga Bitadze
2022-23,2TM,C,38,1,457,69,125,.552,6,26,.231,63,99,.636,.576,23,42,.548,61,76,137,39,16,26,22,64,167,Goga Bitadze
2022-23,IND,C,21,0,202,27,52,.519,4,14,.286,23,38,.605,.558,11,24,.458,25,24,49,18,9,10,12,34,69,Goga Bitadze
2022-23,ORL,C,17,1,255,42,73,.575,2,12,.167,40,61,.656,.589,12,18,.667,36,52,88,21,7,16,10,30,98,Goga Bitadze
2023-24,ORL,C,62,33,957,126,209,.603,2,14,.143,124,195,.636,.608,57,87,.655,109,177,286,79,32,72,44,107,311,Goga Bitadze
2024-25,ORL,C,28,25,684,114,176,.648,1,13,.077,113,163,.693,.651,40,53,.755,84,151,235,56,24,47,43,69,269,Goga Bitadze
2023-24,CHI,SG,23,1,268,32,84,.381,12,44,.273,20,40,.500,.452,4,5,.800,6,26,32,13,3,2,10,24,80,Onuralp Bitim
2011-12,CHA,C,63,41,1455,129,278,.464,0,0,,129,278,.464,.464,69,143,.483,113,255,368,27,20,115,71,145,327,Bismack Biyombo
2012-13,CHA,C,80,65,2186,156,346,.451,0,0,,156,346,.451,.451,74,142,.521,194,388,582,35,28,143,82,195,386,Bismack Biyombo
2013-14,CHA,C,77,9,1072,88,144,.611,0,0,,88,144,.611,.611,46,89,.517,105,261,366,8,7,86,40,124,222,Bismack Biyombo
2014-15,CHO,C,64,21,1243,101,186,.543,0,0,,101,186,.543,.543,102,175,.583,159,248,407,16,18,99,52,140,304,Bismack Biyombo
2015-16,TOR,C,82,22,1808,156,288,.542,0,1,.000,156,287,.544,.542,142,226,.628,182,473,655,29,19,133,71,225,454,Bismack Biyombo
2016-17,ORL,C,81,27,1793,179,339,.528,0,0,,179,339,.528,.528,125,234,.534,157,410,567,74,25,91,95,202,483,Bismack Biyombo
2017-18,ORL,C,82,25,1495,183,352,.520,0,1,.000,183,351,.521,.520,102,157,.650,144,324,468,66,21,95,84,158,468,Bismack Biyombo
2018-19,CHO,C,54,32,783,89,156,.571,0,0,,89,156,.571,.571,58,91,.637,81,166,247,33,11,41,34,103,236,Bismack Biyombo
2019-20,CHO,C,53,29,1029,151,278,.543,0,0,,151,278,.543,.543,91,151,.603,120,188,308,50,10,49,48,116,393,Bismack Biyombo
2020-21,CHO,C,66,36,1349,142,242,.587,0,1,.000,142,241,.589,.587,47,105,.448,137,210,347,81,17,74,71,141,331,Bismack Biyombo
2021-22,PHO,C,36,3,506,86,145,.593,0,0,,86,145,.593,.593,38,71,.535,63,104,167,23,12,26,25,70,210,Bismack Biyombo
2022-23,PHO,C,61,14,874,119,206,.578,0,0,,119,206,.578,.578,25,70,.357,89,171,260,56,18,88,51,114,263,Bismack Biyombo
2023-24,2TM,C,40,27,791,74,131,.565,0,0,,74,131,.565,.565,26,54,.481,62,147,209,53,11,37,42,89,174,Bismack Biyombo
2023-24,MEM,C,30,27,718,67,119,.563,0,0,,67,119,.563,.563,22,46,.478,57,134,191,51,10,34,38,82,156,Bismack Biyombo
2023-24,OKC,C,10,0,73,7,12,.583,0,0,,7,12,.583,.583,4,8,.500,5,13,18,2,1,3,4,7,18,Bismack Biyombo
2023-24,ORL,PG,69,33,1164,115,247,.466,37,94,.394,78,153,.510,.540,49,80,.613,33,106,139,91,35,21,56,110,316,Anthony Black
2024-25,ORL,PG,33,3,791,98,238,.412,21,79,.266,77,159,.484,.456,64,85,.753,19,70,89,117,30,22,73,75,281,Anthony Black
2023-24,CHO,SF,26,3,284,25,52,.481,9,20,.450,16,32,.500,.567,10,15,.667,9,39,48,24,8,11,6,19,69,Leaky Black
2022-23,DET,SF,10,0,90,5,27,.185,4,25,.160,1,2,.500,.259,2,2,1.000,2,4,6,4,2,0,0,6,16,Buddy Boeheim
2023-24,DET,SF,10,0,84,9,29,.310,8,25,.320,1,4,.250,.448,8,10,.800,3,7,10,3,0,1,0,5,34,Buddy Boeheim
2017-18,SAC,SG,78,52,2175,344,772,.446,129,329,.392,215,443,.485,.529,100,119,.840,31,192,223,258,72,16,125,172,917,Bogdan Bogdanović
2018-19,SAC,SG,70,17,1947,361,863,.418,134,372,.360,227,491,.462,.496,134,162,.827,40,203,243,267,72,15,117,142,990,Bogdan Bogdanović
2019-20,SAC,SG,61,28,1766,337,766,.440,164,441,.372,173,325,.532,.547,86,116,.741,26,181,207,207,64,15,102,133,924,Bogdan Bogdanović
2020-21,ATL,SG,44,27,1305,267,565,.473,146,333,.438,121,232,.522,.602,40,44,.909,20,140,160,147,49,13,54,99,720,Bogdan Bogdanović
2021-22,ATL,SG,63,27,1848,342,794,.431,169,459,.368,173,335,.516,.537,97,115,.843,29,221,250,194,68,14,70,132,950,Bogdan Bogdanović
2022-23,ATL,SG,54,9,1508,273,611,.447,146,360,.406,127,251,.506,.566,64,77,.831,23,142,165,150,43,18,65,86,756,Bogdan Bogdanović
2023-24,ATL,SG,79,33,2401,471,1100,.428,240,641,.374,231,459,.503,.537,151,164,.921,53,219,272,247,96,26,112,179,1333,Bogdan Bogdanović
2024-25,ATL,SG,14,0,356,54,133,.406,30,89,.337,24,44,.545,.519,20,21,.952,9,35,44,31,12,4,25,36,158,Bogdan Bogdanović
2014-15,BRK,SF,78,28,1854,261,576,.453,91,256,.355,170,320,.531,.532,87,106,.821,50,163,213,68,34,9,78,104,700,Bojan Bogdanović
2015-16,BRK,SF,79,39,2115,324,749,.433,129,338,.382,195,411,.474,.519,110,132,.833,36,219,255,99,29,5,115,119,887,Bojan Bogdanović
2016-17,2TM,SF,81,54,2083,376,845,.445,144,392,.367,232,453,.512,.530,217,243,.893,37,240,277,111,34,7,131,146,1113,Bojan Bogdanović
2016-17,BRK,SF,55,54,1482,269,611,.440,99,277,.357,170,334,.509,.521,146,167,.874,23,174,197,90,24,3,93,99,783,Bojan Bogdanović
2016-17,WAS,SF,26,0,601,107,234,.457,45,115,.391,62,119,.521,.553,71,76,.934,14,66,80,21,10,4,38,47,330,Bojan Bogdanović
2017-18,IND,SF,80,80,2464,404,852,.474,155,386,.402,249,466,.534,.565,178,205,.868,30,240,270,119,55,8,106,129,1141,Bojan Bogdanović
2018-19,IND,SF,81,81,2573,522,1051,.497,164,386,.425,358,665,.538,.575,246,305,.807,33,300,333,161,69,1,134,138,1454,Bojan Bogdanović
2019-20,UTA,SF,63,63,2083,418,935,.447,189,457,.414,229,478,.479,.548,250,277,.903,39,220,259,131,34,7,159,110,1275,Bojan Bogdanović
2020-21,UTA,SF,72,72,2216,406,925,.439,180,461,.390,226,464,.487,.536,233,265,.879,40,241,281,136,45,4,128,115,1225,Bojan Bogdanović
2021-22,UTA,PF,69,69,2131,422,928,.455,181,468,.387,241,460,.524,.552,223,260,.858,58,238,296,120,34,1,118,116,1248,Bojan Bogdanović
2022-23,DET,PF,59,59,1893,430,882,.488,145,353,.411,285,529,.539,.570,268,303,.884,36,187,223,152,34,8,135,113,1273,Bojan Bogdanović
2023-24,2TM,PF,57,27,1478,309,681,.454,133,334,.398,176,347,.507,.551,117,149,.785,22,130,152,97,30,5,101,95,868,Bojan Bogdanović
2023-24,DET,PF,28,27,921,199,425,.468,86,207,.415,113,218,.518,.569,81,104,.779,13,81,94,71,23,4,63,57,565,Bojan Bogdanović
2023-24,NYK,SF,29,0,557,110,256,.430,47,127,.370,63,129,.488,.521,36,45,.800,9,49,58,26,7,1,38,38,303,Bojan Bogdanović
2019-20,DEN,PF,7,0,87,14,28,.500,4,9,.444,10,19,.526,.571,8,10,.800,5,14,19,6,2,6,10,11,40,Bol Bol
2020-21,DEN,PF,32,2,160,25,58,.431,9,24,.375,16,34,.471,.509,10,15,.667,0,24,24,7,3,10,13,14,69,Bol Bol
2021-22,DEN,PF,14,0,81,15,27,.556,1,4,.250,14,23,.609,.574,2,5,.400,4,16,20,5,1,2,4,4,33,Bol Bol
2022-23,ORL,PF,70,33,1505,261,478,.546,30,113,.265,231,365,.633,.577,82,108,.759,69,336,405,69,30,85,112,92,634,Bol Bol
2023-24,PHO,PF,43,0,469,93,151,.616,22,52,.423,71,99,.717,.689,15,19,.789,32,105,137,17,10,25,19,42,223,Bol Bol
2024-25,PHO,PF,7,0,37,9,15,.600,1,5,.200,8,10,.800,.633,4,6,.667,4,7,11,1,0,0,3,1,23,Bol Bol
2019-20,CLE,C,1,0,3,0,0,,0,0,,0,0,,,0,0,,0,2,2,0,1,0,0,1,0,Marques Bolden
2020-21,CLE,C,6,0,29,1,3,.333,0,0,,1,3,.333,.333,5,8,.625,3,3,6,0,2,2,2,0,7,Marques Bolden
2023-24,2TM,C,11,2,121,17,25,.680,0,1,.000,17,24,.708,.680,3,4,.750,10,24,34,4,3,7,3,10,37,Marques Bolden
2023-24,MIL,C,2,0,3,0,0,,0,0,,0,0,,,0,0,,0,2,2,0,0,0,0,1,0,Marques Bolden
2023-24,CHO,C,9,2,118,17,25,.680,0,1,.000,17,24,.708,.680,3,4,.750,10,22,32,4,3,7,3,9,37,Marques Bolden
2021-22,MIN,SF,35,2,241,17,54,.315,5,18,.278,12,36,.333,.361,11,13,.846,16,27,43,21,6,0,13,26,50,Leandro Bolmaro
2022-23,UTA,SF,14,0,68,3,20,.150,0,4,.000,3,16,.188,.150,0,0,,4,3,7,7,3,1,7,10,6,Leandro Bolmaro
2024-25,PHI,C,15,0,102,9,14,.643,0,0,9,14,.643,.643,6,7,.857,9,18,27,1,0,6,6,16,24,0,Adem Bona
2019-20,DET,PG,10,0,53,5,20,.250,2,10,.200,3,10,.300,.300,0,0,0,4,4,8,1,0,2,6,12,0,Jordan Bone
2020-21,ORL,PG,14,0,196,23,54,.426,10,32,.313,13,22,.591,.519,0,0,4,20,24,18,2,0,3,11,56,0,Jordan Bone
2015-16,PHO,SG,76,51,2108,367,867,.423,99,289,.343,268,578,.464,.480,215,256,.840,27,160,187,200,44,20,160,225,1048,Devin Booker
2016-17,PHO,SG,78,78,2730,606,1431,.423,147,405,.363,459,1026,.447,.475,367,441,.832,46,203,249,268,72,21,241,242,1726,Devin Booker
2017-18,PHO,SG,54,54,1865,455,1054,.432,147,384,.383,308,670,.460,.501,289,329,.878,26,218,244,253,47,14,194,168,1346,Devin Booker
2018-19,PHO,SG,64,64,2242,586,1255,.467,135,414,.326,451,841,.536,.521,393,454,.866,39,226,265,433,56,13,264,200,1700,Devin Booker
2019-20,PHO,SG,70,70,2512,627,1283,.489,141,398,.354,486,885,.549,.544,468,509,.919,29,268,297,456,49,18,264,213,1863,Devin Booker
2020-21,PHO,SG,67,67,2270,623,1287,.484,126,371,.340,497,916,.543,.533,340,392,.867,34,247,281,289,53,16,207,181,1712,Devin Booker
2021-22,PHO,SG,68,68,2345,662,1421,.466,183,478,.383,479,943,.508,.530,315,363,.868,45,297,342,329,77,26,162,180,1822,Devin Booker
2022-23,PHO,SG,53,53,1835,527,1067,.494,111,316,.351,416,751,.554,.546,306,358,.855,46,194,240,293,51,18,145,159,1471,Devin Booker
2023-24,PHO,PG,68,68,2447,642,1305,.492,152,418,.364,490,887,.552,.550,405,457,.886,56,252,308,472,61,28,178,206,1841,Devin Booker
2024-25,PHO,SG,26,26,951,207,472,.439,69,200,.345,138,272,.507,.512,169,188,.899,30,65,95,166,29,9,59,57,652,Devin Booker
2021-22,LAC,SG,51,0,760,125,325,.385,34,111,.306,91,214,.425,.437,59,72,.819,17,94,111,51,26,13,31,43,343,Brandon Boston Jr.
2022-23,LAC,SF,22,1,248,51,122,.418,12,29,.414,39,93,.419,.467,29,38,.763,7,23,30,20,9,0,12,21,143,Brandon Boston Jr.
2023-24,LAC,SF,32,0,345,65,161,.404,14,52,.269,51,109,.468,.447,23,33,.697,19,33,52,13,11,8,24,40,167,Brandon Boston Jr.
2024-25,NOP,SG,29,10,748,128,289,.443,37,106,.349,91,183,.497,.507,49,61,.803,18,81,99,82,43,7,42,51,342,Brandon Boston Jr.
2017-18,GSW,PF,1,0,1,0,1,.000,0,1,.000,0,0,,.000,0,0,,0,1,1,0,0,0,0,0,0,Chris Boucher
2018-19,TOR,PF,28,0,163,34,76,.447,12,37,.324,22,39,.564,.526,13,15,.867,16,40,56,2,6,24,7,31,93,Chris Boucher
2019-20,TOR,C,62,0,819,141,299,.472,38,118,.322,103,181,.569,.535,91,116,.784,107,170,277,26,22,61,28,114,411,Chris Boucher
2020-21,TOR,C,60,14,1453,288,560,.514,90,235,.383,198,325,.609,.595,152,193,.788,117,287,404,63,35,111,46,166,818,Chris Boucher
2021-22,TOR,SF,80,9,1690,268,577,.464,68,229,.297,200,348,.575,.523,150,193,.777,179,315,494,25,49,75,42,174,754,Chris Boucher
2022-23,TOR,PF,76,0,1523,261,529,.493,62,189,.328,199,340,.585,.552,128,168,.762,157,264,421,29,47,64,41,143,712,Chris Boucher
2023-24,TOR,PF,50,0,705,110,217,.507,31,94,.330,79,123,.642,.578,71,92,.772,62,145,207,23,14,24,28,68,322,Chris Boucher
2024-25,TOR,PF,28,0,512,105,225,.467,33,109,.303,72,116,.621,.540,46,60,.767,40,85,125,20,17,20,21,41,289,Chris Boucher
2021-22,CHO,SG,31,0,304,49,141,.348,17,49,.347,32,92,.348,.408,27,31,.871,22,30,52,26,7,1,15,29,142,James Bouknight
2022-23,CHO,SG,34,0,515,69,193,.358,33,109,.303,36,84,.429,.443,20,30,.667,8,64,72,41,14,5,32,49,191,James Bouknight
2023-24,CHO,SG,14,0,81,18,41,.439,13,30,.433,5,11,.455,.598,1,2,.500,1,8,9,6,1,1,2,3,50,James Bouknight
2022-23,2TM,PG,5,0,71,6,14,.429,2,6,.333,4,8,.500,.500,1,2,.500,1,5,6,4,4,2,4,6,15,Jamaree Bouyea
2022-23,MIA,PG,4,0,65,6,13,.462,2,5,.400,4,8,.500,.538,1,2,.500,1,4,5,4,4,2,4,5,15,Jamaree Bouyea
2022-23,WAS,PG,1,0,6,0,1,.000,0,1,.000,0,0,,.000,0,0,,0,1,1,0,0,0,0,1,0,Jamaree Bouyea
2023-24,2TM,PG,9,0,95,10,28,.357,1,9,.111,9,19,.474,.375,0,0,,3,16,19,11,1,0,9,10,21,Jamaree Bouyea
2023-24,POR,PG,6,0,57,5,21,.238,0,8,.000,5,13,.385,.238,0,0,,2,8,10,8,0,0,8,3,10,Jamaree Bouyea
2023-24,SAS,PG,3,0,38,5,7,.714,1,1,1.000,4,6,.667,.786,0,0,,1,8,9,3,1,0,1,7,11,Jamaree Bouyea
2019-20,GSW,PG,45,12,1015,134,321,.417,33,107,.308,101,214,.472,.469,34,41,.829,24,97,121,131,44,10,70,102,335,Ky Bowman
2017-18,UTA,C,9,0,29,3,11,.273,0,1,.000,3,10,.300,.273,2,2,1.000,4,7,11,1,0,0,0,1,8,Tony Bradley
2018-19,UTA,C,3,0,36,8,16,.500,0,0,,8,16,.500,.500,1,2,.500,9,6,15,1,2,2,3,6,17,Tony Bradley
2019-20,UTA,C,58,3,663,126,189,.667,3,3,1.000,123,186,.661,.675,30,46,.652,111,156,267,23,14,33,30,115,285,Tony Bradley
2020-21,2TM,C,42,8,684,131,197,.665,0,3,.000,131,194,.675,.665,38,55,.691,85,154,239,37,15,30,33,61,300,Tony Bradley
2020-21,PHI,C,20,8,287,51,75,.680,0,1,.000,51,74,.689,.680,7,11,.636,39,65,104,17,6,13,6,28,109,Tony Bradley
2020-21,OKC,C,22,0,397,80,122,.656,0,2,.000,80,120,.667,.656,31,44,.705,46,89,135,20,9,17,27,33,191,Tony Bradley
2021-22,CHI,C,55,7,549,72,123,.585,0,0,,72,123,.585,.585,19,29,.655,67,119,186,27,10,33,34,62,163,Tony Bradley
2022-23,CHI,C,12,0,33,6,12,.500,3,5,.600,3,7,.429,.625,4,4,1.000,1,10,11,1,1,1,1,2,19,Tony Bradley
2022-23,SAS,SG,66,32,1550,269,611,.440,77,255,.302,192,356,.539,.503,58,70,.829,28,153,181,127,33,7,76,115,673,Malaki Branham
2023-24,SAS,PG,75,29,1594,271,628,.432,93,268,.347,178,360,.494,.506,55,63,.873,28,120,148,156,27,8,91,94,690,Malaki Branham
2024-25,SAS,SG,21,0,254,44,101,.436,17,44,.386,27,57,.474,.520,17,20,.850,3,27,30,26,7,2,26,14,122,Malaki Branham
2019-20,UTA,PF,9,0,96,10,28,.357,3,13,.231,7,15,.467,.411,1,2,.500,2,18,20,11,3,5,7,7,24,Jarrell Brantley
2020-21,UTA,PF,28,0,138,25,52,.481,12,28,.429,13,24,.542,.596,2,2,1.000,9,18,27,15,7,2,8,17,64,Jarrell Brantley
2022-23,UTA,PF,4,0,39,8,14,.571,4,9,.444,4,5,.800,.714,2,2,1.000,1,5,6,3,0,2,2,3,22,Jarrell Brantley
2022-23,DEN,SG,76,6,1181,143,289,.495,34,96,.354,109,193,.565,.554,40,64,.625,48,133,181,59,41,17,35,101,360,Christian Braun
2023-24,DEN,SG,82,4,1655,222,483,.460,63,164,.384,159,319,.498,.525,93,134,.694,79,227,306,132,42,35,55,137,600,Christian Braun
2024-25,DEN,SG,28,28,946,151,274,.551,28,74,.378,123,200,.615,.602,64,82,.780,35,103,138,56,34,16,36,62,394,Christian Braun
2019-20,NYK,SF,9,0,53,6,22,.273,1,9,.111,5,13,.385,.295,4,5,.800,2,3,5,4,0,1,2,3,17,Ignas Brazdeikis
2020-21,3TM,SF,13,0,249,35,83,.422,11,28,.393,24,55,.436,.488,10,14,.714,11,34,45,17,4,3,12,22,91,Ignas Brazdeikis
2020-21,NYK,SF,4,0,7,0,1,.000,0,0,,0,1,.000,.000,2,2,1.000,1,1,2,1,0,0,1,0,2,Ignas Brazdeikis
2020-21,PHI,SF,1,0,8,0,3,.000,0,1,.000,0,2,.000,.000,0,0,,0,2,2,0,0,0,0,0,0,Ignas Brazdeikis
2020-21,ORL,SF,8,0,234,35,79,.443,11,27,.407,24,52,.462,.513,8,12,.667,10,31,41,16,4,3,11,22,89,Ignas Brazdeikis
2021-22,ORL,SF,42,1,536,81,188,.431,27,87,.310,54,101,.535,.503,21,32,.656,23,49,72,37,10,3,17,48,210,Ignas Brazdeikis
2024-25,PHO,SF,4,0,17,0,3,.000,0,3,.000,0,0,.000,1,2,.500,0,3,3,0,0,0,2,0,1,0,Jalen Bridges
2018-19,PHO,SF,82,56,2417,242,563,.430,105,313,.335,137,250,.548,.523,95,118,.805,56,208,264,173,129,38,70,201,684,Mikal Bridges
2019-20,PHO,SF,73,32,2042,247,484,.510,70,194,.361,177,290,.610,.583,103,122,.844,66,226,292,129,102,46,73,163,667,Mikal Bridges
2020-21,PHO,SF,72,72,2348,363,669,.543,134,315,.425,229,354,.647,.643,110,131,.840,76,233,309,152,76,63,57,116,970,Mikal Bridges
2021-22,PHO,SF,82,82,2854,458,858,.534,115,312,.369,343,546,.628,.601,131,157,.834,74,273,347,185,96,36,68,150,1162,Mikal Bridges
2022-23,2TM,SG,83,83,2963,593,1267,.468,169,442,.382,424,825,.514,.535,316,353,.895,79,285,364,273,91,61,127,159,1671,Mikal Bridges
2022-23,PHO,SF,56,56,2040,354,764,.463,101,261,.387,253,503,.503,.529,156,174,.897,56,187,243,201,65,45,78,115,965,Mikal Bridges
2022-23,BRK,SG,27,27,923,239,503,.475,68,181,.376,171,322,.531,.543,160,179,.894,23,98,121,72,26,16,49,44,706,Mikal Bridges
2023-24,BRK,SF,82,82,2854,564,1294,.436,220,592,.372,344,702,.490,.521,258,317,.814,68,304,372,299,81,30,164,116,1606,Mikal Bridges
2024-25,NYK,SF,31,31,1207,231,460,.502,76,206,.369,155,254,.610,.585,23,33,.697,27,74,101,103,35,16,49,41,561,Mikal Bridges
2018-19,CHO,SF,80,25,1696,237,511,.464,65,200,.325,172,311,.553,.527,58,77,.753,67,256,323,95,55,49,50,111,597,Miles Bridges
2019-20,CHO,SF,65,64,1995,319,753,.424,99,300,.330,220,453,.486,.489,106,131,.809,88,274,362,114,40,48,95,132,843,Miles Bridges
2020-21,CHO,PF,66,19,1932,313,622,.503,116,290,.400,197,332,.593,.596,98,113,.867,81,316,397,147,44,52,106,143,840,Miles Bridges
2021-22,CHO,PF,80,80,2837,596,1214,.491,154,465,.331,442,749,.590,.554,267,333,.802,90,469,559,300,74,67,150,193,1613,Miles Bridges
2023-24,CHO,SF,69,67,2581,559,1210,.462,157,450,.349,402,760,.529,.527,174,211,.825,71,434,505,231,65,33,138,118,1449,Miles Bridges
2024-25,CHO,PF,17,17,507,105,244,.430,33,109,.303,72,135,.533,.498,48,55,.873,15,109,124,54,10,10,29,22,291,Miles Bridges
2020-21,IND,C,5,0,29,5,8,.625,0,0,5,8,.625,.625,3,3,1.000,2,6,8,1,0,5,4,4,13,0,Amida Brimah
2019-20,TOR,SF,19,0,135,13,36,.361,3,15,.200,10,21,.476,.403,8,10,.800,9,17,26,7,4,1,7,18,37,Oshae Brissett
2020-21,IND,SF,21,16,519,73,151,.483,33,78,.423,40,73,.548,.593,50,65,.769,29,86,115,18,19,20,10,32,229,Oshae Brissett
2021-22,IND,SF,67,25,1564,208,506,.411,83,237,.350,125,269,.465,.493,114,164,.695,108,250,358,72,44,29,54,116,613,Oshae Brissett
2022-23,IND,PF,65,2,1083,123,319,.386,48,155,.310,75,164,.457,.461,104,145,.717,62,156,218,44,33,13,34,79,398,Oshae Brissett
2023-24,BOS,SF,55,1,630,68,153,.444,15,55,.273,53,98,.541,.493,50,83,.602,61,99,160,44,19,8,20,54,201,Oshae Brissett
2023-24,NOP,PG,1,0,3,2,5,.400,0,1,.000,2,4,.500,.400,0,0,1,1,2,0,0,0,0,0,4,0,Izaiah Brockington
2016-17,MIL,SG,75,28,1982,290,635,.457,78,193,.404,212,442,.480,.518,109,126,.865,47,166,213,317,84,12,113,140,767,Malcolm Brogdon
2017-18,MIL,PG,48,20,1436,244,503,.485,62,161,.385,182,342,.532,.547,75,85,.882,23,133,156,152,41,13,66,128,625,Malcolm Brogdon
2018-19,MIL,SG,64,64,1832,378,748,.505,104,244,.426,274,504,.544,.575,141,152,.928,65,223,288,205,46,13,91,102,1001,Malcolm Brogdon
2019-20,IND,PG,54,54,1666,326,744,.438,75,230,.326,251,514,.488,.489,166,186,.892,46,216,262,381,35,10,131,98,893,Malcolm Brogdon
2020-21,IND,PG,56,56,1930,444,980,.453,145,374,.388,299,606,.493,.527,153,177,.864,58,236,294,329,49,15,115,110,1186,Malcolm Brogdon
2021-22,IND,PG,36,36,1206,243,543,.448,58,186,.312,185,357,.518,.501,143,167,.856,33,152,185,212,30,14,77,71,687,Malcolm Brogdon
2022-23,BOS,PG,67,0,1744,354,732,.484,132,297,.444,222,435,.510,.574,160,184,.870,42,238,280,248,45,18,98,109,1000,Malcolm Brogdon
2023-24,POR,PG,39,25,1121,218,496,.440,82,199,.412,136,297,.458,.522,95,116,.819,28,120,148,214,27,8,60,58,613,Malcolm Brogdon
2024-25,WAS,PG,13,10,321,64,139,.460,11,33,.333,53,106,.500,.500,38,45,.844,12,42,54,43,7,4,21,22,177,Malcolm Brogdon
2020-21,HOU,SG,20,5,520,78,192,.406,60,157,.382,18,35,.514,.563,7,12,.583,10,58,68,30,12,5,22,34,223,Armoni Brooks
2021-22,2TM,SG,54,11,844,98,289,.339,74,249,.297,24,40,.600,.467,18,21,.857,20,83,103,62,28,11,27,74,288,Armoni Brooks
2021-22,HOU,SG,41,8,690,87,251,.347,64,213,.300,23,38,.605,.474,16,19,.842,12,69,81,49,21,8,23,60,254,Armoni Brooks
2021-22,TOR,PG,13,3,154,11,38,.289,10,36,.278,1,2,.500,.421,2,2,1.000,8,14,22,13,7,3,4,14,34,Armoni Brooks
2023-24,BRK,PG,10,0,104,15,46,.326,11,32,.344,4,14,.286,.446,1,2,.500,7,11,18,5,1,1,3,3,42,Armoni Brooks
2017-18,MEM,SF,82,74,2350,340,772,.440,94,264,.356,246,508,.484,.501,124,166,.747,49,208,257,135,73,17,124,233,898,Dillon Brooks
2018-19,MEM,SF,18,0,330,49,122,.402,15,40,.375,34,82,.415,.463,22,30,.733,9,22,31,16,10,4,19,50,135,Dillon Brooks
2019-20,MEM,SG,73,73,2112,435,1068,.407,147,411,.358,288,657,.438,.476,164,203,.808,68,175,243,150,63,27,124,278,1181,Dillon Brooks
2020-21,MEM,SF,67,67,1997,432,1031,.419,128,372,.344,304,659,.461,.481,159,195,.815,53,143,196,157,78,26,119,237,1151,Dillon Brooks
2021-22,MEM,SF,32,31,885,227,526,.432,46,149,.309,181,377,.480,.475,90,106,.849,29,73,102,88,36,8,50,105,590,Dillon Brooks
2022-23,MEM,SF,73,73,2214,392,991,.396,143,439,.326,249,552,.451,.468,120,154,.779,45,199,244,189,65,16,104,240,1047,Dillon Brooks
2023-24,HOU,SF,72,72,2227,329,768,.428,133,370,.359,196,398,.492,.515,124,147,.844,53,193,246,119,64,10,88,241,915,Dillon Brooks
2024-25,HOU,SF,28,28,886,138,321,.430,63,164,.384,75,157,.478,.528,43,50,.860,36,75,111,45,20,8,32,95,382,Dillon Brooks
2018-19,DET,SG,74,56,1449,125,314,.398,24,93,.258,101,221,.457,.436,45,60,.750,48,137,185,91,40,36,46,178,319,Bruce Brown
2019-20,DET,PG,58,43,1634,198,447,.443,33,96,.344,165,351,.470,.480,88,119,.739,61,213,274,230,63,29,100,162,517,Bruce Brown
2020-21,BRK,PG,65,37,1451,235,423,.556,17,59,.288,218,364,.599,.576,86,117,.735,111,238,349,104,58,28,54,145,573,Bruce Brown
2021-22,BRK,SF,72,45,1774,256,506,.506,38,94,.404,218,412,.529,.543,97,128,.758,100,245,345,148,77,52,56,176,647,Bruce Brown
2022-23,DEN,SF,80,31,2280,358,741,.483,91,254,.358,267,487,.548,.545,116,153,.758,63,265,328,268,87,51,123,190,923,Bruce Brown
2023-24,2TM,SG,67,44,1866,278,582,.478,53,164,.323,225,418,.538,.523,117,142,.824,53,231,284,192,59,17,86,148,726,Bruce Brown
2023-24,IND,SG,33,33,981,149,314,.475,33,101,.327,116,213,.545,.527,67,82,.817,25,129,154,100,35,8,41,81,398,Bruce Brown
2023-24,TOR,PG,34,11,885,129,268,.481,20,63,.317,109,205,.532,.519,50,60,.833,28,102,130,92,24,9,45,67,328,Bruce Brown
2019-20,ATL,SG,10,0,40,6,19,.316,3,9,.333,3,10,.300,.395,5,5,1.000,2,2,4,2,2,2,3,3,20,Charlie Brown Jr.
2020-21,OKC,SG,9,1,152,13,43,.302,5,21,.238,8,22,.364,.360,9,10,.900,3,14,17,9,4,2,6,19,40,Charlie Brown Jr.
2021-22,2TM,SG,22,2,177,10,39,.256,1,12,.083,9,27,.333,.269,9,10,.900,14,18,32,6,10,4,5,18,30,Charlie Brown Jr.
2021-22,DAL,SG,3,0,15,1,5,.200,0,3,.000,1,2,.500,.200,0,0,,0,1,1,1,2,1,0,2,2,Charlie Brown Jr.
2021-22,PHI,SG,19,2,162,9,34,.265,1,9,.111,8,25,.320,.279,9,10,.900,14,17,31,5,8,3,5,16,28,Charlie Brown Jr.
2023-24,NYK,SG,8,0,37,2,10,.200,2,7,.286,0,3,.000,.300,0,0,,1,1,2,0,0,2,2,5,6,Charlie Brown Jr.
2021-22,2TM,SG,5,2,104,10,32,.313,6,18,.333,4,14,.286,.406,5,6,.833,1,15,16,4,2,0,1,7,31,Chaundee Brown Jr.
2021-22,LAL,SF,2,0,21,1,7,.143,0,3,.000,1,4,.250,.143,0,0,,0,2,2,0,0,0,1,0,2,Chaundee Brown Jr.
2021-22,ATL,SG,3,2,83,9,25,.360,6,15,.400,3,10,.300,.480,5,6,.833,1,13,14,4,2,0,0,7,29,Chaundee Brown Jr.
2021-22,POR,SF,48,6,640,81,190,.426,19,61,.311,62,129,.481,.476,44,65,.677,38,97,135,35,26,24,36,90,225,Greg Brown III
2022-23,POR,PF,16,0,93,11,28,.393,1,7,.143,10,21,.476,.411,5,12,.417,2,17,19,3,4,5,6,13,28,Greg Brown III
2023-24,DAL,PF,6,0,40,5,11,.455,1,3,.333,4,8,.500,.500,4,9,.444,3,6,9,4,0,4,4,5,15,Greg Brown III
2016-17,BOS,SF,78,20,1341,192,423,.454,46,135,.341,146,288,.507,.508,85,124,.685,45,175,220,64,35,18,68,142,515,Jaylen Brown
2017-18,BOS,SG,70,70,2152,373,803,.465,121,306,.395,252,497,.507,.540,150,233,.644,66,280,346,114,70,26,124,181,1017,Jaylen Brown
2018-19,BOS,SG,74,25,1913,368,792,.465,95,276,.344,273,516,.529,.525,133,202,.658,65,248,313,100,69,32,99,186,964,Jaylen Brown
2019-20,BOS,SG,57,57,1934,427,887,.481,129,338,.382,298,549,.543,.554,176,243,.724,62,302,364,118,65,20,125,167,1159,Jaylen Brown
2020-21,BOS,SG,58,58,1999,538,1111,.484,163,411,.397,375,700,.536,.558,191,250,.764,71,276,347,195,72,32,158,168,1430,Jaylen Brown
2021-22,BOS,SF,66,66,2220,576,1217,.473,166,464,.358,410,753,.544,.541,241,318,.758,53,351,404,231,70,18,178,163,1559,Jaylen Brown
2022-23,BOS,SF,67,67,2405,679,1383,.491,163,487,.335,516,896,.576,.550,263,344,.765,78,381,459,232,75,26,197,172,1784,Jaylen Brown
2023-24,BOS,SF,70,70,2343,627,1256,.499,145,410,.354,482,846,.570,.557,211,300,.703,84,303,387,249,83,37,166,185,1610,Jaylen Brown
2024-25,BOS,SF,26,26,928,232,510,.455,63,188,.335,169,322,.525,.517,113,153,.739,38,117,155,120,36,8,72,62,640,Jaylen Brown
2022-23,IND,SG,6,0,40,4,7,.571,0,1,.000,4,6,.667,.571,1,2,.500,2,4,6,3,4,0,2,9,9,Kendall Brown
2023-24,IND,SG,15,0,63,8,15,.533,0,2,.000,8,13,.615,.533,5,8,.625,3,2,5,5,0,0,2,9,21,Kendall Brown
2023-24,LAC,PF,44,0,394,37,90,.411,14,48,.292,23,42,.548,.489,1,2,.500,20,42,62,25,12,6,9,49,89,Kobe Brown
2024-25,LAC,PF,7,0,47,9,20,.450,1,6,.167,8,14,.571,.475,1,2,.500,5,11,16,4,1,0,0,5,20,Kobe Brown
2019-20,POR,C,9,0,33,4,10,.400,0,0,4,10,.400,.400,3,8,.375,3,11,14,1,1,1,3,7,11,0,Moses Brown
2020-21,OKC,C,43,32,920,146,268,.545,0,0,146,268,.545,.545,78,126,.619,154,229,383,10,31,47,43,93,370,0,Moses Brown
2021-22,2TM,C,40,6,345,64,108,.593,0,0,64,108,.593,.593,43,72,.597,39,96,135,1,7,16,20,53,171,0,Moses Brown
2021-22,DAL,C,26,1,169,27,50,.540,0,0,27,50,.540,.540,27,43,.628,16,45,61,1,3,9,14,28,81,0,Moses Brown
2021-22,CLE,C,14,5,176,37,58,.638,0,0,37,58,.638,.638,16,29,.552,23,51,74,0,4,7,6,25,90,0,Moses Brown
2022-23,2TM,C,36,1,294,61,96,.635,0,0,61,96,.635,.635,33,72,.458,57,82,139,4,4,14,15,39,155,0,Moses Brown
2022-23,LAC,C,34,1,288,61,96,.635,0,0,61,96,.635,.635,33,72,.458,57,82,139,4,3,14,14,38,155,0,Moses Brown
2022-23,BRK,C,2,0,6,0,0,,0,0,0,0,,,0,0,,0,0,0,0,1,0,1,1,0,0,Moses Brown
2023-24,POR,C,22,5,200,33,65,.508,0,0,33,65,.508,.508,9,31,.290,37,49,86,7,5,7,11,27,75,0,Moses Brown
2024-25,IND,C,9,0,46,13,20,.650,0,0,13,20,.650,.650,3,5,.600,4,9,13,0,2,1,6,6,29,0,Moses Brown
2017-18,MIL,SG,54,4,776,82,205,.400,32,91,.352,50,114,.439,.478,21,24,.875,27,116,143,25,31,13,25,80,217,Sterling Brown
2018-19,MIL,SG,58,7,1034,145,312,.465,53,147,.361,92,165,.558,.550,29,42,.690,29,155,184,84,25,8,46,88,372,Sterling Brown
2019-20,MIL,SF,52,1,767,95,256,.371,44,136,.324,51,120,.425,.457,32,40,.800,31,152,183,51,29,7,42,54,266,Sterling Brown
2020-21,HOU,SG,51,14,1229,150,335,.448,91,215,.423,59,120,.492,.584,25,31,.806,38,186,224,72,38,12,41,97,416,Sterling Brown
2021-22,DAL,SG,49,3,628,59,155,.381,28,92,.304,31,63,.492,.471,14,15,.933,26,123,149,34,14,7,23,56,160,Sterling Brown
2022-23,LAL,SF,4,0,24,0,4,.000,0,2,.000,0,2,.000,.000,0,0,,3,5,8,2,3,0,0,4,0,Sterling Brown
2018-19,WAS,SF,52,10,730,97,234,.415,22,69,.319,75,165,.455,.462,32,47,.681,35,110,145,80,21,5,30,56,248,Troy Brown Jr.
2019-20,WAS,SF,69,22,1782,273,622,.439,61,179,.341,212,443,.479,.488,109,139,.784,76,307,383,178,85,7,79,132,716,Troy Brown Jr.
2020-21,2TM,SF,34,0,524,62,144,.431,22,70,.314,40,74,.541,.507,15,21,.714,20,85,105,29,10,6,21,49,161,Troy Brown Jr.
2020-21,WAS,SF,21,0,287,33,89,.371,14,46,.304,19,43,.442,.449,10,15,.667,11,50,61,19,3,4,16,29,90,Troy Brown Jr.
2020-21,CHI,SF,13,0,237,29,55,.527,8,24,.333,21,31,.677,.600,5,6,.833,9,35,44,10,7,2,5,20,71,Troy Brown Jr.
2021-22,CHI,SF,66,7,1055,108,258,.419,47,133,.353,61,125,.488,.510,20,26,.769,39,164,203,66,36,5,26,62,283,Troy Brown Jr.
2022-23,LAL,SF,76,45,1860,200,465,.430,107,281,.381,93,184,.505,.545,34,39,.872,62,246,308,95,59,16,49,120,541,Troy Brown Jr.
2023-24,2TM,SF,59,15,827,84,226,.372,47,141,.333,37,85,.435,.476,32,37,.865,25,119,144,60,24,3,30,42,247,Troy Brown Jr.
2023-24,MIN,SF,37,3,410,52,118,.441,31,84,.369,21,34,.618,.572,19,22,.864,14,58,72,35,8,2,18,26,154,Troy Brown Jr.
2023-24,DET,SF,22,12,417,32,108,.296,16,57,.281,16,51,.314,.370,13,15,.867,11,61,72,25,16,1,12,16,93,Troy Brown Jr.
2018-19,DAL,PG,73,38,1591,264,565,.467,63,181,.348,201,384,.523,.523,87,120,.725,25,144,169,230,37,4,88,127,678,Jalen Brunson
2019-20,DAL,PG,57,16,1022,181,388,.466,43,120,.358,138,268,.515,.522,61,75,.813,22,112,134,188,22,4,66,74,466,Jalen Brunson
2020-21,DAL,PG,68,12,1697,328,627,.523,81,200,.405,247,427,.578,.588,120,151,.795,27,204,231,239,35,1,80,109,857,Jalen Brunson
2021-22,DAL,SG,79,61,2524,506,1008,.502,94,252,.373,412,756,.545,.549,179,213,.840,43,266,309,377,66,3,124,151,1285,Jalen Brunson
2022-23,NYK,PG,68,68,2379,587,1195,.491,134,322,.416,453,873,.519,.547,325,392,.829,40,201,241,421,61,15,142,152,1633,Jalen Brunson
2023-24,NYK,PG,77,77,2726,790,1648,.479,211,526,.401,579,1122,.516,.543,421,497,.847,43,235,278,519,70,13,186,144,2212,Jalen Brunson
2024-25,NYK,PG,31,31,1072,259,538,.481,79,189,.418,180,349,.516,.555,163,201,.811,14,78,92,238,25,2,74,72,760,Jalen Brunson
2017-18,LAL,C,15,0,72,8,21,.381,1,10,.100,7,11,.636,.405,5,9,.556,3,14,17,6,1,2,2,6,22,Thomas Bryant
2018-19,WAS,C,72,53,1496,309,502,.616,33,99,.333,276,403,.685,.648,107,137,.781,113,341,454,92,25,67,60,126,758,Thomas Bryant
2019-20,WAS,C,46,36,1147,243,418,.581,37,91,.407,206,327,.630,.626,86,116,.741,98,233,331,83,25,49,53,103,609,Thomas Bryant
2020-21,WAS,C,10,10,271,59,91,.648,9,21,.429,50,70,.714,.698,16,24,.667,18,43,61,15,4,8,11,31,143,Thomas Bryant
2021-22,WAS,C,27,9,439,77,148,.520,12,42,.286,65,106,.613,.561,35,40,.875,26,82,108,23,6,21,19,43,201,Thomas Bryant
2022-23,2TM,C,59,26,1081,230,369,.623,26,59,.441,204,310,.658,.659,93,126,.738,86,253,339,31,16,30,38,102,579,Thomas Bryant
2022-23,LAL,C,41,25,876,197,301,.654,22,50,.440,175,251,.697,.691,80,108,.741,67,212,279,29,14,23,28,77,496,Thomas Bryant
2022-23,DEN,C,18,1,205,33,68,.485,4,9,.444,29,59,.492,.515,13,18,.722,19,41,60,2,2,7,10,25,83,Thomas Bryant
2023-24,MIA,C,38,4,441,86,149,.577,4,22,.182,82,127,.646,.591,41,47,.872,40,101,141,23,10,16,21,46,217,Thomas Bryant
2024-25,2TM,C,16,0,183,23,49,.469,11,29,.379,12,20,.600,.582,13,13,1.000,11,42,53,7,4,12,4,13,70,Thomas Bryant
2024-25,MIA,C,10,0,115,12,28,.429,6,17,.353,6,11,.545,.536,11,11,1.000,6,26,32,4,1,9,2,9,41,Thomas Bryant
2024-25,IND,C,6,0,68,11,21,.524,5,12,.417,6,9,.667,.643,2,2,1.000,5,16,21,3,3,3,2,4,29,Thomas Bryant
2021-22,MEM,SG,2,0,10,1,4,.250,0,2,.000,1,2,.500,.250,0,0,1,1,2,2,1,0,2,1,2,0,Shaq Buchanan
2023-24,ATL,SG,17,0,196,34,92,.370,9,40,.225,25,52,.481,.418,4,8,.500,6,27,33,27,7,5,10,20,81,Kobe Bufkin
2024-25,ATL,SG,10,0,124,18,47,.383,4,19,.211,14,28,.500,.426,13,18,.722,5,16,21,17,3,2,8,9,53,Kobe Bufkin
2013-14,LAC,SF,43,0,395,43,121,.355,22,73,.301,21,48,.438,.446,7,9,.778,11,43,54,12,9,1,13,26,115,Reggie Bullock
2014-15,2TM,SF,36,2,338,24,70,.343,15,46,.326,9,24,.375,.450,6,9,.667,1,49,50,8,10,4,8,19,69,Reggie Bullock
2014-15,LAC,SF,25,2,263,23,54,.426,15,39,.385,8,15,.533,.565,4,5,.800,0,40,40,6,9,2,6,17,65,Reggie Bullock
2014-15,PHO,SF,11,0,75,1,16,.063,0,7,.000,1,9,.111,.063,2,4,.500,1,9,10,2,1,2,2,2,4,Reggie Bullock
2015-16,DET,SF,37,0,429,43,98,.439,22,53,.415,21,45,.467,.551,14,15,.933,14,54,68,27,10,2,8,29,122,Reggie Bullock
2016-17,DET,SF,31,5,467,54,128,.422,28,73,.384,26,55,.473,.531,5,7,.714,13,51,64,29,18,3,10,22,141,Reggie Bullock
2017-18,DET,SF,62,52,1732,267,546,.489,125,281,.445,142,265,.536,.603,39,49,.796,27,127,154,95,47,13,47,70,698,Reggie Bullock
2018-19,2TM,SG,63,60,1879,245,594,.412,148,393,.377,97,201,.483,.537,73,85,.859,22,151,173,129,40,12,65,109,711,Reggie Bullock
2018-19,DET,SG,44,44,1355,182,441,.413,114,294,.388,68,147,.463,.542,56,64,.875,20,103,123,109,24,5,54,79,534,Reggie Bullock
2018-19,LAL,SG,19,16,524,63,153,.412,34,99,.343,29,54,.537,.523,17,21,.810,2,48,50,20,16,7,11,30,177,Reggie Bullock
2019-20,NYK,SG,29,19,684,90,224,.402,37,111,.333,53,113,.469,.484,17,21,.810,13,55,68,42,25,3,19,56,234,Reggie Bullock
2020-21,NYK,SF,65,64,1949,248,561,.442,163,398,.410,85,163,.521,.587,50,55,.909,16,207,223,99,52,11,45,146,709,Reggie Bullock
2021-22,DAL,SF,68,37,1902,201,501,.401,141,392,.360,60,109,.550,.542,40,48,.833,33,208,241,83,41,14,40,111,583,Reggie Bullock
2022-23,DAL,SF,78,55,2364,192,470,.409,151,397,.380,41,73,.562,.569,26,37,.703,32,251,283,108,54,13,36,166,561,Reggie Bullock
2023-24,HOU,SF,44,0,417,34,82,.415,27,67,.403,7,15,.467,.579,1,1,1.000,6,67,73,15,12,5,10,29,96,Reggie Bullock
2013-14,UTA,PG,70,68,2262,341,897,.380,111,336,.330,230,561,.410,.442,102,113,.903,37,171,208,396,42,6,131,145,895,Trey Burke
2014-15,UTA,PG,76,43,2288,370,1005,.368,124,390,.318,246,615,.400,.430,109,145,.752,31,173,204,328,65,15,124,119,973,Trey Burke
2015-16,UTA,PG,64,0,1366,262,634,.413,88,256,.344,174,378,.460,.483,67,82,.817,18,94,112,148,35,6,80,86,679,Trey Burke
2016-17,WAS,PG,57,0,703,116,255,.455,31,70,.443,85,185,.459,.516,22,29,.759,7,40,47,100,11,5,48,54,285,Trey Burke
2017-18,NYK,PG,36,9,785,193,384,.503,38,105,.362,155,279,.556,.552,37,57,.649,13,58,71,170,24,4,43,43,461,Trey Burke
2018-19,2TM,PG,58,8,1125,236,548,.431,56,159,.352,180,389,.463,.482,103,124,.831,28,71,99,159,33,7,49,58,631,Trey Burke
2018-19,NYK,PG,33,7,689,148,358,.413,30,86,.349,118,272,.434,.455,62,75,.827,15,47,62,94,21,5,29,33,388,Trey Burke
2018-19,DAL,PG,25,1,436,88,190,.463,26,73,.356,62,117,.530,.532,41,49,.837,13,24,37,65,12,2,20,25,243,Trey Burke
2019-20,2TM,PG,33,1,520,94,209,.450,32,75,.427,62,134,.463,.526,23,29,.793,16,34,50,83,16,2,21,33,243,Trey Burke
2019-20,PHI,PG,25,0,329,59,127,.465,16,38,.421,43,89,.483,.528,13,18,.722,15,20,35,53,7,1,12,21,147,Trey Burke
2019-20,DAL,PG,8,1,191,35,82,.427,16,37,.432,19,45,.422,.524,10,11,.909,1,14,15,30,9,1,9,12,96,Trey Burke
2020-21,DAL,PG,62,1,911,151,353,.428,58,164,.354,93,189,.492,.510,51,57,.895,10,44,54,81,36,7,33,64,411,Trey Burke
2021-22,DAL,PG,42,0,441,84,215,.391,26,82,.317,58,133,.436,.451,20,23,.870,4,29,33,57,12,0,26,39,214,Trey Burke
2011-12,UTA,SG,59,0,939,153,357,.429,15,45,.333,138,312,.442,.450,104,143,.727,57,75,132,55,27,5,51,84,425,Alec Burks
2012-13,UTA,SG,64,0,1137,163,388,.420,33,92,.359,130,296,.439,.463,92,129,.713,37,108,145,92,35,13,74,114,451,Alec Burks
2013-14,UTA,SG,78,12,2193,380,831,.457,50,143,.350,330,688,.480,.487,279,373,.748,59,198,257,212,69,14,149,190,1089,Alec Burks
2014-15,UTA,SG,27,27,899,121,300,.403,26,68,.382,95,232,.409,.447,106,129,.822,19,95,114,82,17,5,52,64,374,Alec Burks
2015-16,UTA,SG,31,3,797,137,334,.410,32,79,.405,105,255,.412,.458,106,141,.752,16,93,109,63,18,4,51,71,412,Alec Burks
2016-17,UTA,SG,42,0,653,99,248,.399,25,76,.329,74,172,.430,.450,60,78,.769,17,103,120,30,18,5,35,50,283,Alec Burks
2017-18,UTA,SG,64,1,1059,170,414,.411,47,142,.331,123,272,.452,.467,107,124,.863,19,173,192,67,37,8,60,75,494,Alec Burks
2018-19,3TM,SG,64,24,1375,192,474,.405,61,168,.363,131,306,.428,.469,116,141,.823,30,205,235,128,39,21,65,91,561,Alec Burks
2018-19,UTA,SG,17,0,269,47,114,.412,16,43,.372,31,71,.437,.482,33,38,.868,2,25,27,20,6,4,15,22,143,Alec Burks
2018-19,CLE,SG,34,24,979,136,340,.400,45,119,.378,91,221,.412,.466,79,98,.806,26,160,186,98,25,16,46,62,396,Alec Burks
2018-19,SAC,SG,13,0,127,9,20,.450,0,6,.000,9,14,.643,.450,4,5,.800,2,20,22,10,8,1,4,7,22,Alec Burks
2019-20,2TM,SF,66,19,1754,321,768,.418,116,301,.385,205,467,.439,.493,235,265,.887,48,234,282,189,62,17,91,128,993,Alec Burks
2019-20,GSW,SF,48,18,1390,244,601,.406,84,224,.375,160,377,.424,.476,201,224,.897,37,189,226,151,50,17,76,107,773,Alec Burks
2019-20,PHI,SG,18,1,364,77,167,.461,32,77,.416,45,90,.500,.557,34,41,.829,11,45,56,38,12,0,15,21,220,Alec Burks
2020-21,NYK,SG,49,5,1255,210,500,.420,102,246,.415,108,254,.425,.522,101,118,.856,21,206,227,107,31,14,49,102,623,Alec Burks
2021-22,NYK,SG,81,44,2318,285,728,.391,157,389,.404,128,339,.378,.499,217,264,.822,47,350,397,239,85,26,91,215,944,Alec Burks
2022-23,DET,SG,51,8,1122,200,459,.436,99,239,.414,101,220,.459,.544,153,188,.814,19,139,158,114,38,8,58,98,652,Alec Burks
2023-24,2TM,SG,66,1,1212,210,569,.369,124,330,.376,86,239,.360,.478,145,167,.868,24,126,150,88,28,12,48,75,689,Alec Burks
2023-24,DET,SG,43,0,901,160,406,.394,99,247,.401,61,159,.384,.516,121,134,.903,16,94,110,68,21,11,32,64,540,Alec Burks
2023-24,NYK,SG,23,1,311,50,163,.307,25,83,.301,25,80,.313,.383,24,33,.727,8,32,40,20,7,1,16,11,149,Alec Burks
2024-25,MIA,SG,14,0,237,29,59,.492,21,41,.512,8,18,.444,.669,13,17,.765,6,26,32,17,10,4,3,10,92,Alec Burks
2018-19,OKC,SG,32,0,240,33,82,.402,8,27,.296,25,55,.455,.451,8,12,.667,4,24,28,9,6,8,9,31,82,Deonte Burton
2019-20,OKC,SF,39,0,356,43,125,.344,10,53,.189,33,72,.458,.384,8,14,.571,7,50,57,17,7,10,19,34,104,Deonte Burton
2022-23,SAC,PF,2,0,6,0,2,.000,0,1,.000,0,1,.000,.000,0,0,,0,0,0,0,0,0,0,0,0,Deonte Burton
2021-22,UTA,SG,42,1,360,61,151,.404,28,88,.318,33,63,.524,.497,11,16,.688,5,40,45,63,17,8,33,47,161,Jared Butler
2022-23,OKC,PG,6,1,77,15,32,.469,7,14,.500,8,18,.444,.578,0,0,,1,3,4,8,5,0,5,5,37,Jared Butler
2023-24,WAS,SG,40,0,566,98,201,.488,24,78,.308,74,123,.602,.547,31,36,.861,9,49,58,126,29,8,50,58,251,Jared Butler
2024-25,WAS,SG,20,0,220,46,101,.455,7,25,.280,39,76,.513,.490,17,23,.739,6,14,20,50,7,2,18,24,116,Jared Butler
2011-12,CHI,SG,42,0,359,32,79,.405,2,11,.182,30,68,.441,.418,43,56,.768,23,33,56,14,11,5,14,20,109,Jimmy Butler
2012-13,CHI,SF,82,20,2134,239,512,.467,40,105,.381,199,407,.489,.506,187,233,.803,136,192,328,115,78,31,62,97,705,Jimmy Butler
2013-14,CHI,SG,67,67,2591,275,693,.397,68,240,.283,207,453,.457,.446,260,338,.769,87,243,330,175,127,36,102,106,878,Jimmy Butler
2014-15,CHI,SG,65,65,2513,421,912,.462,73,193,.378,348,719,.484,.502,386,463,.834,114,265,379,212,114,36,93,108,1301,Jimmy Butler
2015-16,CHI,SG,67,67,2474,470,1035,.454,64,205,.312,406,830,.489,.485,395,475,.832,79,279,358,321,110,43,132,124,1399,Jimmy Butler
2016-17,CHI,SF,76,75,2809,570,1252,.455,91,248,.367,479,1004,.477,.492,585,676,.865,129,341,470,417,143,32,159,112,1816,Jimmy Butler
2017-18,MIN,SG,59,59,2164,437,921,.474,70,200,.350,367,721,.509,.512,363,425,.854,79,235,314,288,116,24,108,78,1307,Jimmy Butler
2018-19,2TM,SF,65,65,2185,418,904,.462,67,193,.347,351,711,.494,.499,312,365,.855,121,221,342,263,123,39,95,111,1215,Jimmy Butler
2018-19,MIN,SG,10,10,361,74,157,.471,17,45,.378,57,112,.509,.525,48,61,.787,16,36,52,43,24,10,14,18,213,Jimmy Butler
2018-19,PHI,SF,55,55,1824,344,747,.461,50,148,.338,294,599,.491,.494,264,304,.868,105,185,290,220,99,29,81,93,1002,Jimmy Butler
2019-20,MIA,SF,58,58,1959,345,758,.455,29,119,.244,316,639,.495,.474,438,525,.834,106,280,386,350,103,32,127,81,1157,Jimmy Butler
2020-21,MIA,SF,52,52,1745,366,736,.497,25,102,.245,341,634,.538,.514,359,416,.863,94,265,359,369,108,18,109,71,1116,Jimmy Butler
2021-22,MIA,SF,57,57,1931,398,829,.480,27,116,.233,371,713,.520,.496,396,455,.870,102,234,336,312,94,27,121,88,1219,Jimmy Butler
2022-23,MIA,PF,64,64,2138,479,888,.539,36,103,.350,443,785,.564,.560,472,555,.850,141,234,375,340,117,21,101,80,1466,Jimmy Butler
2023-24,MIA,PF,60,60,2042,396,793,.499,60,145,.414,336,648,.519,.537,394,459,.858,105,213,318,298,79,17,102,68,1246,Jimmy Butler
2024-25,MIA,PF,20,20,627,122,221,.552,10,28,.357,112,193,.580,.575,115,147,.782,51,64,115,97,25,8,26,20,369,Jimmy Butler
2022-23,POR,C,19,1,221,17,53,.321,8,35,.229,9,18,.500,.396,3,4,.750,3,14,17,11,7,9,1,22,45,John Butler
2024-25,CHI,SF,29,0,381,53,143,.371,25,74,.338,28,69,.406,.458,22,28,.786,15,61,76,17,8,22,18,42,153,Matas Buzelis
2014-15,TOR,SF,8,0,23,4,12,.333,2,3,.667,2,9,.222,.417,0,0,,1,1,2,0,0,1,4,3,10,Bruno Caboclo
2015-16,TOR,SF,6,1,43,1,12,.083,1,7,.143,0,5,.000,.125,0,0,,1,1,2,1,2,1,4,2,3,Bruno Caboclo
2016-17,TOR,SF,9,0,40,6,16,.375,2,6,.333,4,10,.400,.438,0,0,,5,5,10,4,2,1,2,4,14,Bruno Caboclo
2017-18,2TM,SF,12,0,107,9,31,.290,3,17,.176,6,14,.429,.339,5,6,.833,7,15,22,4,3,4,4,8,26,Bruno Caboclo
2017-18,TOR,SF,2,0,7,0,2,.000,0,2,.000,0,0,,.000,0,0,,0,1,1,1,1,0,0,1,0,Bruno Caboclo
2017-18,SAC,SF,10,0,100,9,29,.310,3,15,.200,6,14,.429,.362,5,6,.833,7,14,21,3,2,4,4,7,26,Bruno Caboclo
2018-19,MEM,PF,34,19,800,96,225,.427,48,130,.369,48,95,.505,.533,42,50,.840,42,116,158,50,14,33,38,81,282,Bruno Caboclo
2019-20,2TM,C,30,0,244,38,89,.427,6,33,.182,32,56,.571,.461,8,9,.889,23,37,60,12,15,17,13,31,90,Bruno Caboclo
2019-20,MEM,C,22,0,192,28,69,.406,4,25,.160,24,44,.545,.435,2,3,.667,17,27,44,10,10,12,7,23,62,Bruno Caboclo
2019-20,HOU,C,8,0,52,10,20,.500,2,8,.250,8,12,.667,.550,6,6,1.000,6,10,16,2,5,5,6,8,28,Bruno Caboclo
2020-21,HOU,PF,6,0,36,8,17,.471,0,5,.000,8,12,.667,.471,1,2,.500,3,11,14,1,0,2,4,6,17,Bruno Caboclo
2019-20,LAL,C,1,0,9,3,6,.500,0,0,3,6,.500,.500,0,0,,2,3,5,1,0,0,0,0,6,0,Devontae Cacok
2020-21,LAL,PF,20,1,98,17,29,.586,0,0,17,29,.586,.586,5,11,.455,12,20,32,1,5,4,5,8,39,0,Devontae Cacok
2021-22,SAS,PF,15,0,121,21,31,.677,0,0,21,31,.677,.677,4,7,.571,8,34,42,6,8,7,3,16,46,0,Devontae Cacok
2022-23,MIA,PF,18,0,240,37,66,.561,7,20,.350,30,46,.652,.614,17,22,.773,15,37,52,12,11,1,6,21,98,Jamal Cain
2023-24,MIA,PF,26,1,259,34,79,.430,11,31,.355,23,48,.479,.500,18,23,.783,15,22,37,10,10,5,8,22,97,Jamal Cain
2024-25,NOP,SF,16,0,225,25,55,.455,9,28,.321,16,27,.593,.536,10,16,.625,15,30,45,10,8,7,7,20,69,Jamal Cain
2013-14,DET,SG,80,41,1583,182,460,.396,59,185,.319,123,275,.447,.460,47,61,.770,38,118,156,55,75,12,28,145,470,Kentavious Caldwell-Pope
2014-15,DET,SG,82,82,2587,390,972,.401,153,444,.345,237,528,.449,.480,110,158,.696,46,209,255,109,93,18,94,161,1043,Kentavious Caldwell-Pope
2015-16,DET,SG,76,76,2789,403,960,.420,114,369,.309,289,591,.489,.479,185,228,.811,70,212,282,138,110,17,105,167,1105,Kentavious Caldwell-Pope
2016-17,DET,SG,76,75,2529,370,928,.399,153,437,.350,217,491,.442,.481,154,185,.832,55,193,248,193,89,12,86,118,1047,Kentavious Caldwell-Pope
2017-18,LAL,SG,74,74,2458,340,798,.426,159,415,.383,181,383,.473,.526,153,194,.789,60,327,387,162,106,16,97,145,992,Kentavious Caldwell-Pope
2018-19,LAL,SG,82,23,2035,325,756,.430,151,435,.347,174,321,.542,.530,137,158,.867,48,190,238,110,73,13,65,137,938,Kentavious Caldwell-Pope
2019-20,LAL,SG,69,26,1762,237,507,.467,92,239,.385,145,268,.541,.558,79,102,.775,38,104,142,111,57,14,62,128,645,Kentavious Caldwell-Pope
2020-21,LAL,SG,67,67,1902,218,506,.431,120,293,.410,98,213,.460,.549,97,112,.866,27,152,179,127,62,26,66,114,653,Kentavious Caldwell-Pope
2021-22,WAS,SG,77,77,2329,361,829,.435,159,408,.390,202,421,.480,.531,137,154,.890,41,220,261,145,83,26,97,139,1018,Kentavious Caldwell-Pope
2022-23,DEN,SG,76,76,2381,292,632,.462,135,319,.423,157,313,.502,.569,103,125,.824,35,173,208,183,112,35,86,145,822,Kentavious Caldwell-Pope
2023-24,DEN,SG,76,76,2402,270,587,.460,125,308,.406,145,279,.520,.566,101,113,.894,31,152,183,183,98,42,75,151,766,Kentavious Caldwell-Pope
2024-25,ORL,SG,32,32,986,95,237,.401,46,155,.297,49,82,.598,.498,46,50,.920,11,55,66,61,52,20,26,66,282,Kentavious Caldwell-Pope
2023-24,POR,PF,70,49,1739,197,438,.450,58,172,.337,139,266,.523,.516,75,99,.758,139,204,343,87,66,33,84,174,527,Toumani Camara
2024-25,POR,PF,30,30,916,98,234,.419,44,127,.346,54,107,.505,.513,22,30,.733,65,103,168,58,40,14,46,85,262,Toumani Camara
2020-21,DEN,PG,65,19,1425,120,315,.381,76,216,.352,44,99,.444,.502,80,91,.879,22,112,134,232,79,14,73,132,396,Facundo Campazzo
2021-22,DEN,PG,65,4,1184,107,296,.361,58,193,.301,49,103,.476,.459,60,78,.769,23,94,117,220,63,23,67,124,332,Facundo Campazzo
2022-23,DAL,PG,8,0,52,3,13,.231,3,11,.273,0,2,.000,.346,1,2,.500,0,2,2,9,6,0,3,3,10,Facundo Campazzo
2019-20,DEN,PF,14,0,45,6,15,.400,1,6,.167,5,9,.556,.433,4,4,1.000,5,5,10,3,1,1,3,7,17,Vlatko Čančar
2020-21,DEN,PF,41,1,281,33,72,.458,9,33,.273,24,39,.615,.521,10,13,.769,11,39,50,14,11,2,14,18,85,Vlatko Čančar
2021-22,DEN,PF,15,1,176,23,41,.561,7,12,.583,16,29,.552,.646,9,14,.643,8,23,31,17,2,3,9,18,62,Vlatko Čančar
2022-23,DEN,PF,60,9,889,108,227,.476,43,115,.374,65,112,.580,.570,38,41,.927,24,104,128,80,22,14,37,84,297,Vlatko Čančar
2024-25,DEN,PF,4,0,34,4,7,.571,1,2,.500,3,5,.600,.643,0,0,,3,5,8,0,0,1,2,4,9,Vlatko Čančar
2020-21,ORL,PG,8,0,74,11,28,.393,6,16,.375,5,12,.417,.500,6,7,.857,0,5,5,1,5,1,2,9,34,Devin Cannady
2021-22,ORL,PG,5,0,145,15,44,.341,15,37,.405,0,7,.000,.511,5,7,.714,1,5,6,10,5,3,5,9,50,Devin Cannady
2014-15,HOU,C,12,0,90,14,29,.483,0,0,,14,29,.483,.483,4,23,.174,10,26,36,2,1,9,5,14,32,Clint Capela
2015-16,HOU,C,77,35,1471,231,397,.582,0,1,.000,231,396,.583,.582,80,211,.379,194,300,494,47,59,92,60,190,542,Clint Capela
2016-17,HOU,C,65,59,1551,362,563,.643,0,0,,362,563,.643,.643,94,177,.531,178,348,526,63,34,79,87,179,818,Clint Capela
2017-18,HOU,C,74,74,2034,441,676,.652,0,1,.000,441,675,.653,.652,144,257,.560,241,561,802,68,58,137,103,185,1026,Clint Capela
2018-19,HOU,C,67,67,2249,474,732,.648,0,0,,474,732,.648,.648,166,261,.636,298,550,848,96,44,102,94,168,1114,Clint Capela
2019-20,HOU,C,39,39,1279,244,388,.629,0,0,,244,388,.629,.629,55,104,.529,168,369,537,48,33,72,63,102,543,Clint Capela
2020-21,ATL,C,63,63,1898,413,695,.594,0,0,,413,695,.594,.594,130,227,.573,297,606,903,49,44,129,73,145,956,Clint Capela
2021-22,ATL,C,74,73,2042,370,604,.613,0,1,.000,370,603,.614,.613,80,169,.473,279,598,877,92,55,93,44,166,820,Clint Capela
2022-23,ATL,C,65,63,1730,350,536,.653,0,1,.000,350,535,.654,.653,79,131,.603,258,459,717,58,45,79,54,139,779,Clint Capela
2023-24,ATL,C,73,73,1883,353,618,.571,0,1,.000,353,617,.572,.571,130,206,.631,335,441,776,91,43,106,74,164,836,Clint Capela
2024-25,ATL,C,31,31,712,135,236,.572,0,0,,135,236,.572,.572,31,58,.534,109,174,283,40,18,32,28,60,301,Clint Capela
2020-21,CHO,C,19,4,115,18,36,.500,1,7,.143,17,29,.586,.514,9,11,.818,6,21,27,2,1,5,5,13,46,Vernon Carey Jr.
2021-22,2TM,C,7,1,44,7,13,.538,0,0,,7,13,.538,.538,6,13,.462,8,4,12,0,2,1,3,4,20,Vernon Carey Jr.
2021-22,CHO,C,4,1,17,3,6,.500,0,0,,3,6,.500,.500,2,3,.667,3,2,5,0,1,0,1,1,8,Vernon Carey Jr.
2021-22,WAS,C,3,0,27,4,7,.571,0,0,,4,7,.571,.571,4,10,.400,5,2,7,0,1,1,2,3,12,Vernon Carey Jr.
2022-23,WAS,C,11,0,28,2,8,.250,0,0,,2,8,.250,.250,2,2,1.000,3,8,11,3,2,2,2,5,6,Vernon Carey Jr.
2024-25,OKC,C,5,0,18,1,7,.143,0,5,.000,1,2,.500,.143,2,2,1.000,3,5,8,2,1,1,0,1,4,Branden Carlson
2024-25,WAS,PG,28,19,822,91,234,.389,42,124,.339,49,110,.445,.479,22,27,.815,10,109,119,106,23,7,55,86,246,Carlton Carrington
2018-19,MEM,PG,39,3,577,56,185,.303,34,102,.333,22,83,.265,.395,26,32,.813,14,52,66,69,26,11,33,55,172,Jevon Carter
2019-20,PHO,PG,58,2,945,101,243,.416,62,146,.425,39,97,.402,.543,23,27,.852,30,88,118,84,47,17,32,86,287,Jevon Carter
2020-21,PHO,PG,60,1,717,94,223,.422,56,151,.371,38,72,.528,.547,4,7,.571,16,76,92,71,29,9,16,56,248,Jevon Carter
2021-22,2TM,PG,66,3,905,98,253,.387,66,170,.388,32,83,.386,.518,15,18,.833,14,96,110,96,24,14,34,67,277,Jevon Carter
2021-22,BRK,PG,46,1,552,58,174,.333,42,127,.331,16,47,.340,.454,7,10,.700,9,58,67,46,14,10,26,45,165,Jevon Carter
2021-22,MIL,PG,20,2,353,40,79,.506,24,43,.558,16,36,.444,.658,8,8,1.000,5,38,43,50,10,4,8,22,112,Jevon Carter
2022-23,MIL,PG,81,39,1810,239,565,.423,142,337,.421,97,228,.425,.549,31,38,.816,35,167,202,197,66,29,78,158,651,Jevon Carter
2023-24,CHI,PG,72,0,1004,138,365,.378,77,234,.329,61,131,.466,.484,4,7,.571,11,49,60,94,37,16,36,71,357,Jevon Carter
2024-25,CHI,PG,14,0,97,18,42,.429,11,28,.393,7,14,.500,.560,1,2,.500,2,11,13,12,5,0,6,4,48,Jevon Carter
2018-19,CHI,C,44,44,1110,180,371,.485,6,32,.188,174,339,.513,.493,89,112,.795,87,220,307,78,26,58,65,152,455,Wendell Carter Jr.
2019-20,CHI,C,43,43,1256,183,343,.534,6,29,.207,177,314,.564,.542,112,152,.737,139,266,405,51,33,36,72,162,484,Wendell Carter Jr.
2020-21,2TM,C,54,44,1375,230,457,.503,15,51,.294,215,406,.530,.520,131,179,.732,132,311,443,104,35,42,78,146,606,Wendell Carter Jr.
2020-21,CHI,C,32,25,792,129,252,.512,8,22,.364,121,230,.526,.528,82,111,.739,70,180,250,69,18,24,49,96,348,Wendell Carter Jr.
2020-21,ORL,C,22,19,583,101,205,.493,7,29,.241,94,176,.534,.510,49,68,.721,62,131,193,35,17,18,29,50,258,Wendell Carter Jr.
2021-22,ORL,PF,62,61,1852,359,684,.525,70,214,.327,289,470,.615,.576,143,207,.691,139,509,648,171,36,43,117,169,931,Wendell Carter Jr.
2022-23,ORL,C,57,54,1690,322,613,.525,80,225,.356,242,388,.624,.591,144,195,.738,120,377,497,132,30,33,106,159,868,Wendell Carter Jr.
2023-24,ORL,C,55,48,1406,223,425,.525,64,171,.374,159,254,.626,.600,93,134,.694,112,269,381,95,35,28,68,121,603,Wendell Carter Jr.
2024-25,ORL,C,20,17,492,48,107,.449,7,39,.179,41,68,.603,.481,38,51,.745,33,111,144,45,14,13,14,49,141,Wendell Carter Jr.
2013-14,PHI,PG,70,70,2414,427,1054,.405,55,208,.264,372,846,.440,.431,258,367,.703,101,336,437,441,130,43,247,213,1167,Michael Carter-Williams
2014-15,2TM,PG,66,63,2149,364,919,.396,36,153,.235,328,766,.428,.416,202,291,.694,64,289,353,442,111,30,253,167,966,Michael Carter-Williams
2014-15,PHI,PG,41,38,1391,232,611,.380,32,125,.256,200,486,.412,.406,117,182,.643,43,211,254,302,60,18,174,103,613,Michael Carter-Williams
2014-15,MIL,PG,25,25,758,132,308,.429,4,28,.143,128,280,.457,.435,85,109,.780,21,78,99,140,51,12,79,64,353,Michael Carter-Williams
2015-16,MIL,PG,54,37,1649,251,555,.452,15,55,.273,236,500,.472,.466,106,162,.654,48,228,276,281,80,41,153,162,623,Michael Carter-Williams
2016-17,CHI,PG,45,19,846,112,306,.366,15,64,.234,97,242,.401,.391,58,77,.753,24,129,153,113,38,23,66,102,297,Michael Carter-Williams
2017-18,CHO,PG,52,2,835,76,229,.332,14,59,.237,62,170,.365,.362,73,89,.820,37,101,138,116,44,23,52,99,239,Michael Carter-Williams
2018-19,2TM,PG,28,1,372,46,123,.374,10,38,.263,36,85,.424,.415,32,53,.604,19,51,70,70,20,15,20,48,134,Michael Carter-Williams
2018-19,HOU,PG,16,1,145,25,61,.410,7,19,.368,18,42,.429,.467,12,26,.462,3,10,13,21,9,6,10,27,69,Michael Carter-Williams
2018-19,ORL,PG,12,0,227,21,62,.339,3,19,.158,18,43,.419,.363,20,27,.741,16,41,57,49,11,9,10,21,65,Michael Carter-Williams
2019-20,ORL,SG,45,0,833,111,260,.427,22,75,.293,89,185,.481,.469,79,95,.832,46,101,147,109,49,22,52,87,323,Michael Carter-Williams
2020-21,ORL,SG,31,25,800,105,270,.389,15,61,.246,90,209,.431,.417,49,80,.613,39,100,139,129,25,17,69,81,274,Michael Carter-Williams
2022-23,ORL,PG,4,0,44,6,14,.429,1,3,.333,5,11,.455,.464,4,7,.571,1,4,5,7,1,1,4,5,17,Michael Carter-Williams
2023-24,TOR,SG,4,0,36,3,8,.375,1,4,.250,2,4,.500,.438,4,5,.800,2,2,4,3,1,0,1,3,11,D.J. Carton
2024-25,TOR,SG,4,0,33,1,7,.143,0,3,.000,1,4,.250,.143,1,1,1.000,0,4,4,3,2,0,4,1,3,D.J. Carton
2017-18,LAL,PG,37,7,562,50,116,.431,13,43,.302,37,73,.507,.487,21,30,.700,15,50,65,75,23,10,42,52,134,Alex Caruso
2018-19,LAL,PG,25,4,531,77,173,.445,24,50,.480,53,123,.431,.514,51,64,.797,20,47,67,77,24,9,42,54,229,Alex Caruso
2019-20,LAL,PG,64,2,1175,120,291,.412,40,120,.333,80,171,.468,.481,69,94,.734,17,106,123,124,70,18,53,98,349,Alex Caruso
2020-21,LAL,PG,58,6,1216,133,305,.436,55,137,.401,78,168,.464,.526,49,76,.645,31,139,170,160,64,15,76,108,370,Alex Caruso
2021-22,CHI,SG,41,18,1147,102,256,.398,42,126,.333,60,130,.462,.480,58,73,.795,33,115,148,165,71,15,57,106,304,Alex Caruso
2022-23,CHI,PG,67,36,1575,130,286,.455,55,151,.364,75,135,.556,.551,59,73,.808,42,154,196,193,98,46,77,159,374,Alex Caruso
2023-24,CHI,SG,71,57,2040,253,541,.468,136,333,.408,117,208,.563,.593,73,96,.760,62,211,273,247,120,70,102,181,715,Alex Caruso
2024-25,OKC,SG,20,0,398,43,114,.377,17,65,.262,26,49,.531,.452,7,9,.778,12,46,58,49,38,12,15,40,110,Alex Caruso
2024-25,SAS,PG,30,17,771,119,310,.384,31,115,.270,88,195,.451,.434,68,96,.708,20,57,77,110,26,10,55,51,337,Stephon Castle
2023-24,LAL,C,16,0,59,9,16,.563,0,0,,9,16,.563,.563,6,6,1.000,6,6,12,3,2,0,3,11,24,Colin Castleton
2024-25,MEM,C,8,0,22,1,4,.250,0,2,.000,1,2,.500,.250,8,8,1.000,2,5,7,0,0,1,0,3,10,Colin Castleton
2015-16,SAC,C,66,39,1412,191,339,.563,0,2,.000,191,337,.567,.563,81,125,.648,134,218,352,37,48,66,46,146,463,Willie Cauley-Stein
2016-17,SAC,C,75,21,1421,255,481,.530,0,2,.000,255,479,.532,.530,101,151,.669,85,254,339,80,53,44,69,147,611,Willie Cauley-Stein
2017-18,SAC,C,73,57,2044,388,773,.502,3,12,.250,385,761,.506,.504,153,247,.619,131,379,510,172,77,67,109,185,932,Willie Cauley-Stein
2018-19,SAC,C,81,81,2213,412,741,.556,1,2,.500,411,739,.556,.557,140,254,.551,181,497,678,194,96,51,84,227,965,Willie Cauley-Stein
2019-20,2TM,C,54,39,1097,175,302,.579,0,1,.000,175,301,.581,.579,40,66,.606,84,231,315,70,49,61,40,121,390,Willie Cauley-Stein
2019-20,GSW,C,41,37,940,144,257,.560,0,0,,144,257,.560,.560,35,57,.614,71,184,255,60,45,50,35,102,323,Willie Cauley-Stein
2019-20,DAL,C,13,2,157,31,45,.689,0,1,.000,31,44,.705,.689,5,9,.556,13,47,60,10,4,11,5,19,67,Willie Cauley-Stein
2020-21,DAL,C,53,16,906,115,182,.632,1,11,.091,114,171,.667,.635,49,78,.628,66,170,236,35,21,43,29,129,280,Willie Cauley-Stein
2021-22,2TM,C,20,2,183,16,35,.457,1,2,.500,15,33,.455,.471,1,2,.500,13,27,40,10,6,3,7,19,34,Willie Cauley-Stein
2021-22,DAL,C,18,2,177,16,35,.457,1,2,.500,15,33,.455,.471,1,2,.500,13,25,38,9,6,3,7,17,34,Willie Cauley-Stein
2021-22,PHI,C,2,0,6,0,0,,0,0,,0,0,,,0,0,,0,2,2,1,0,0,0,2,0,Willie Cauley-Stein
2021-22,IND,SG,1,0,1,1,1,1.000,0,0,1,1,1.000,1.000,0,0,0,0,0,0,0,0,0,0,2,0,,Ahmad Caver
2022-23,2TM,SF,17,3,320,59,130,.454,33,82,.402,26,48,.542,.581,14,17,.824,10,50,60,10,6,5,11,26,165,Julian Champagnie
2022-23,PHI,SF,2,0,7,0,2,.000,0,1,.000,0,1,.000,.000,0,0,,0,0,0,0,1,0,0,0,0,Julian Champagnie
2022-23,SAS,SF,15,3,313,59,128,.461,33,81,.407,26,47,.553,.590,14,17,.824,10,50,60,10,5,5,11,26,165,Julian Champagnie
2023-24,SAS,SF,74,59,1468,164,402,.408,101,277,.365,63,125,.504,.534,75,92,.815,42,164,206,103,48,42,57,77,504,Julian Champagnie
2024-25,SAS,SF,31,26,895,134,307,.436,84,225,.373,50,82,.610,.573,37,41,.902,23,130,153,43,27,17,35,51,389,Julian Champagnie
2021-22,TOR,SF,36,0,281,31,67,.463,10,28,.357,21,39,.538,.537,9,9,1.000,37,35,72,11,8,4,8,32,81,Justin Champagnie
2022-23,2TM,SF,5,0,34,5,15,.333,1,5,.200,4,10,.400,.367,0,0,,3,5,8,4,1,0,0,2,11,Justin Champagnie
2022-23,TOR,SF,3,0,11,3,3,1.000,0,0,,3,3,1.000,1.000,0,0,,1,3,4,1,0,0,0,1,6,Justin Champagnie
2022-23,BOS,SF,2,0,23,2,12,.167,1,5,.200,1,7,.143,.208,0,0,,2,2,4,3,1,0,0,1,5,Justin Champagnie
2023-24,WAS,SF,15,1,235,32,78,.410,13,45,.289,19,33,.576,.494,12,15,.800,19,34,53,19,10,9,10,14,89,Justin Champagnie
2024-25,WAS,SF,11,8,266,41,79,.519,12,36,.333,29,43,.674,.595,9,14,.643,27,46,73,13,13,10,11,24,103,Justin Champagnie
2022-23,MEM,PG,36,0,281,35,83,.422,2,15,.133,33,68,.485,.434,6,13,.462,9,29,38,58,12,5,18,15,78,Kennedy Chandler
2019-20,NOP,PF,4,0,51,6,9,.667,0,1,.000,6,8,.750,.667,0,0,3,6,9,3,1,1,4,10,12,0,Zylan Cheatham
2021-22,UTA,SF,1,0,5,0,3,.000,0,2,.000,0,1,.000,.000,0,0,0,0,0,0,0,0,0,0,0,0,Zylan Cheatham
2018-19,HOU,PG,7,0,33,2,8,.250,2,5,.400,0,3,.000,.375,0,0,,1,3,4,4,1,1,1,2,6,Chris Chiozza
2019-20,2TM,PG,28,2,401,55,140,.393,27,72,.375,28,68,.412,.489,5,5,1.000,9,44,53,83,21,4,32,37,142,Chris Chiozza
2019-20,WAS,PG,10,0,123,10,34,.294,7,16,.438,3,18,.167,.397,0,0,,0,15,15,28,10,2,9,12,27,Chris Chiozza
2019-20,BRK,PG,18,2,278,45,106,.425,20,56,.357,25,50,.500,.519,5,5,1.000,9,29,38,55,11,2,23,25,115,Chris Chiozza
2020-21,BRK,PG,22,1,232,31,88,.352,13,42,.310,18,46,.391,.426,13,17,.765,3,21,24,65,7,6,16,19,88,Chris Chiozza
2021-22,GSW,PG,34,1,372,24,81,.296,17,53,.321,7,28,.250,.401,2,3,.667,9,27,36,65,13,0,32,32,67,Chris Chiozza
2024-25,TOR,PF,3,0,14,1,2,.500,0,0,1,2,.500,.500,0,0,2,2,4,1,0,0,2,2,2,0,,Ulrich Chomche
2016-17,PHO,PF,82,75,1743,284,632,.449,72,224,.321,212,408,.520,.506,113,181,.624,96,252,348,60,67,70,108,263,753,Marquese Chriss
2017-18,PHO,PF,72,49,1527,202,477,.423,56,190,.295,146,287,.509,.482,96,158,.608,76,319,395,83,51,70,107,205,556,Marquese Chriss
2018-19,2TM,PF,43,2,499,67,180,.372,16,72,.222,51,108,.472,.417,32,45,.711,40,102,142,22,17,11,36,81,182,Marquese Chriss
2018-19,HOU,PF,16,0,104,11,34,.324,1,15,.067,10,19,.526,.338,6,7,.857,7,21,28,6,2,4,12,17,29,Marquese Chriss
2018-19,CLE,PF,27,2,395,56,146,.384,15,57,.263,41,89,.461,.435,26,38,.684,33,81,114,16,15,7,24,64,153,Marquese Chriss
2019-20,GSW,PF,59,21,1196,210,385,.545,8,39,.205,202,346,.584,.556,120,156,.769,114,251,365,114,39,62,78,122,548,Marquese Chriss
2020-21,GSW,PF,2,0,27,5,14,.357,1,5,.200,4,9,.444,.393,2,4,.500,3,10,13,2,0,2,2,3,13,Marquese Chriss
2021-22,DAL,PF,34,0,346,62,134,.463,8,25,.320,54,109,.495,.493,22,33,.667,33,70,103,17,13,12,17,64,154,Marquese Chriss
2024-25,LAC,SG,1,0,18,2,7,.286,1,4,.250,1,3,.333,.357,0,0,1,2,3,0,2,0,1,0,5,0,Cam Christie
2022-23,LAL,SG,41,3,512,44,106,.415,26,62,.419,18,44,.409,.538,14,16,.875,7,68,75,21,9,7,13,33,128,Max Christie
2023-24,LAL,SG,67,7,944,103,241,.427,42,118,.356,61,123,.496,.515,36,46,.783,15,127,142,60,20,17,35,57,284,Max Christie
2024-25,LAL,SG,29,8,621,62,145,.428,24,70,.343,38,75,.507,.510,52,60,.867,21,48,69,34,25,10,22,42,200,Max Christie
2021-22,HOU,SG,74,2,1334,224,500,.448,56,189,.296,168,311,.540,.504,83,113,.735,52,134,186,150,65,13,114,97,587,Josh Christopher
2022-23,HOU,SG,64,2,786,153,329,.465,21,89,.236,132,240,.550,.497,45,60,.750,20,51,71,73,33,15,60,59,372,Josh Christopher
2024-25,MIA,SG,1,0,2,0,1,.000,0,1,.000,0,0,,.000,0,0,,0,0,0,0,0,0,1,0,0,Josh Christopher
2023-24,SAS,SF,12,0,141,16,33,.485,1,12,.083,15,21,.714,.500,12,15,.800,8,14,22,10,7,3,3,18,45,Sidy Cissoko
2024-25,SAS,SF,12,0,36,5,11,.455,3,5,.600,2,6,.333,.591,0,4,.000,2,6,8,5,0,0,1,5,13,Sidy Cissoko
2018-19,HOU,PF,51,2,641,50,151,.331,41,138,.297,9,13,.692,.467,7,7,1.000,24,92,116,18,20,26,7,47,148,Gary Clark
2019-20,2TM,PF,42,5,567,54,133,.406,39,111,.351,15,22,.682,.553,9,10,.900,37,73,110,17,6,22,10,46,156,Gary Clark
2019-20,HOU,PF,18,0,212,23,59,.390,18,51,.353,5,8,.625,.542,6,7,.857,11,29,40,12,2,7,2,21,70,Gary Clark
2019-20,ORL,SF,24,5,355,31,74,.419,21,60,.350,10,14,.714,.561,3,3,1.000,26,44,70,5,4,15,8,25,86,Gary Clark
2020-21,3TM,SF,39,11,654,40,132,.303,31,108,.287,9,24,.375,.420,8,10,.800,33,82,115,31,13,7,17,35,119,Gary Clark
2020-21,ORL,SF,35,11,637,40,131,.305,31,108,.287,9,23,.391,.424,8,10,.800,33,79,112,30,12,7,17,34,119,Gary Clark
2020-21,DEN,SF,2,0,4,0,0,,0,0,,0,0,,,0,0,,0,1,1,0,0,0,0,0,0,Gary Clark
2020-21,PHI,PF,2,0,13,0,1,.000,0,0,,0,1,.000,.000,0,0,,0,2,2,1,1,0,0,1,0,Gary Clark
2021-22,NOP,PF,38,1,378,33,88,.375,28,70,.400,5,18,.278,.534,7,10,.700,23,67,90,18,13,7,10,20,101,Gary Clark
2019-20,MEM,PF,58,4,1300,296,479,.618,23,64,.359,273,415,.658,.642,85,112,.759,92,253,345,81,32,48,55,100,700,Brandon Clarke
2020-21,MEM,PF,59,16,1415,256,495,.517,20,77,.260,236,418,.565,.537,78,113,.690,97,231,328,95,60,51,33,84,610,Brandon Clarke
2021-22,MEM,PF,64,1,1246,288,447,.644,5,22,.227,283,425,.666,.650,85,130,.654,135,207,342,86,39,68,34,122,666,Brandon Clarke
2022-23,MEM,PF,56,8,1090,229,349,.656,1,6,.167,228,343,.665,.658,99,137,.723,92,218,310,72,34,37,55,131,558,Brandon Clarke
2023-24,MEM,PF,6,1,134,33,59,.559,1,6,.167,32,53,.604,.568,1,7,.143,13,19,32,9,5,6,3,8,68,Brandon Clarke
2024-25,MEM,PF,31,17,569,103,170,.606,1,16,.063,102,154,.662,.609,19,31,.613,52,106,158,31,24,15,16,67,226,Brandon Clarke
2014-15,LAL,PG,59,38,1476,267,596,.448,38,121,.314,229,475,.482,.480,131,158,.829,56,135,191,206,51,12,96,109,703,Jordan Clarkson
2015-16,LAL,SG,79,79,2552,475,1098,.433,111,320,.347,364,778,.468,.483,164,204,.804,93,220,313,192,88,7,135,168,1225,Jordan Clarkson
2016-17,LAL,SG,82,19,2397,477,1071,.445,117,356,.329,360,715,.503,.500,134,168,.798,49,197,246,213,88,8,164,150,1205,Jordan Clarkson
2017-18,2TM,SG,81,2,1888,430,954,.451,112,318,.352,318,636,.500,.509,152,190,.800,57,160,217,221,58,6,127,107,1124,Jordan Clarkson
2017-18,LAL,SG,53,2,1256,299,667,.448,68,210,.324,231,457,.505,.499,105,132,.795,44,115,159,173,39,3,95,63,771,Jordan Clarkson
2017-18,CLE,SG,28,0,632,131,287,.456,44,108,.407,87,179,.486,.533,47,58,.810,13,45,58,48,19,3,32,44,353,Jordan Clarkson
2018-19,CLE,SG,81,0,2214,529,1180,.448,144,445,.324,385,735,.524,.509,162,192,.844,82,188,270,196,57,13,135,112,1364,Jordan Clarkson
2019-20,2TM,SG,71,2,1705,394,867,.454,152,413,.368,242,454,.533,.542,138,165,.836,50,137,187,136,46,16,97,108,1078,Jordan Clarkson
2019-20,CLE,SG,29,0,666,144,326,.442,59,159,.371,85,167,.509,.532,76,86,.884,21,48,69,70,17,8,39,33,423,Jordan Clarkson
2019-20,UTA,SG,42,2,1039,250,541,.462,93,254,.366,157,287,.547,.548,62,79,.785,29,89,118,66,29,8,58,75,655,Jordan Clarkson
2020-21,UTA,SG,68,1,1818,457,1075,.425,208,599,.347,249,476,.523,.522,129,144,.896,47,227,274,168,61,10,115,110,1251,Jordan Clarkson
2021-22,UTA,SG,79,1,2141,466,1113,.419,190,597,.318,276,516,.535,.504,144,174,.828,67,206,273,194,66,16,129,149,1266,Jordan Clarkson
2022-23,UTA,SG,61,61,1988,458,1031,.444,155,459,.338,303,572,.530,.519,200,245,.816,72,174,246,270,33,13,186,120,1271,Jordan Clarkson
2023-24,UTA,SG,55,19,1682,337,816,.413,91,309,.294,246,507,.485,.469,177,201,.881,49,139,188,277,35,6,146,81,942,Jordan Clarkson
2024-25,UTA,SG,18,2,470,96,235,.409,35,105,.333,61,130,.469,.483,57,71,.803,10,52,62,74,17,4,44,29,284,Jordan Clarkson
2019-20,BRK,C,15,0,187,27,48,.563,1,7,.143,26,41,.634,.573,11,21,.524,19,25,44,16,1,8,9,14,66,Nic Claxton
2020-21,BRK,C,32,1,594,90,145,.621,1,5,.200,89,140,.636,.624,31,64,.484,43,123,166,28,23,40,18,68,212,Nic Claxton
2021-22,BRK,C,47,19,974,178,264,.674,0,0,,178,264,.674,.674,54,93,.581,91,173,264,43,24,51,38,110,410,Nic Claxton
2022-23,BRK,C,76,76,2271,414,587,.705,0,2,.000,414,585,.708,.705,133,246,.541,184,518,702,144,65,189,96,212,961,Nic Claxton
2023-24,BRK,C,71,71,2116,366,582,.629,1,5,.200,365,577,.633,.630,108,196,.551,193,513,706,147,46,146,93,175,841,Nic Claxton
2024-25,BRK,C,25,17,634,105,185,.568,1,8,.125,104,177,.588,.570,28,55,.509,51,137,188,50,22,31,33,54,239,Nic Claxton
2019-20,HOU,SG,33,0,291,57,142,.401,37,107,.346,20,35,.571,.532,10,11,.909,4,26,30,27,9,6,19,26,161,Chris Clemons
2024-25,POR,C,23,7,377,56,105,.533,5,15,.333,51,90,.567,.557,16,22,.727,65,80,145,12,12,40,25,66,133,Donovan Clingan
2023-24,BRK,PF,23,4,370,50,93,.538,12,33,.364,38,60,.633,.602,21,30,.700,26,55,81,18,8,16,15,25,133,Noah Clowney
2024-25,BRK,PF,22,4,433,64,157,.408,42,110,.382,22,47,.468,.541,21,27,.778,21,61,82,17,7,12,18,63,191,Noah Clowney
2019-20,LAC,SG,18,1,159,23,54,.426,6,19,.316,17,35,.486,.481,6,11,.545,4,12,16,14,5,2,8,20,58,Amir Coffey
2020-21,LAC,SG,44,1,394,45,103,.437,23,56,.411,22,47,.468,.549,27,38,.711,10,34,44,22,10,0,15,30,140,Amir Coffey
2021-22,LAC,SG,69,30,1567,211,466,.453,96,254,.378,115,212,.542,.556,101,117,.863,26,171,197,124,38,15,45,87,619,Amir Coffey
2022-23,LAC,SF,50,9,625,56,145,.386,11,40,.275,45,105,.429,.424,49,63,.778,17,36,53,53,7,5,21,50,172,Amir Coffey
2023-24,LAC,SF,70,13,1460,166,352,.472,70,184,.380,96,168,.571,.571,61,71,.859,29,119,148,76,41,14,33,102,463,Amir Coffey
2024-25,LAC,SG,30,8,736,106,216,.491,49,114,.430,57,102,.559,.604,40,48,.833,16,62,78,36,16,3,20,49,301,Amir Coffey
2024-25,UTA,PG,21,2,367,26,86,.302,5,32,.156,21,54,.389,.331,8,19,.421,3,40,43,70,16,4,50,38,65,Isaiah Collier
2017-18,ATL,PF,74,26,1785,314,545,.576,16,47,.340,298,498,.598,.591,133,186,.715,176,365,541,98,47,80,105,215,777,John Collins
2018-19,ATL,PF,61,59,1829,465,831,.560,55,158,.348,410,673,.609,.593,203,266,.763,219,376,595,121,22,39,120,199,1188,John Collins
2019-20,ATL,PF,41,41,1363,353,605,.583,59,147,.401,294,458,.642,.632,120,150,.800,116,300,416,60,31,66,75,138,885,John Collins
2020-21,ATL,PF,63,63,1848,429,771,.556,83,208,.399,346,563,.615,.610,170,204,.833,118,349,467,78,34,63,84,193,1111,John Collins
2021-22,ATL,PF,54,53,1663,339,644,.526,64,176,.364,275,468,.588,.576,134,169,.793,93,329,422,98,33,56,60,164,876,John Collins
2022-23,ATL,PF,71,71,2130,359,707,.508,70,240,.292,289,467,.619,.557,143,178,.803,77,385,462,85,42,73,79,220,931,John Collins
2023-24,UTA,PF,68,66,1901,397,746,.532,86,232,.371,311,514,.605,.590,147,185,.795,157,418,575,77,40,61,98,191,1027,John Collins
2024-25,UTA,PF,26,17,780,168,321,.523,36,85,.424,132,236,.559,.579,88,101,.871,58,156,214,65,29,22,67,75,460,John Collins
2017-18,POR,C,66,1,1045,115,289,.398,35,113,.310,80,176,.455,.458,27,42,.643,45,176,221,52,17,31,58,133,292,Zach Collins
2018-19,POR,C,77,0,1356,189,400,.473,40,121,.331,149,279,.534,.523,94,126,.746,109,215,324,71,25,66,77,174,512,Zach Collins
2019-20,POR,PF,11,11,290,32,68,.471,7,19,.368,25,49,.510,.522,6,8,.750,25,44,69,16,5,5,14,36,77,Zach Collins
2021-22,SAS,C,28,4,502,76,155,.490,14,41,.341,62,114,.544,.535,52,65,.800,46,107,153,61,13,23,45,67,218,Zach Collins
2022-23,SAS,C,63,26,1441,284,548,.518,55,147,.374,229,401,.571,.568,108,142,.761,116,286,402,180,37,49,129,199,731,Zach Collins
2023-24,SAS,C,69,29,1526,298,616,.484,58,181,.320,240,435,.552,.531,122,162,.753,118,252,370,194,34,52,132,206,776,Zach Collins
2024-25,SAS,C,24,4,341,50,105,.476,12,36,.333,38,69,.551,.533,28,32,.875,28,52,80,42,11,12,21,53,140,Zach Collins
2022-23,POR,C,1,0,21,3,5,.600,0,0,3,5,.600,.600,1,4,.250,2,1,3,0,0,1,0,0,7,0,Chance Comanche
2007-08,MEM,PG,53,46,1381,189,442,.428,30,91,.330,159,351,.453,.462,90,123,.732,21,118,139,222,44,2,89,85,498,Mike Conley
2008-09,MEM,PG,82,61,2508,323,730,.442,88,217,.406,235,513,.458,.503,161,197,.817,25,251,276,354,90,8,143,146,895,Mike Conley
2009-10,MEM,PG,80,80,2569,369,830,.445,82,212,.387,287,618,.464,.494,139,187,.743,30,161,191,425,109,12,170,178,959,Mike Conley
2010-11,MEM,PG,81,81,2872,423,953,.444,80,217,.369,343,736,.466,.486,181,247,.733,32,215,247,528,144,18,176,182,1107,Mike Conley
2011-12,MEM,PG,62,61,2174,296,684,.433,60,159,.377,236,525,.450,.477,136,158,.861,22,134,156,404,136,11,125,133,788,Mike Conley
2012-13,MEM,PG,80,80,2757,414,940,.440,106,293,.362,308,647,.476,.497,234,282,.830,43,182,225,487,174,24,189,171,1168,Mike Conley
2013-14,MEM,PG,73,73,2446,463,1030,.450,105,291,.361,358,739,.484,.500,225,276,.815,41,172,213,441,110,13,150,141,1256,Mike Conley
2014-15,MEM,PG,70,70,2225,393,882,.446,107,277,.386,286,605,.473,.506,214,249,.859,29,180,209,375,89,14,156,139,1107,Mike Conley
2015-16,MEM,PG,56,56,1761,294,696,.422,78,215,.363,216,481,.449,.478,191,229,.834,26,138,164,342,67,16,84,100,857,Mike Conley
2016-17,MEM,PG,69,68,2292,464,1009,.460,171,419,.408,293,590,.497,.545,316,368,.859,31,210,241,433,92,19,156,126,1415,Mike Conley
2017-18,MEM,PG,12,12,373,64,168,.381,24,77,.312,40,91,.440,.452,53,66,.803,0,27,27,49,12,3,18,24,205,Mike Conley
2018-19,MEM,PG,70,70,2342,490,1120,.438,155,426,.364,335,694,.483,.507,343,406,.845,40,199,239,449,94,22,130,123,1478,Mike Conley
2019-20,UTA,PG,47,41,1363,232,567,.409,96,256,.375,136,311,.437,.494,115,139,.827,33,118,151,208,36,5,92,104,675,Mike Conley
2020-21,UTA,PG,51,51,1498,284,640,.444,138,335,.412,146,305,.479,.552,121,142,.852,36,141,177,305,70,9,99,98,827,Mike Conley
2021-22,UTA,PG,72,72,2058,344,791,.435,169,414,.408,175,377,.464,.542,129,162,.796,47,170,217,385,96,21,123,142,986,Mike Conley
2022-23,2TM,PG,67,66,2029,261,610,.428,135,351,.385,126,259,.486,.539,141,169,.834,33,149,182,450,73,14,103,139,798,Mike Conley
2022-23,UTA,PG,43,42,1276,153,375,.408,77,213,.362,76,162,.469,.511,78,96,.813,17,90,107,330,44,10,74,94,461,Mike Conley
2022-23,MIN,PG,24,24,753,108,235,.460,58,138,.420,50,97,.515,.583,63,73,.863,16,59,75,120,29,4,29,45,337,Mike Conley
2023-24,MIN,PG,76,76,2193,294,644,.457,179,405,.442,115,239,.481,.595,102,112,.911,37,181,218,449,88,17,102,128,869,Mike Conley
2024-25,MIN,PG,26,26,661,67,192,.349,48,134,.358,19,58,.328,.474,31,34,.912,13,60,73,117,39,6,33,42,213,Mike Conley
2015-16,POR,SG,34,0,143,13,49,.265,5,21,.238,8,28,.286,.316,5,5,1.000,11,21,32,10,2,0,10,6,36,Pat Connaughton
2016-17,POR,SG,39,1,316,37,72,.514,17,33,.515,20,39,.513,.632,7,9,.778,10,42,52,28,6,2,17,23,98,Pat Connaughton
2017-18,POR,SG,82,5,1488,165,390,.423,74,210,.352,91,180,.506,.518,37,44,.841,36,125,161,91,23,22,43,120,441,Pat Connaughton
2018-19,MIL,SG,61,2,1261,163,350,.466,66,200,.330,97,150,.647,.560,29,40,.725,61,197,258,122,33,25,33,81,421,Pat Connaughton
2019-20,MIL,SG,67,4,1243,137,301,.455,55,166,.331,82,135,.607,.547,31,40,.775,60,224,284,107,25,31,52,70,360,Pat Connaughton
2020-21,MIL,SG,69,4,1575,168,387,.434,101,272,.371,67,115,.583,.565,31,40,.775,63,269,332,81,49,23,33,99,468,Pat Connaughton
2021-22,MIL,SF,65,19,1691,227,496,.458,146,370,.395,81,126,.643,.605,45,54,.833,45,228,273,82,59,15,35,86,645,Pat Connaughton
2022-23,MIL,SF,61,33,1443,165,421,.392,109,322,.339,56,99,.566,.521,27,41,.659,50,233,283,77,37,11,33,69,466,Pat Connaughton
2023-24,MIL,SF,76,3,1676,151,347,.435,82,238,.345,69,109,.633,.553,44,58,.759,51,188,239,161,40,19,49,99,428,Pat Connaughton
2024-25,MIL,SG,16,0,269,27,71,.380,14,45,.311,13,26,.500,.479,9,12,.750,8,38,46,26,3,5,11,20,77,Pat Connaughton
2019-20,2TM,PF,13,0,54,8,12,.667,0,0,,8,12,.667,.667,7,8,.875,6,8,14,1,3,0,3,5,23,Tyler Cook
2019-20,CLE,PF,11,0,35,7,10,.700,0,0,,7,10,.700,.700,5,6,.833,4,6,10,1,1,0,1,4,19,Tyler Cook
2019-20,DEN,SF,2,0,19,1,2,.500,0,0,,1,2,.500,.500,2,2,1.000,2,2,4,0,2,0,2,1,4,Tyler Cook
2020-21,2TM,SF,32,1,438,69,103,.670,1,2,.500,68,101,.673,.675,17,35,.486,28,67,95,17,8,2,21,35,156,Tyler Cook
2020-21,BRK,PF,4,0,17,1,3,.333,0,0,,1,3,.333,.333,0,0,,1,1,2,2,0,0,1,2,2,Tyler Cook
2020-21,DET,SF,28,1,421,68,100,.680,1,2,.500,67,98,.684,.685,17,35,.486,27,66,93,15,8,2,20,33,154,Tyler Cook
2021-22,CHI,PF,20,2,200,23,38,.605,0,0,,23,38,.605,.605,21,32,.656,16,37,53,3,4,4,7,28,67,Tyler Cook
2022-23,WAS,PF,10,1,126,17,28,.607,0,1,.000,17,27,.630,.607,4,10,.400,16,22,38,6,6,4,8,13,38,Xavier Cooks
2021-22,ATL,PG,13,0,39,3,14,.214,1,6,.167,2,8,.250,.250,0,0,0,5,5,5,0,0,5,1,7,0,Sharife Cooper
2023-24,WAS,SF,63,15,1715,188,432,.435,64,185,.346,124,247,.502,.509,92,131,.702,56,200,256,110,57,48,87,137,532,Bilal Coulibaly
2024-25,WAS,SF,26,26,903,124,284,.437,31,103,.301,93,181,.514,.491,69,88,.784,37,112,149,91,38,19,54,65,348,Bilal Coulibaly
2023-24,PHI,SG,32,0,289,54,112,.482,12,32,.375,42,80,.525,.536,53,71,.746,14,32,46,16,8,1,5,17,173,Ricky Council IV
2024-25,PHI,SF,21,0,264,36,89,.404,9,34,.265,27,55,.491,.455,36,42,.857,13,30,43,16,7,4,8,17,117,Ricky Council IV
2013-14,HOU,SF,7,0,34,6,14,.429,4,11,.364,2,3,.667,.571,0,0,,2,3,5,0,2,0,1,3,16,Robert Covington
2014-15,PHI,SF,70,49,1956,299,756,.396,167,446,.374,132,310,.426,.506,178,217,.820,65,251,316,105,97,31,128,189,943,Robert Covington
2015-16,PHI,SF,67,49,1903,274,712,.385,170,482,.353,104,230,.452,.504,140,177,.791,65,354,419,97,105,40,143,232,858,Robert Covington
2016-17,PHI,SF,67,67,2119,292,732,.399,137,412,.333,155,320,.484,.492,143,174,.822,92,344,436,102,127,69,131,203,864,Robert Covington
2017-18,PHI,SF,80,80,2532,345,836,.413,203,550,.369,142,286,.497,.534,116,136,.853,55,378,433,156,137,72,126,238,1009,Robert Covington
2018-19,2TM,SF,35,35,1203,156,362,.431,85,225,.378,71,137,.518,.548,68,89,.764,28,165,193,46,74,47,47,126,465,Robert Covington
2018-19,PHI,SF,13,13,440,50,117,.427,30,77,.390,20,40,.500,.556,17,23,.739,7,60,67,14,24,23,22,45,147,Robert Covington
2018-19,MIN,SF,22,22,763,106,245,.433,55,148,.372,51,97,.526,.545,51,66,.773,21,105,126,32,50,24,25,81,318,Robert Covington
2019-20,2TM,PF,70,68,2137,305,723,.422,161,480,.335,144,243,.593,.533,99,124,.798,63,400,463,88,115,93,103,220,870,Robert Covington
2019-20,MIN,PF,48,47,1411,216,496,.435,108,312,.346,108,184,.587,.544,75,94,.798,36,251,287,56,80,45,73,148,615,Robert Covington
2019-20,HOU,C,22,21,726,89,227,.392,53,168,.315,36,59,.610,.509,24,30,.800,27,149,176,32,35,48,30,72,255,Robert Covington
2020-21,POR,PF,70,70,2243,204,509,.401,135,356,.379,69,153,.451,.533,50,62,.806,61,405,466,117,101,84,64,195,593,Robert Covington
2021-22,2TM,PF,71,42,1940,209,498,.420,128,339,.378,81,159,.509,.548,58,69,.841,59,332,391,92,103,91,75,190,604,Robert Covington
2021-22,POR,PF,48,40,1431,128,336,.381,79,230,.343,49,106,.462,.499,30,36,.833,41,233,274,68,74,63,58,132,365,Robert Covington
2021-22,LAC,PF,23,2,509,81,162,.500,49,109,.450,32,53,.604,.651,28,33,.848,18,99,117,24,29,28,17,58,239,Robert Covington
2022-23,LAC,PF,48,0,779,102,229,.445,54,136,.397,48,93,.516,.563,30,40,.750,31,135,166,57,38,33,32,86,288,Robert Covington
2023-24,2TM,PF,29,6,488,43,98,.439,19,56,.339,24,42,.571,.536,22,26,.846,31,66,97,24,39,18,11,56,127,Robert Covington
2023-24,LAC,PF,3,3,69,3,9,.333,2,8,.250,1,1,1.000,.444,1,2,.500,2,6,8,7,6,2,0,7,9,Robert Covington
2023-24,PHI,SF,26,3,419,40,89,.449,17,48,.354,23,41,.561,.545,21,24,.875,29,60,89,17,33,16,11,49,118,Robert Covington
2013-14,POR,SG,15,0,100,12,33,.364,6,14,.429,6,19,.316,.455,3,4,.750,1,8,9,6,2,1,3,10,33,Allen Crabbe
2014-15,POR,SG,51,9,683,63,153,.412,30,85,.353,33,68,.485,.510,12,16,.750,7,66,73,39,19,15,15,74,168,Allen Crabbe
2015-16,POR,SG,81,8,2105,311,678,.459,112,285,.393,199,393,.506,.541,98,113,.867,27,189,216,99,63,16,64,192,832,Allen Crabbe
2016-17,POR,SG,79,7,2254,303,647,.468,134,302,.444,169,345,.490,.572,105,124,.847,19,207,226,94,54,20,62,171,845,Allen Crabbe
2017-18,BRK,SG,75,68,2197,337,827,.407,201,532,.378,136,295,.461,.529,115,135,.852,28,296,324,117,47,35,78,168,990,Allen Crabbe
2018-19,BRK,SG,43,20,1133,137,373,.367,98,259,.378,39,114,.342,.499,41,56,.732,16,132,148,46,23,13,46,102,413,Allen Crabbe
2019-20,2TM,SG,37,1,653,63,177,.356,36,119,.303,27,58,.466,.458,10,14,.714,11,66,77,33,15,4,17,47,172,Allen Crabbe
2019-20,ATL,SG,28,1,522,52,143,.364,30,93,.323,22,50,.440,.469,9,12,.750,10,55,65,28,15,4,12,36,143,Allen Crabbe
2019-20,MIN,SF,9,0,131,11,34,.324,6,26,.231,5,8,.625,.412,1,2,.500,1,11,12,5,0,0,5,11,29,Allen Crabbe
2017-18,DEN,SF,39,5,629,62,137,.453,17,58,.293,45,79,.570,.515,22,35,.629,40,87,127,25,12,15,20,63,163,Torrey Craig
2018-19,DEN,SF,75,37,1503,160,362,.442,61,188,.324,99,174,.569,.526,49,70,.700,89,174,263,72,37,46,44,175,430,Torrey Craig
2019-20,DEN,SF,58,27,1072,124,269,.461,45,138,.326,79,131,.603,.545,22,36,.611,63,126,189,47,23,36,25,135,315,Torrey Craig
2020-21,2TM,SF,50,8,803,109,227,.480,39,106,.368,70,121,.579,.566,17,22,.773,57,140,197,49,28,26,25,83,274,Torrey Craig
2020-21,MIL,SF,18,0,201,18,46,.391,8,22,.364,10,24,.417,.478,1,2,.500,13,30,43,16,9,7,5,24,45,Torrey Craig
2020-21,PHO,SF,32,8,602,91,181,.503,31,84,.369,60,97,.619,.588,16,20,.800,44,110,154,33,19,19,20,59,229,Torrey Craig
2021-22,2TM,SF,78,16,1596,200,441,.454,77,234,.329,123,207,.594,.541,39,52,.750,86,224,310,91,46,36,67,151,516,Torrey Craig
2021-22,IND,SF,51,14,1034,128,281,.456,46,138,.333,82,143,.573,.537,27,35,.771,59,136,195,58,24,19,39,95,329,Torrey Craig
2021-22,PHO,SF,27,2,562,72,160,.450,31,96,.323,41,64,.641,.547,12,17,.706,27,88,115,33,22,17,28,56,187,Torrey Craig
2022-23,PHO,PF,79,60,1948,228,500,.456,100,253,.395,128,247,.518,.556,32,45,.711,145,281,426,117,50,62,73,179,588,Torrey Craig
2023-24,CHI,SF,53,14,1049,108,251,.430,60,153,.392,48,98,.490,.550,27,36,.750,69,148,217,58,30,21,32,110,303,Torrey Craig
2024-25,CHI,SF,7,1,80,14,27,.519,8,21,.381,6,6,1.000,.667,2,2,1.000,5,12,17,3,1,1,0,13,38,Torrey Craig
2012-13,DAL,SF,78,16,1353,141,367,.384,63,192,.328,78,175,.446,.470,47,73,.644,35,152,187,94,63,17,49,128,392,Jae Crowder
2013-14,DAL,SF,78,8,1254,130,296,.439,50,151,.331,80,145,.552,.524,46,61,.754,46,148,194,60,59,21,41,100,356,Jae Crowder
2014-15,2TM,SF,82,17,1647,229,545,.420,61,208,.293,168,337,.499,.476,109,141,.773,72,221,293,94,72,25,49,137,628,Jae Crowder
2014-15,DAL,SF,25,0,265,33,76,.434,13,38,.342,20,38,.526,.520,10,11,.909,12,17,29,12,15,5,10,26,89,Jae Crowder
2014-15,BOS,SF,57,17,1382,196,469,.418,48,170,.282,148,299,.495,.469,99,130,.762,60,204,264,82,57,20,39,111,539,Jae Crowder
2015-16,BOS,SF,73,73,2308,360,813,.443,122,363,.336,238,450,.529,.518,196,239,.820,70,303,373,135,126,35,83,198,1038,Jae Crowder
2016-17,BOS,SF,72,72,2335,333,720,.463,157,394,.398,176,326,.540,.572,176,217,.811,48,367,415,155,73,23,80,161,999,Jae Crowder
2017-18,2TM,SF,80,47,2090,271,671,.404,110,341,.323,161,330,.488,.486,121,148,.818,59,216,275,99,64,21,74,187,773,Jae Crowder
2017-18,CLE,SF,53,47,1346,157,376,.418,62,189,.328,95,187,.508,.500,78,92,.848,41,132,173,58,41,12,42,124,454,Jae Crowder
2017-18,UTA,SF,27,0,744,114,295,.386,48,152,.316,66,143,.462,.468,43,56,.768,18,84,102,41,23,9,32,63,319,Jae Crowder
2018-19,UTA,SF,80,11,2166,318,797,.399,173,522,.331,145,275,.527,.508,142,197,.721,60,324,384,133,64,31,85,170,951,Jae Crowder
2019-20,2TM,SF,65,53,1875,226,563,.401,135,394,.343,91,169,.538,.521,97,125,.776,52,332,384,161,72,24,69,143,684,Jae Crowder
2019-20,MEM,SF,45,45,1322,147,399,.368,78,266,.293,69,133,.519,.466,75,95,.789,40,237,277,125,47,14,54,85,447,Jae Crowder
2019-20,MIA,PF,20,8,553,79,164,.482,57,128,.445,22,36,.611,.655,22,30,.733,12,95,107,36,25,10,15,58,237,Jae Crowder
2020-21,PHO,PF,60,42,1648,199,492,.404,148,380,.389,51,112,.455,.555,57,75,.760,32,250,282,127,48,27,55,125,603,Jae Crowder
2021-22,PHO,PF,67,67,1886,217,544,.399,127,365,.348,90,179,.503,.516,71,90,.789,30,324,354,124,95,30,55,173,632,Jae Crowder
2022-23,MIL,PF,18,3,340,45,94,.479,24,55,.436,21,39,.538,.606,10,12,.833,17,52,69,27,12,6,7,27,124,Jae Crowder
2023-24,MIL,PF,50,25,1156,114,270,.422,58,166,.349,56,104,.538,.530,26,36,.722,31,130,161,66,38,9,23,74,312,Jae Crowder
2024-25,SAC,SF,6,2,89,6,17,.353,3,12,.250,3,5,.600,.441,5,6,.833,6,11,17,4,3,0,4,10,20,Jae Crowder
2023-24,NOP,PG,1,0,3,0,1,.000,0,0,0,1,.000,.000,0,0,0,0,0,0,0,0,0,0,0,0,,Jalen Crutcher
2024-25,BRK,SG,5,0,10,1,7,.143,0,3,.000,1,4,.250,.143,1,2,.500,0,2,2,0,0,0,0,0,3,Cui Yongxi
2019-20,MIN,SG,63,35,1506,230,569,.404,66,221,.299,164,348,.471,.462,54,117,.462,70,142,212,110,57,38,81,125,580,Jarrett Culver
2020-21,MIN,SG,34,7,499,69,168,.411,13,53,.245,56,115,.487,.449,29,48,.604,34,70,104,24,17,9,28,58,180,Jarrett Culver
2021-22,MEM,SG,37,0,338,51,135,.378,12,47,.255,39,88,.443,.422,16,34,.471,13,35,48,33,20,5,20,42,130,Jarrett Culver
2022-23,ATL,SF,10,1,137,17,43,.395,1,12,.083,16,31,.516,.407,9,13,.692,10,28,38,6,6,2,7,14,44,Jarrett Culver
2021-22,DET,SG,64,64,2088,429,1031,.416,114,363,.314,315,668,.472,.471,142,168,.845,58,296,354,356,78,43,234,200,1114,Cade Cunningham
2022-23,DET,PG,12,12,400,93,224,.415,17,61,.279,76,163,.466,.453,36,43,.837,12,62,74,72,10,7,39,34,239,Cade Cunningham
2023-24,DET,PG,62,62,2074,524,1167,.449,119,335,.355,405,832,.487,.500,238,274,.869,33,235,268,464,56,22,212,153,1405,Cade Cunningham
2024-25,DET,PG,27,27,979,244,543,.449,66,177,.373,178,366,.486,.510,100,125,.800,28,158,186,263,23,24,121,76,654,Cade Cunningham
2013-14,2TM,PG,2,0,13,1,3,.333,1,1,1.000,0,2,.000,.500,0,0,,0,1,1,0,2,0,0,0,3,Seth Curry
2013-14,MEM,PG,1,0,4,0,0,,0,0,,0,0,,,0,0,,0,0,0,0,0,0,0,0,0,Seth Curry
2013-14,CLE,PG,1,0,9,1,3,.333,1,1,1.000,0,2,.000,.500,0,0,,0,1,1,0,2,0,0,0,3,Seth Curry
2014-15,PHO,PG,2,0,8,0,3,.000,0,1,.000,0,2,.000,.000,0,0,,0,2,2,1,0,0,0,2,0,Seth Curry
2015-16,SAC,PG,44,9,692,102,224,.455,50,111,.450,52,113,.460,.567,45,54,.833,9,51,60,67,22,3,36,41,299,Seth Curry
2016-17,DAL,PG,70,42,2029,338,703,.481,137,322,.425,201,381,.528,.578,85,100,.850,25,154,179,189,79,7,92,126,898,Seth Curry
2018-19,POR,SG,74,2,1399,212,465,.456,113,251,.450,99,214,.463,.577,44,52,.846,27,93,120,66,36,12,61,97,581,Seth Curry
2019-20,DAL,SG,64,25,1576,284,574,.495,145,321,.452,139,253,.549,.621,80,97,.825,27,118,145,124,38,9,62,113,793,Seth Curry
2020-21,PHI,SG,57,57,1638,258,552,.467,126,280,.450,132,272,.485,.582,69,77,.896,10,126,136,155,44,8,65,96,711,Seth Curry
2021-22,2TM,SG,64,64,2135,360,739,.487,158,374,.422,202,365,.553,.594,82,94,.872,21,179,200,230,53,14,109,148,960,Seth Curry
2021-22,PHI,SG,45,45,1566,256,528,.485,100,250,.400,156,278,.561,.580,64,73,.877,17,134,151,181,36,11,84,101,676,Seth Curry
2021-22,BRK,SG,19,19,569,104,211,.493,58,124,.468,46,87,.529,.630,18,21,.857,4,45,49,49,17,3,25,47,284,Seth Curry
2022-23,BRK,SG,61,7,1211,208,449,.463,94,232,.405,114,217,.525,.568,51,55,.927,13,87,100,99,36,7,51,96,561,Seth Curry
2023-24,2TM,SG,44,4,616,80,204,.392,38,108,.352,42,96,.438,.485,28,31,.903,18,50,68,44,22,6,21,39,226,Seth Curry
2023-24,DAL,SG,36,3,457,54,145,.372,29,80,.363,25,65,.385,.472,17,19,.895,15,37,52,30,17,3,16,32,154,Seth Curry
2023-24,CHO,SG,8,1,159,26,59,.441,9,28,.321,17,31,.548,.517,11,12,.917,3,13,16,14,5,3,5,7,72,Seth Curry
2024-25,CHO,SG,27,5,336,44,99,.444,22,53,.415,22,46,.478,.556,9,11,.818,10,26,36,12,13,4,7,27,119,Seth Curry
2009-10,GSW,PG,80,77,2896,528,1143,.462,166,380,.437,362,763,.474,.535,177,200,.885,48,308,356,472,152,19,243,252,1399,Stephen Curry
2010-11,GSW,PG,74,74,2489,505,1053,.480,151,342,.442,354,711,.498,.551,212,227,.934,52,234,286,432,109,20,226,233,1373,Stephen Curry
2011-12,GSW,PG,26,23,732,145,296,.490,55,121,.455,90,175,.514,.583,38,47,.809,15,73,88,138,39,8,65,62,383,Stephen Curry
2012-13,GSW,PG,78,78,2983,626,1388,.451,272,600,.453,354,788,.449,.549,262,291,.900,59,255,314,539,126,12,240,198,1786,Stephen Curry
2013-14,GSW,PG,78,78,2846,652,1383,.471,261,615,.424,391,768,.509,.566,308,348,.885,46,288,334,666,128,14,294,194,1873,Stephen Curry
2014-15,GSW,PG,80,80,2613,653,1341,.487,286,646,.443,367,695,.528,.594,308,337,.914,56,285,341,619,163,16,249,158,1900,Stephen Curry
2015-16,GSW,PG,79,79,2700,805,1598,.504,402,886,.454,403,712,.566,.630,363,400,.908,68,362,430,527,169,15,262,161,2375,Stephen Curry
2016-17,GSW,PG,79,79,2638,675,1443,.468,324,789,.411,351,654,.537,.580,325,362,.898,61,292,353,524,142,17,239,183,1999,Stephen Curry
2017-18,GSW,PG,51,51,1631,428,864,.495,212,501,.423,216,363,.595,.618,278,302,.921,36,225,261,310,80,8,153,114,1346,Stephen Curry
2018-19,GSW,PG,69,69,2331,632,1340,.472,354,810,.437,278,530,.525,.604,263,287,.916,45,324,369,361,92,25,192,166,1881,Stephen Curry
2019-20,GSW,PG,5,5,139,33,82,.402,12,49,.245,21,33,.636,.476,26,26,1.000,4,22,26,33,5,2,16,11,104,Stephen Curry
2020-21,GSW,PG,63,63,2152,658,1365,.482,337,801,.421,321,564,.569,.605,362,395,.916,29,316,345,363,77,8,213,119,2015,Stephen Curry
2021-22,GSW,PG,64,64,2211,535,1224,.437,285,750,.380,250,474,.527,.554,275,298,.923,34,301,335,404,85,23,206,130,1630,Stephen Curry
2022-23,GSW,PG,56,56,1941,559,1133,.493,273,639,.427,286,494,.579,.614,257,281,.915,39,302,341,352,52,20,179,117,1648,Stephen Curry
2023-24,GSW,PG,74,74,2421,650,1445,.450,357,876,.408,293,569,.515,.573,299,324,.923,37,293,330,379,54,28,210,117,1956,Stephen Curry
2024-25,GSW,PG,24,24,748,177,399,.444,102,248,.411,75,151,.497,.571,84,91,.923,10,105,115,157,28,13,74,25,540,Stephen Curry
2024-25,ORL,SF,29,22,723,92,217,.424,35,106,.330,57,111,.514,.505,24,31,.774,28,74,102,43,11,6,28,45,243,Tristan Da Silva
2024-25,NYK,SG,12,0,82,6,20,.300,5,14,.357,1,6,.167,.425,2,2,1.000,0,13,13,5,1,2,1,5,19,Pacome Dadiet
2022-23,NOP,PG,59,11,1042,87,208,.418,27,86,.314,60,122,.492,.483,26,40,.650,36,152,188,134,43,11,57,99,227,Dyson Daniels
2023-24,NOP,PG,61,16,1358,139,311,.447,42,135,.311,97,176,.551,.514,34,53,.642,62,174,236,164,85,25,59,101,354,Dyson Daniels
2024-25,ATL,SG,29,29,974,158,346,.457,36,110,.327,122,236,.517,.509,26,43,.605,46,101,147,101,90,26,56,73,378,Dyson Daniels
2020-21,CHO,SG,7,0,26,2,7,.286,2,7,.286,0,0,.429,3,3,1.000,1,0,1,1,0,1,1,1,9,0,Nate Darling
2012-13,NOH,PF,64,60,1846,349,676,.516,0,6,.000,349,670,.521,.516,169,225,.751,165,357,522,63,75,112,89,158,867,Anthony Davis
2013-14,NOP,PF,67,66,2358,522,1005,.519,2,9,.222,520,996,.522,.520,348,440,.791,207,466,673,105,89,189,109,200,1394,Anthony Davis
2014-15,NOP,PF,68,68,2455,642,1199,.535,1,12,.083,641,1187,.540,.536,371,461,.805,173,523,696,149,100,200,95,141,1656,Anthony Davis
2015-16,NOP,C,61,61,2164,560,1136,.493,35,108,.324,525,1028,.511,.508,326,430,.758,130,497,627,116,78,125,121,148,1481,Anthony Davis
2016-17,NOP,C,75,75,2708,770,1526,.505,40,134,.299,730,1392,.524,.518,519,647,.802,172,712,884,157,94,167,181,168,2099,Anthony Davis
2017-18,NOP,PF,75,75,2727,780,1462,.534,55,162,.340,725,1300,.558,.552,495,598,.828,187,645,832,174,115,193,162,159,2110,Anthony Davis
2018-19,NOP,C,56,56,1850,530,1026,.517,48,145,.331,482,881,.547,.540,344,433,.794,174,498,672,218,88,135,112,132,1452,Anthony Davis
2019-20,LAL,PF,62,62,2131,551,1096,.503,72,218,.330,479,878,.546,.536,444,525,.846,142,435,577,200,91,143,154,156,1618,Anthony Davis
2020-21,LAL,PF,36,36,1162,301,613,.491,26,100,.260,275,513,.536,.512,158,214,.738,62,224,286,110,45,59,74,60,786,Anthony Davis
2021-22,LAL,C,40,40,1404,370,695,.532,13,70,.186,357,625,.571,.542,174,244,.713,106,288,394,122,49,90,82,97,927,Anthony Davis
2022-23,LAL,C,56,54,1904,542,962,.563,19,74,.257,523,888,.589,.573,348,444,.784,195,507,702,148,59,114,122,146,1451,Anthony Davis
2023-24,LAL,C,76,76,2700,713,1283,.556,29,107,.271,684,1176,.582,.567,421,516,.816,239,722,961,266,91,178,159,177,1876,Anthony Davis
2024-25,LAL,C,29,29,1001,270,519,.520,19,63,.302,251,456,.550,.539,186,241,.772,76,255,331,98,37,61,65,55,745,Anthony Davis
2022-23,WAS,SG,28,5,423,66,171,.386,17,70,.243,49,101,.485,.436,14,27,.519,10,55,65,28,10,8,17,48,163,Johnny Davis
2023-24,WAS,SG,50,6,613,62,154,.403,14,40,.350,48,114,.421,.448,14,24,.583,18,54,72,32,18,10,13,57,152,Johnny Davis
2024-25,WAS,SG,20,0,186,27,58,.466,6,19,.316,21,39,.538,.517,7,11,.636,7,25,32,9,12,6,4,16,67,Johnny Davis
2019-20,TOR,SG,72,4,1209,199,436,.456,94,242,.388,105,194,.541,.564,51,59,.864,50,187,237,115,39,14,76,124,543,Terence Davis
2020-21,2TM,SG,61,4,1074,195,456,.428,98,267,.367,97,189,.513,.535,45,55,.818,20,134,154,83,44,14,63,97,533,Terence Davis
2020-21,TOR,SG,34,4,493,87,210,.414,44,122,.361,43,88,.489,.519,16,18,.889,9,57,66,37,17,7,29,48,234,Terence Davis
2020-21,SAC,SG,27,0,581,108,246,.439,54,145,.372,54,101,.535,.549,29,37,.784,11,77,88,46,27,7,34,49,299,Terence Davis
2021-22,SAC,SG,30,11,536,113,267,.423,49,149,.329,64,118,.542,.515,36,44,.818,11,83,94,40,25,11,33,70,311,Terence Davis
2022-23,SAC,SG,64,5,841,154,364,.423,89,243,.366,65,121,.537,.545,34,43,.791,20,119,139,67,43,12,53,104,431,Terence Davis
2022-23,BOS,SG,12,0,66,8,19,.421,2,7,.286,6,12,.500,.474,1,2,.500,2,7,9,11,2,2,4,5,19,JD Davison
2023-24,BOS,SG,8,0,39,5,12,.417,3,7,.429,2,5,.400,.542,3,4,.750,2,8,10,10,1,1,2,4,16,JD Davison
2024-25,BOS,PG,5,0,24,2,5,.400,1,3,.333,1,2,.500,.500,1,2,.500,0,2,2,1,1,0,6,1,6,JD Davison
2022-23,HOU,SF,4,0,25,5,12,.417,3,10,.300,2,2,1.000,.542,2,2,1.000,1,5,6,1,0,1,0,2,15,Darius Days
2009-10,TOR,SG,77,65,1664,255,512,.498,4,16,.250,251,496,.506,.502,148,194,.763,66,157,223,53,43,18,62,176,662,DeMar DeRozan
2010-11,TOR,SG,82,82,2851,539,1154,.467,5,52,.096,534,1102,.485,.469,327,402,.813,75,240,315,148,85,31,144,217,1410,DeMar DeRozan
2011-12,TOR,SG,63,63,2206,381,903,.422,24,92,.261,357,811,.440,.435,268,331,.810,40,171,211,128,48,17,123,162,1054,DeMar DeRozan
2012-13,TOR,SG,82,82,3013,548,1231,.445,34,120,.283,514,1111,.463,.459,355,427,.831,48,272,320,204,76,24,151,173,1485,DeMar DeRozan
2013-14,TOR,SG,79,79,3017,604,1407,.429,64,210,.305,540,1197,.451,.452,519,630,.824,51,292,343,313,86,28,176,197,1791,DeMar DeRozan
2014-15,TOR,SG,60,60,2100,409,990,.413,25,88,.284,384,902,.426,.426,361,434,.832,41,236,277,210,73,11,137,122,1204,DeMar DeRozan
2015-16,TOR,SG,78,78,2804,614,1377,.446,47,139,.338,567,1238,.458,.463,555,653,.850,64,285,349,315,81,21,175,167,1830,DeMar DeRozan
2016-17,TOR,SG,74,74,2620,721,1545,.467,33,124,.266,688,1421,.484,.477,545,647,.842,70,316,386,290,78,13,180,134,2020,DeMar DeRozan
2017-18,TOR,SG,80,80,2711,645,1413,.456,89,287,.310,556,1126,.494,.488,461,559,.825,59,256,315,417,85,22,175,151,1840,DeMar DeRozan
2018-19,SAS,SG,77,77,2688,631,1313,.481,7,45,.156,624,1268,.492,.483,366,441,.830,54,408,462,475,86,36,199,177,1635,DeMar DeRozan
2019-20,SAS,SF,68,68,2316,557,1049,.531,9,35,.257,548,1014,.540,.535,381,451,.845,44,331,375,380,70,20,164,180,1504,DeMar DeRozan
2020-21,SAS,PF,61,61,2056,455,920,.495,19,74,.257,436,846,.515,.505,387,440,.880,40,219,259,422,56,15,119,128,1316,DeMar DeRozan
2021-22,CHI,PF,76,76,2743,774,1535,.504,50,142,.352,724,1393,.520,.521,520,593,.877,56,336,392,374,68,24,181,178,2118,DeMar DeRozan
2022-23,CHI,SF,74,74,2682,657,1303,.504,46,142,.324,611,1161,.526,.522,456,523,.872,34,309,343,377,83,36,153,186,1816,DeMar DeRozan
2023-24,CHI,SF,79,79,2989,650,1355,.480,75,225,.333,575,1130,.509,.507,522,612,.853,43,297,340,421,90,45,135,161,1897,DeMar DeRozan
2024-25,SAC,SF,26,26,918,197,410,.480,17,55,.309,180,355,.507,.501,128,150,.853,14,85,99,101,38,11,41,50,539,DeMar DeRozan
2013-14,3TM,C,31,6,390,38,83,.458,0,0,,38,83,.458,.458,21,32,.656,38,89,127,5,7,22,18,66,97,Dewayne Dedmon
2013-14,GSW,C,4,0,6,0,1,.000,0,0,,0,1,.000,.000,1,2,.500,0,0,0,0,0,0,0,1,1,Dewayne Dedmon
2013-14,PHI,C,11,0,150,15,29,.517,0,0,,15,29,.517,.517,7,13,.538,11,38,49,3,0,9,9,28,37,Dewayne Dedmon
2013-14,ORL,C,16,6,234,23,53,.434,0,0,,23,53,.434,.434,13,17,.765,27,51,78,2,7,13,9,37,59,Dewayne Dedmon
2014-15,ORL,C,59,15,845,91,162,.562,0,1,.000,91,161,.565,.562,34,64,.531,118,177,295,9,16,50,51,141,216,Dewayne Dedmon
2015-16,ORL,C,58,20,705,99,177,.559,0,0,,99,177,.559,.559,57,76,.750,67,161,228,13,22,46,32,109,255,Dewayne Dedmon
2016-17,SAS,C,76,37,1330,161,259,.622,0,0,,161,259,.622,.622,65,93,.699,129,367,496,44,37,61,61,180,387,Dewayne Dedmon
2017-18,ATL,C,62,46,1542,250,477,.524,50,141,.355,200,336,.595,.577,67,86,.779,100,389,489,90,40,51,86,162,617,Dewayne Dedmon
2018-19,ATL,C,64,52,1609,259,526,.492,83,217,.382,176,309,.570,.571,92,113,.814,105,375,480,90,69,71,84,214,693,Dewayne Dedmon
2019-20,2TM,C,44,18,774,102,255,.400,22,107,.206,80,148,.541,.443,30,36,.833,60,189,249,22,25,41,57,133,256,Dewayne Dedmon
2019-20,SAC,C,34,10,541,69,171,.404,14,71,.197,55,100,.550,.444,23,28,.821,46,121,167,15,15,26,47,93,175,Dewayne Dedmon
2019-20,ATL,C,10,8,233,33,84,.393,8,36,.222,25,48,.521,.440,7,8,.875,14,68,82,7,10,15,10,40,81,Dewayne Dedmon
2020-21,MIA,C,16,0,210,46,65,.708,1,5,.200,45,60,.750,.715,20,27,.741,28,58,86,12,9,6,13,36,113,Dewayne Dedmon
2021-22,MIA,C,67,15,1065,164,290,.566,19,47,.404,145,243,.597,.598,75,100,.750,105,281,386,47,24,42,70,174,422,Dewayne Dedmon
2022-23,2TM,C,38,1,426,77,151,.510,12,39,.308,65,112,.580,.550,33,49,.673,34,100,134,26,9,19,25,75,199,Dewayne Dedmon
2022-23,MIA,C,30,0,350,64,129,.496,11,37,.297,53,92,.576,.539,32,44,.727,28,81,109,16,7,14,19,61,171,Dewayne Dedmon
2022-23,PHI,C,8,1,76,13,22,.591,1,2,.500,12,20,.600,.614,1,5,.200,6,19,25,10,2,5,6,14,28,Dewayne Dedmon
2013-14,CLE,SG,72,4,1271,122,296,.412,57,155,.368,65,141,.461,.508,38,48,.792,29,94,123,187,33,5,60,121,339,Matthew Dellavedova
2014-15,CLE,SG,67,13,1380,111,307,.362,68,167,.407,43,140,.307,.472,29,38,.763,37,89,126,204,24,2,61,152,319,Matthew Dellavedova
2015-16,CLE,PG,76,14,1867,207,511,.405,98,239,.410,109,272,.401,.501,57,66,.864,33,129,162,337,44,9,116,178,569,Matthew Dellavedova
2016-17,MIL,PG,76,54,1986,208,534,.390,79,215,.367,129,319,.404,.463,82,96,.854,24,123,147,357,53,0,133,153,577,Matthew Dellavedova
2017-18,MIL,PG,38,3,712,55,152,.362,29,78,.372,26,74,.351,.457,25,27,.926,14,50,64,145,14,0,49,67,164,Matthew Dellavedova
2018-19,2TM,PG,48,0,812,98,242,.405,44,130,.338,54,112,.482,.496,42,52,.808,6,71,77,181,14,2,68,75,282,Matthew Dellavedova
2018-19,MIL,PG,12,0,97,6,19,.316,4,11,.364,2,8,.250,.421,4,4,1.000,0,10,10,29,2,0,11,9,20,Matthew Dellavedova
2018-19,CLE,PG,36,0,715,92,223,.413,40,119,.336,52,104,.500,.502,38,48,.792,6,61,67,152,12,2,57,66,262,Matthew Dellavedova
2019-20,CLE,PG,57,4,821,62,175,.354,21,91,.231,41,84,.488,.414,32,37,.865,18,57,75,180,20,2,59,78,177,Matthew Dellavedova
2020-21,CLE,PG,13,1,224,14,56,.250,4,25,.160,10,31,.323,.286,4,4,1.000,6,18,24,58,4,1,6,21,36,Matthew Dellavedova
2022-23,SAC,PG,32,0,213,17,50,.340,9,27,.333,8,23,.348,.430,4,7,.571,1,12,13,41,7,0,10,20,47,Matthew Dellavedova
2023-24,DAL,SG,4,0,30,10,19,.526,1,8,.125,9,11,.818,.553,1,3,.333,1,8,9,4,0,1,3,1,22,Dexter Dennis
2018-19,MIL,SG,27,0,411,50,124,.403,22,83,.265,28,41,.683,.492,9,12,.750,16,49,65,31,13,6,19,38,131,Donte DiVincenzo
2019-20,MIL,SG,66,24,1520,232,510,.455,83,247,.336,149,263,.567,.536,63,86,.733,66,252,318,154,85,20,90,113,610,Donte DiVincenzo
2020-21,MIL,SG,66,66,1814,253,603,.420,131,346,.379,122,257,.475,.528,51,71,.718,81,299,380,203,72,15,91,112,688,Donte DiVincenzo
2021-22,2TM,SG,42,1,1006,118,336,.351,74,218,.339,44,118,.373,.461,70,83,.843,40,130,170,118,48,8,72,69,380,Donte DiVincenzo
2021-22,MIL,SG,17,0,341,39,118,.331,21,74,.284,18,44,.409,.419,23,27,.852,18,42,60,29,11,3,28,26,122,Donte DiVincenzo
2021-22,SAC,SG,25,1,665,79,218,.362,53,144,.368,26,74,.351,.484,47,56,.839,22,88,110,89,37,5,44,43,258,Donte DiVincenzo
2022-23,GSW,SG,72,36,1894,235,540,.435,150,378,.397,85,162,.525,.574,58,71,.817,80,245,325,252,97,10,112,133,678,Donte DiVincenzo
2023-24,NYK,SG,81,63,2360,445,1004,.443,283,705,.401,162,299,.542,.584,86,114,.754,63,234,297,216,107,36,113,166,1259,Donte DiVincenzo
2024-25,MIN,SG,30,2,750,97,255,.380,68,195,.349,29,60,.483,.514,20,25,.800,11,86,97,101,36,7,48,44,282,Donte DiVincenzo
2022-23,LAC,C,22,1,195,24,47,.511,1,2,.500,23,45,.511,.521,10,16,.625,31,19,50,4,7,8,9,15,59,Moussa Diabaté
2023-24,LAC,C,11,0,64,10,19,.526,0,0,,10,19,.526,.526,9,14,.643,15,9,24,4,5,1,2,4,29,Moussa Diabaté
2024-25,CHO,C,28,4,515,46,75,.613,0,0,,46,75,.613,.613,11,25,.440,92,107,199,18,17,22,26,50,103,Moussa Diabaté
2020-21,MIL,PF,14,1,141,16,40,.400,1,8,.125,15,32,.469,.413,11,14,.786,8,26,34,8,7,6,3,16,44,Mamadi Diakite
2021-22,OKC,PF,13,3,188,25,47,.532,0,5,.000,25,42,.595,.532,6,11,.545,17,42,59,2,5,9,7,33,56,Mamadi Diakite
2022-23,CLE,C,22,2,176,24,50,.480,7,21,.333,17,29,.586,.550,2,2,1.000,8,22,30,8,4,9,12,26,57,Mamadi Diakite
2023-24,2TM,PF,6,0,24,4,6,.667,0,1,.000,4,5,.800,.667,4,6,.667,1,3,4,2,1,1,1,2,12,Mamadi Diakite
2023-24,SAS,PF,3,0,16,4,5,.800,0,0,,4,5,.800,.800,4,6,.667,1,2,3,2,0,1,0,1,12,Mamadi Diakite
2023-24,NYK,PF,3,0,8,0,1,.000,0,1,.000,0,0,,.000,0,0,,0,1,1,0,1,0,1,1,0,Mamadi Diakite
2016-17,NOP,PF,17,0,199,36,76,.474,0,0,,36,76,.474,.474,15,21,.714,23,50,73,4,4,7,7,17,87,Cheick Diallo
2017-18,NOP,PF,52,0,581,102,176,.580,0,0,,102,176,.580,.580,50,66,.758,47,164,211,19,11,21,28,82,254,Cheick Diallo
2018-19,NOP,PF,64,1,896,168,271,.620,1,4,.250,167,267,.625,.622,50,67,.746,75,257,332,33,29,33,49,113,387,Cheick Diallo
2019-20,PHO,C,47,2,479,92,142,.648,1,3,.333,91,139,.655,.651,34,39,.872,30,101,131,22,11,12,32,55,219,Cheick Diallo
2021-22,DET,C,3,0,31,3,8,.375,0,0,,3,8,.375,.375,5,6,.833,4,8,12,0,1,0,1,6,11,Cheick Diallo
2018-19,OKC,SG,51,3,526,75,165,.455,4,24,.167,71,141,.504,.467,36,59,.610,38,59,97,17,21,10,23,77,190,Hamidou Diallo
2019-20,OKC,SF,46,3,896,132,296,.446,16,57,.281,116,239,.485,.473,38,63,.603,44,123,167,36,37,9,51,101,318,Hamidou Diallo
2020-21,2TM,SF,52,9,1226,224,470,.477,28,82,.341,196,388,.505,.506,128,200,.640,59,213,272,101,41,24,76,134,604,Hamidou Diallo
2020-21,OKC,SG,32,5,761,143,297,.481,12,41,.293,131,256,.512,.502,83,132,.629,37,128,165,77,31,12,49,83,381,Hamidou Diallo
2020-21,DET,SF,20,4,465,81,173,.468,16,41,.390,65,132,.492,.514,45,68,.662,22,85,107,24,10,12,27,51,223,Hamidou Diallo
2021-22,DET,SG,58,29,1269,261,526,.496,23,93,.247,238,433,.550,.518,91,140,.650,69,208,277,73,71,17,58,143,636,Hamidou Diallo
2022-23,DET,SF,56,0,996,215,375,.573,5,21,.238,210,354,.593,.580,87,148,.588,57,137,194,55,53,16,71,124,522,Hamidou Diallo
2023-24,WAS,SG,2,0,5,1,2,.500,0,0,,1,2,.500,.500,0,0,,2,0,2,1,2,0,1,1,2,Hamidou Diallo
2023-24,TOR,SG,60,17,1268,189,445,.425,88,241,.365,101,204,.495,.524,44,51,.863,27,105,132,68,34,2,50,87,510,Gradey Dick
2024-25,TOR,SG,26,26,833,158,375,.421,65,184,.353,93,191,.487,.508,88,99,.889,21,68,89,57,24,6,46,62,469,Gradey Dick
2022-23,OKC,PF,39,1,569,76,181,.420,26,98,.265,50,83,.602,.492,15,23,.652,19,86,105,46,14,7,26,42,193,Ousmane Dieng
2023-24,OKC,PF,33,0,365,49,116,.422,21,70,.300,28,46,.609,.513,14,16,.875,10,41,51,37,8,5,19,22,133,Ousmane Dieng
2024-25,OKC,PF,17,0,189,20,60,.333,9,36,.250,11,24,.458,.408,7,11,.636,9,34,43,13,11,4,4,18,56,Ousmane Dieng
2024-25,MIN,PG,15,0,127,23,51,.451,9,21,.429,14,30,.467,.539,0,0,1,10,11,25,2,0,16,5,55,0,Rob Dillingham
2014-15,DET,PG,34,1,455,51,169,.302,12,65,.185,39,104,.375,.337,31,34,.912,4,44,48,104,19,6,33,53,145,Spencer Dinwiddie
2015-16,DET,PG,12,0,159,19,54,.352,1,10,.100,18,44,.409,.361,19,33,.576,4,13,17,22,3,0,7,20,58,Spencer Dinwiddie
2016-17,BRK,PG,59,18,1334,134,302,.444,38,101,.376,96,201,.478,.507,126,159,.792,27,137,164,185,44,23,66,119,432,Spencer Dinwiddie
2017-18,BRK,PG,80,58,2306,324,838,.387,141,433,.326,183,405,.452,.471,218,268,.813,40,219,259,524,68,23,128,186,1007,Spencer Dinwiddie
2018-19,BRK,PG,68,4,1914,366,828,.442,124,370,.335,242,458,.528,.517,287,356,.806,26,140,166,311,40,17,152,187,1143,Spencer Dinwiddie
2019-20,BRK,PG,64,49,1994,424,1021,.415,123,400,.308,301,621,.485,.476,347,446,.778,32,189,221,432,40,21,174,180,1318,Spencer Dinwiddie
2020-21,BRK,SG,3,3,64,6,16,.375,2,7,.286,4,9,.444,.438,6,6,1.000,0,13,13,9,2,1,5,4,20,Spencer Dinwiddie
2021-22,2TM,PG,67,51,1980,306,735,.416,112,330,.339,194,405,.479,.493,195,252,.774,45,234,279,346,44,13,104,150,919,Spencer Dinwiddie
2021-22,WAS,PG,44,44,1330,185,492,.376,70,226,.310,115,266,.432,.447,116,143,.811,36,171,207,256,27,7,73,107,556,Spencer Dinwiddie
2021-22,DAL,PG,23,7,650,121,243,.498,42,104,.404,79,139,.568,.584,79,109,.725,9,63,72,90,17,6,31,43,363,Spencer Dinwiddie
2022-23,2TM,SG,79,79,2725,460,1050,.438,181,490,.369,279,560,.498,.524,268,330,.812,28,242,270,515,67,24,145,187,1369,Spencer Dinwiddie
2022-23,DAL,SG,53,53,1808,316,694,.455,138,341,.405,178,353,.504,.555,170,207,.821,19,144,163,279,39,16,90,124,940,Spencer Dinwiddie
2022-23,BRK,PG,26,26,917,144,356,.404,43,149,.289,101,207,.488,.465,98,123,.797,9,98,107,236,28,8,55,63,429,Spencer Dinwiddie
2023-24,2TM,PG,76,52,2152,251,640,.392,124,368,.337,127,272,.467,.489,169,210,.805,30,175,205,356,51,22,91,138,795,Spencer Dinwiddie
2023-24,BRK,PG,48,48,1474,195,499,.391,89,278,.320,106,221,.480,.480,125,160,.781,26,132,158,288,38,9,62,86,604,Spencer Dinwiddie
2023-24,LAL,PG,28,4,678,56,141,.397,35,90,.389,21,51,.412,.521,44,50,.880,4,43,47,68,13,13,29,52,191,Spencer Dinwiddie
2024-25,DAL,PG,29,2,630,71,189,.376,35,107,.327,36,82,.439,.468,65,74,.878,6,49,55,94,26,8,24,39,242,Spencer Dinwiddie
2018-19,DAL,SG,72,72,2318,506,1186,.427,168,514,.327,338,672,.503,.497,346,485,.713,86,477,563,429,77,25,247,137,1526,Luka Dončić
2019-20,DAL,PG,61,61,2047,581,1255,.463,171,541,.316,410,714,.574,.531,426,562,.758,78,495,573,538,62,14,260,153,1759,Luka Dončić
2020-21,DAL,PG,66,66,2262,647,1351,.479,192,548,.350,455,803,.567,.550,344,471,.730,54,473,527,567,64,36,281,152,1830,Luka Dončić
2021-22,DAL,PG,65,65,2301,641,1403,.457,201,569,.353,440,834,.528,.529,364,489,.744,56,537,593,568,75,36,292,145,1847,Luka Dončić
2022-23,DAL,PG,66,66,2391,719,1449,.496,185,541,.342,534,908,.588,.560,515,694,.742,54,515,569,529,90,33,236,166,2138,Luka Dončić
2023-24,DAL,PG,70,70,2624,804,1652,.487,284,744,.382,520,908,.573,.573,478,608,.786,59,588,647,686,99,38,282,149,2370,Luka Dončić
2024-25,DAL,PG,22,22,785,216,466,.464,75,212,.354,141,254,.555,.544,112,146,.767,16,167,183,172,44,9,75,58,619,Luka Dončić
2017-18,ATL,SG,56,5,974,144,382,.377,72,199,.362,72,183,.393,.471,45,63,.714,17,113,130,79,17,5,37,63,405,Tyler Dorsey
2018-19,2TM,SG,48,11,698,107,264,.405,44,132,.333,63,132,.477,.489,38,61,.623,27,86,113,56,14,2,27,53,296,Tyler Dorsey
2018-19,ATL,SG,27,0,251,32,89,.360,10,39,.256,22,50,.440,.416,16,26,.615,9,34,43,17,7,1,10,20,90,Tyler Dorsey
2018-19,MEM,SG,21,11,447,75,175,.429,34,93,.366,41,82,.500,.526,22,35,.629,18,52,70,39,7,1,17,33,206,Tyler Dorsey
2022-23,DAL,SF,3,0,8,4,5,.800,1,2,.500,3,3,1.000,.900,0,0,,1,1,2,0,0,0,0,0,9,Tyler Dorsey
2019-20,OKC,SF,36,28,820,86,218,.394,30,101,.297,56,117,.479,.463,42,53,.792,24,57,81,27,31,4,22,97,244,Luguentz Dort
2020-21,OKC,SG,52,52,1543,247,639,.387,113,329,.343,134,310,.432,.475,122,164,.744,38,151,189,88,45,19,79,134,729,Luguentz Dort
2021-22,OKC,SG,51,51,1665,293,726,.404,130,391,.332,163,335,.487,.493,161,191,.843,38,174,212,88,46,18,88,149,877,Luguentz Dort
2022-23,OKC,SF,74,73,2272,339,873,.388,135,409,.330,204,464,.440,.466,200,259,.772,128,216,344,154,75,23,92,243,1013,Luguentz Dort
2023-24,OKC,SF,79,79,2246,288,657,.438,156,396,.394,132,261,.506,.557,128,155,.826,74,210,284,113,72,47,74,228,860,Luguentz Dort
2024-25,OKC,SF,29,29,854,97,240,.404,63,161,.391,34,79,.430,.535,28,35,.800,45,89,134,47,35,23,16,91,285,Luguentz Dort
2021-22,CHI,SG,77,40,2110,278,535,.520,70,186,.376,208,349,.596,.585,53,78,.679,27,187,214,256,60,29,108,182,679,Ayo Dosunmu
2022-23,CHI,SG,80,51,2098,281,570,.493,59,189,.312,222,381,.583,.545,66,82,.805,45,175,220,206,62,26,99,182,687,Ayo Dosunmu
2023-24,CHI,SG,76,37,2212,360,719,.501,119,295,.403,241,424,.568,.583,85,105,.810,54,162,216,242,68,36,103,166,924,Ayo Dosunmu
2024-25,CHI,SG,30,17,924,147,300,.490,40,125,.320,107,175,.611,.557,43,54,.796,18,100,118,145,24,14,40,68,377,Ayo Dosunmu
2020-21,CHI,PG,11,0,50,11,21,.524,1,7,.143,10,14,.714,.548,0,0,,2,3,5,7,4,0,0,3,23,Devon Dotson
2021-22,CHI,PG,11,0,85,11,23,.478,2,9,.222,9,14,.643,.522,5,9,.556,1,8,9,15,1,0,5,11,29,Devon Dotson
2022-23,WAS,PG,6,0,53,1,10,.100,1,4,.250,0,6,.000,.150,0,0,,6,4,10,8,5,0,3,9,3,Devon Dotson
2019-20,DET,PF,38,19,754,92,236,.390,28,98,.286,64,138,.464,.449,31,46,.674,20,98,118,19,20,8,35,80,243,Sekou Doumbouya
2020-21,DET,PF,56,11,869,107,282,.379,26,115,.226,81,167,.485,.426,45,64,.703,39,104,143,47,24,9,44,94,285,Sekou Doumbouya
2021-22,LAL,PF,2,0,16,5,8,.625,1,2,.500,4,6,.667,.688,3,4,.750,2,4,6,0,3,2,2,1,14,Sekou Doumbouya
2021-22,3TM,PG,9,0,108,8,26,.308,1,9,.111,7,17,.412,.327,2,2,1.000,8,10,18,10,5,1,5,5,19,Jeff Dowtin
2021-22,GSW,PG,4,0,28,3,6,.500,0,1,.000,3,5,.600,.500,0,0,,1,6,7,3,0,1,1,2,6,Jeff Dowtin
2021-22,MIL,PG,1,0,3,0,1,.000,0,1,.000,0,0,,.000,0,0,,0,0,0,0,0,0,0,0,0,Jeff Dowtin
2021-22,ORL,PG,4,0,77,5,19,.263,1,7,.143,4,12,.333,.289,2,2,1.000,7,4,11,7,5,0,4,3,13,Jeff Dowtin
2022-23,TOR,PG,25,0,259,25,57,.439,5,16,.313,20,41,.488,.482,6,9,.667,6,17,23,31,9,3,5,13,61,Jeff Dowtin
2023-24,PHI,PG,12,0,142,20,36,.556,9,19,.474,11,17,.647,.681,3,4,.750,3,17,20,27,7,1,5,1,52,Jeff Dowtin
2024-25,PHI,PG,9,0,92,10,24,.417,1,8,.125,9,16,.563,.438,4,5,.800,2,6,8,10,3,1,1,5,25,Jeff Dowtin
2017-18,OKC,PG,2,0,3,1,2,.500,0,0,,1,2,.500,.500,0,0,,0,1,1,0,0,0,1,1,2,PJ Dozier
2018-19,BOS,SG,6,0,51,8,21,.381,2,8,.250,6,13,.462,.429,1,2,.500,6,11,17,5,2,0,0,2,19,PJ Dozier
2019-20,DEN,SG,29,0,412,65,157,.414,17,49,.347,48,108,.444,.468,21,29,.724,10,45,55,63,14,6,27,45,168,PJ Dozier
2020-21,DEN,SG,50,6,1088,148,355,.417,47,149,.315,101,206,.490,.483,42,66,.636,35,147,182,92,31,22,46,86,385,PJ Dozier
2021-22,DEN,SG,18,0,340,36,99,.364,15,48,.313,21,51,.412,.439,10,13,.769,14,49,63,29,11,6,13,33,97,PJ Dozier
2022-23,SAC,SF,16,0,79,10,33,.303,2,16,.125,8,17,.471,.333,0,0,,1,13,14,10,6,1,5,7,22,PJ Dozier
2024-25,MIN,SG,9,0,35,2,3,.667,2,3,.667,0,0,,1.000,1,6,.167,1,4,5,5,1,0,1,3,7,PJ Dozier
2023-24,CHI,SF,4,0,30,4,10,.400,2,6,.333,2,4,.500,.500,1,2,.500,1,3,4,4,2,1,2,6,11,Henri Drell
2012-13,DET,C,60,10,1243,208,342,.608,1,2,.500,207,340,.609,.610,59,159,.371,169,288,457,30,59,95,57,144,476,Andre Drummond
2013-14,DET,C,81,81,2619,479,769,.623,0,2,.000,479,767,.625,.623,137,328,.418,440,631,1071,35,101,131,110,273,1095,Andre Drummond
2014-15,DET,C,82,82,2502,494,961,.514,0,2,.000,494,959,.515,.514,142,365,.389,437,667,1104,55,73,153,120,285,1130,Andre Drummond
2015-16,DET,C,81,81,2666,552,1060,.521,2,6,.333,550,1054,.522,.522,208,586,.355,395,803,1198,67,119,112,155,245,1314,Andre Drummond
2016-17,DET,C,81,81,2409,483,911,.530,2,7,.286,481,904,.532,.531,137,355,.386,345,770,1115,90,124,89,152,237,1105,Andre Drummond
2017-18,DET,C,78,78,2625,466,881,.529,0,11,.000,466,870,.536,.529,239,395,.605,399,848,1247,237,114,127,200,250,1171,Andre Drummond
2018-19,DET,C,79,79,2647,561,1052,.533,5,38,.132,556,1014,.548,.536,243,412,.590,423,809,1232,112,136,138,175,272,1370,Andre Drummond
2019-20,2TM,C,57,56,1879,418,784,.533,5,35,.143,413,749,.551,.536,169,294,.575,250,614,864,152,109,93,203,201,1010,Andre Drummond
2019-20,DET,C,49,48,1654,360,679,.530,1,21,.048,359,658,.546,.531,149,255,.584,226,549,775,138,97,82,174,176,870,Andre Drummond
2019-20,CLE,C,8,8,225,58,105,.552,4,14,.286,54,91,.593,.571,20,39,.513,24,65,89,14,12,11,29,25,140,Andre Drummond
2020-21,2TM,C,46,46,1242,282,572,.493,0,8,.000,282,564,.500,.493,123,205,.600,166,385,551,94,63,49,124,149,687,Andre Drummond
2020-21,CLE,C,25,25,722,180,380,.474,0,8,.000,180,372,.484,.474,77,129,.597,101,236,337,64,40,29,81,69,437,Andre Drummond
2020-21,LAL,C,21,21,520,102,192,.531,0,0,,102,192,.531,.531,46,76,.605,65,149,214,30,23,20,43,80,250,Andre Drummond
2021-22,2TM,C,73,36,1437,247,433,.570,0,3,.000,247,430,.574,.570,86,164,.524,229,451,680,131,78,68,115,192,580,Andre Drummond
2021-22,PHI,C,49,12,902,128,238,.538,0,2,.000,128,236,.542,.538,42,82,.512,136,297,433,97,56,45,79,121,298,Andre Drummond
2021-22,BRK,C,24,24,535,119,195,.610,0,1,.000,119,194,.613,.610,44,82,.537,93,154,247,34,22,23,36,71,282,Andre Drummond
2022-23,CHI,C,67,0,849,166,274,.606,0,3,.000,166,271,.613,.606,67,125,.536,138,306,444,33,45,27,75,117,399,Andre Drummond
2023-24,CHI,C,79,10,1351,267,480,.556,0,3,.000,267,477,.560,.556,129,218,.592,265,443,708,37,73,48,81,140,663,Andre Drummond
2024-25,PHI,C,24,14,463,67,134,.500,1,9,.111,66,125,.528,.504,31,54,.574,67,126,193,12,30,10,40,60,166,Andre Drummond
2021-22,IND,SG,55,39,1541,268,621,.432,94,255,.369,174,366,.475,.507,90,112,.804,41,185,226,114,56,10,90,95,720,Chris Duarte
2022-23,IND,SF,46,12,897,123,333,.369,55,174,.316,68,159,.428,.452,61,72,.847,19,96,115,64,25,9,41,65,362,Chris Duarte
2023-24,SAC,SF,59,11,719,80,210,.381,44,127,.346,36,83,.434,.486,26,33,.788,26,80,106,44,28,8,26,80,230,Chris Duarte
2024-25,CHI,SG,13,0,54,10,20,.500,5,12,.417,5,8,.625,.625,6,8,.750,4,12,16,5,0,0,1,5,31,Chris Duarte
2024-25,OKC,SG,4,0,7,0,3,.000,0,2,.000,0,1,.000,.000,0,0,0,0,0,0,0,0,0,0,0,0,Alex Ducas
2021-22,BRK,PG,22,7,341,39,108,.361,9,37,.243,30,71,.423,.403,17,21,.810,30,37,67,17,14,7,9,36,104,David Duke Jr.
2022-23,BRK,SG,23,0,228,36,78,.462,1,12,.083,35,66,.530,.468,12,17,.706,11,18,29,21,10,1,18,31,85,David Duke Jr.
2023-24,SAS,SG,4,0,51,10,18,.556,3,6,.500,7,12,.583,.639,3,3,1.000,2,8,10,5,2,0,3,4,26,David Duke Jr.
2024-25,SAS,SG,1,0,8,1,4,.250,0,1,.000,1,3,.333,.250,1,2,.500,0,0,0,2,0,0,0,1,3,David Duke Jr.
2016-17,MIN,PG,78,7,1333,118,313,.377,21,73,.288,97,240,.404,.411,36,59,.610,24,142,166,188,78,36,89,178,293,Kris Dunn
2017-18,CHI,PG,52,43,1525,286,666,.429,43,134,.321,243,532,.457,.462,84,114,.737,24,197,221,310,104,27,150,174,699,Kris Dunn
2018-19,CHI,PG,46,44,1389,215,506,.425,34,96,.354,181,410,.441,.458,55,69,.797,19,168,187,277,68,21,104,166,519,Kris Dunn
2019-20,CHI,PG,51,32,1269,152,342,.444,29,112,.259,123,230,.535,.487,40,54,.741,23,163,186,173,101,17,68,158,373,Kris Dunn
2020-21,ATL,PG,4,0,45,1,12,.083,0,2,.000,1,10,.100,.083,3,4,.750,0,6,6,2,2,2,3,10,5,Kris Dunn
2021-22,POR,PG,14,3,336,44,102,.431,1,11,.091,43,91,.473,.436,17,18,.944,9,40,49,79,23,3,32,38,106,Kris Dunn
2022-23,UTA,PG,22,3,568,116,216,.537,17,36,.472,99,180,.550,.576,41,53,.774,9,91,100,124,25,10,35,58,290,Kris Dunn
2023-24,UTA,PG,66,32,1249,147,313,.470,41,111,.369,106,202,.525,.535,22,32,.688,50,139,189,254,68,28,79,135,357,Kris Dunn
2024-25,LAC,PG,31,20,730,88,198,.444,34,100,.340,54,98,.551,.530,6,12,.500,22,90,112,85,54,8,36,79,216,Kris Dunn
2024-25,PHO,SF,26,11,465,60,143,.420,28,91,.308,32,52,.615,.517,5,12,.417,17,51,68,21,15,16,14,59,153,Ryan Dunn
2007-08,SEA,SG,80,80,2768,587,1366,.430,59,205,.288,528,1161,.455,.451,391,448,.873,70,278,348,192,78,75,232,122,1624,Kevin Durant
2008-09,OKC,SF,74,74,2885,661,1390,.476,97,230,.422,564,1160,.486,.510,452,524,.863,77,405,482,205,96,53,225,134,1871,Kevin Durant
2009-10,OKC,SF,82,82,3239,794,1668,.476,128,351,.365,666,1317,.506,.514,756,840,.900,105,518,623,231,112,84,271,171,2472,Kevin Durant
2010-11,OKC,SF,78,78,3038,711,1538,.462,145,414,.350,566,1124,.504,.509,594,675,.880,57,476,533,214,88,76,218,159,2161,Kevin Durant
2011-12,OKC,SF,66,66,2546,643,1297,.496,133,344,.387,510,953,.535,.547,431,501,.860,40,487,527,231,88,77,248,133,1850,Kevin Durant
2012-13,OKC,SF,81,81,3119,731,1433,.510,139,334,.416,592,1099,.539,.559,679,750,.905,46,594,640,374,116,105,280,143,2280,Kevin Durant
2013-14,OKC,SF,81,81,3122,849,1688,.503,192,491,.391,657,1197,.549,.560,703,805,.873,58,540,598,445,103,59,285,174,2593,Kevin Durant
2014-15,OKC,SF,27,27,913,238,467,.510,64,159,.403,174,308,.565,.578,146,171,.854,16,162,178,110,24,25,74,40,686,Kevin Durant
2015-16,OKC,SF,72,72,2578,698,1381,.505,186,481,.387,512,900,.569,.573,447,498,.898,45,544,589,361,69,85,250,137,2029,Kevin Durant
2016-17,GSW,PF,62,62,2070,551,1026,.537,117,312,.375,434,714,.608,.594,336,384,.875,39,474,513,300,66,99,138,117,1555,Kevin Durant
2017-18,GSW,SF,68,68,2325,630,1222,.516,173,413,.419,457,809,.565,.586,359,404,.889,31,433,464,366,50,119,207,133,1792,Kevin Durant
2018-19,GSW,SF,78,78,2702,721,1383,.521,137,388,.353,584,995,.587,.571,448,506,.885,33,464,497,457,58,84,225,155,2027,Kevin Durant
2020-21,BRK,PF,35,32,1157,324,603,.537,85,189,.450,239,414,.577,.608,210,238,.882,13,234,247,195,25,45,120,70,943,Kevin Durant
2021-22,BRK,PF,55,55,2047,578,1115,.518,115,300,.383,463,815,.568,.570,372,409,.910,29,378,407,351,48,52,191,113,1643,Kevin Durant
2022-23,2TM,PF,47,47,1672,483,862,.560,93,230,.404,390,632,.617,.614,307,334,.919,17,296,313,235,34,67,156,99,1366,Kevin Durant
2022-23,BRK,PF,39,39,1403,410,734,.559,71,189,.376,339,545,.622,.607,267,286,.934,14,248,262,207,32,57,136,92,1158,Kevin Durant
2022-23,PHO,PF,8,8,269,73,128,.570,22,41,.537,51,87,.586,.656,40,48,.833,3,48,51,28,2,10,20,7,208,Kevin Durant
2023-24,PHO,PF,75,75,2791,751,1436,.523,168,407,.413,583,1029,.567,.581,362,423,.856,41,454,495,378,69,91,244,133,2032,Kevin Durant
2024-25,PHO,PF,20,20,717,194,377,.515,50,119,.420,144,258,.558,.581,112,133,.842,8,120,128,75,16,23,62,35,550,Kevin Durant
2022-23,DET,C,67,31,1670,258,398,.648,0,2,.000,258,396,.652,.648,96,157,.611,229,366,595,75,44,59,92,182,612,Jalen Duren
2023-24,DET,C,61,60,1777,349,564,.619,0,4,.000,349,560,.623,.619,143,181,.790,192,517,709,147,33,47,129,192,841,Jalen Duren
2024-25,DET,C,28,28,701,104,150,.693,0,0,,104,150,.693,.693,49,80,.613,85,173,258,65,15,33,56,88,257,Jalen Duren
2018-19,MIL,PG,3,0,6,2,3,.667,1,1,1.000,1,2,.500,.833,0,0,0,1,1,2,0,0,0,0,5,0,Trevon Duval
2022-23,HOU,PF,82,5,1767,296,660,.448,59,172,.343,237,488,.486,.493,109,145,.752,195,301,496,88,96,47,101,189,760,Tari Eason
2023-24,HOU,PF,22,0,480,88,189,.466,18,50,.360,70,139,.504,.513,21,33,.636,46,107,153,27,31,19,20,51,215,Tari Eason
2024-25,HOU,PF,24,0,546,105,221,.475,23,73,.315,82,148,.554,.527,37,49,.755,51,100,151,25,46,24,20,59,270,Tari Eason
2024-25,MEM,C,20,14,438,93,154,.604,9,21,.429,84,133,.632,.633,30,47,.638,74,86,160,21,16,23,32,57,225,Zach Edey
2020-21,MIN,SG,72,55,2314,505,1211,.417,171,520,.329,334,691,.483,.488,211,272,.776,59,277,336,211,82,36,160,129,1392,Anthony Edwards
2021-22,MIN,SG,72,72,2466,549,1245,.441,215,602,.357,334,643,.519,.527,220,280,.786,62,281,343,275,105,46,190,164,1533,Anthony Edwards
2022-23,MIN,SG,79,79,2842,707,1541,.459,213,578,.369,494,963,.513,.528,319,422,.756,47,411,458,350,125,58,259,186,1946,Anthony Edwards
2023-24,MIN,SG,79,78,2770,718,1558,.461,190,532,.357,528,1026,.515,.522,423,506,.836,52,378,430,405,101,42,241,141,2049,Anthony Edwards
2024-25,MIN,SG,30,30,1077,270,604,.447,124,295,.420,146,309,.472,.550,94,117,.803,20,146,166,120,40,18,93,58,758,Anthony Edwards
2019-20,BOS,SG,37,0,351,42,128,.328,24,76,.316,18,52,.346,.422,13,19,.684,6,41,47,24,12,4,15,34,121,Carsen Edwards
2020-21,BOS,SG,31,1,276,47,111,.423,18,63,.286,29,48,.604,.505,11,13,.846,3,23,26,14,7,1,7,25,123,Carsen Edwards
2021-22,DET,SG,4,0,79,9,30,.300,4,16,.250,5,14,.357,.367,1,1,1.000,2,4,6,14,2,0,5,4,23,Carsen Edwards
2024-25,PHI,SF,2,0,9,2,3,.667,0,1,.000,2,2,1.000,.667,0,1,.000,0,2,2,1,0,0,0,0,4,Justin Edwards
2021-22,BRK,SF,48,23,987,110,267,.412,48,136,.353,62,131,.473,.502,16,19,.842,44,128,172,31,29,24,42,85,284,Kessler Edwards
2022-23,2TM,SF,36,4,385,36,93,.387,17,55,.309,19,38,.500,.478,11,15,.733,23,38,61,23,14,6,13,40,100,Kessler Edwards
2022-23,BRK,SF,14,1,79,6,24,.250,2,12,.167,4,12,.333,.292,1,2,.500,6,8,14,2,3,1,4,3,15,Kessler Edwards
2022-23,SAC,SF,22,3,306,30,69,.435,15,43,.349,15,26,.577,.543,10,13,.769,17,30,47,21,11,5,9,37,85,Kessler Edwards
2023-24,SAC,SF,54,0,275,34,82,.415,20,52,.385,14,30,.467,.537,5,9,.556,9,33,42,15,10,4,4,26,93,Kessler Edwards
2024-25,DAL,SF,10,0,24,0,6,.000,0,4,.000,0,2,.000,.000,0,0,,0,2,2,1,0,1,1,4,0,Kessler Edwards
2021-22,OKC,SG,2,0,11,1,4,.250,1,4,.250,0,0,.375,0,0,0,3,3,0,0,0,1,0,3,0,,Rob Edwards
2018-19,HOU,SF,2,0,16,1,4,.250,1,4,.250,0,0,.375,0,0,1,1,2,0,0,0,0,0,3,0,,Vince Edwards
2020-21,POR,SF,30,0,192,25,66,.379,7,34,.206,18,32,.563,.432,11,15,.733,11,21,32,10,6,3,5,27,68,CJ Elleby
2021-22,POR,SF,58,28,1174,121,308,.393,37,126,.294,84,182,.462,.453,60,84,.714,66,161,227,87,35,19,56,116,339,CJ Elleby
2022-23,SAC,SG,16,0,71,7,16,.438,6,12,.500,1,4,.250,.625,4,7,.571,4,4,8,6,5,1,1,10,24,Keon Ellis
2023-24,SAC,SG,57,21,978,107,232,.461,70,168,.417,37,64,.578,.612,26,35,.743,32,92,124,85,51,29,37,112,310,Keon Ellis
2024-25,SAC,SG,29,4,577,59,128,.461,37,91,.407,22,37,.595,.605,27,32,.844,22,42,64,31,33,23,23,54,182,Keon Ellis
2016-17,PHI,C,31,31,786,200,429,.466,36,98,.367,164,331,.495,.508,191,244,.783,61,182,243,66,27,76,117,112,627,Joel Embiid
2017-18,PHI,C,63,63,1912,510,1056,.483,66,214,.308,444,842,.527,.514,359,467,.769,143,547,690,199,40,111,234,209,1445,Joel Embiid
2018-19,PHI,C,64,64,2154,580,1199,.484,79,263,.300,501,936,.535,.517,522,649,.804,160,711,871,234,46,122,226,211,1761,Joel Embiid
2019-20,PHI,C,51,51,1506,382,801,.477,57,172,.331,325,629,.517,.512,351,435,.807,141,452,593,152,45,65,159,174,1172,Joel Embiid
2020-21,PHI,C,51,51,1585,461,899,.513,58,154,.377,403,745,.541,.545,471,548,.859,113,426,539,145,50,69,159,123,1451,Joel Embiid
2021-22,PHI,C,68,68,2297,666,1334,.499,93,251,.371,573,1083,.529,.534,654,803,.814,146,650,796,284,77,99,214,181,2079,Joel Embiid
2022-23,PHI,C,66,66,2284,728,1328,.548,66,200,.330,662,1128,.587,.573,661,771,.857,113,557,670,274,66,112,226,205,2183,Joel Embiid
2023-24,PHI,C,39,39,1309,450,851,.529,54,139,.388,396,712,.556,.561,399,452,.883,95,335,430,219,46,66,150,112,1353,Joel Embiid
2024-25,PHI,C,9,9,252,61,142,.430,11,38,.289,50,104,.481,.468,59,62,.952,13,50,63,35,6,8,28,22,192,Joel Embiid
2018-19,SAS,PF,23,0,113,15,26,.577,0,0,,15,26,.577,.577,11,13,.846,6,28,34,7,2,5,8,11,41,Drew Eubanks
2019-20,SAS,C,22,3,272,43,67,.642,1,1,1.000,42,66,.636,.649,20,26,.769,28,57,85,15,5,17,21,37,107,Drew Eubanks
2020-21,SAS,C,54,3,755,116,205,.566,2,2,1.000,114,203,.562,.571,77,106,.726,74,167,241,42,18,49,45,88,311,Drew Eubanks
2021-22,2TM,C,71,31,1245,221,371,.596,5,23,.217,216,348,.621,.602,99,130,.762,130,252,382,85,31,40,81,122,546,Drew Eubanks
2021-22,SAS,C,49,9,595,84,159,.528,1,8,.125,83,151,.550,.531,59,79,.747,64,132,196,50,13,30,46,61,228,Drew Eubanks
2021-22,POR,C,22,22,650,137,212,.646,4,15,.267,133,197,.675,.656,40,51,.784,66,120,186,35,18,10,35,61,318,Drew Eubanks
2022-23,POR,C,78,28,1584,214,334,.641,7,18,.389,207,316,.655,.651,83,125,.664,132,286,418,103,40,102,67,169,518,Drew Eubanks
2023-24,PHO,C,75,6,1169,152,253,.601,3,3,1.000,149,250,.596,.607,72,93,.774,103,219,322,63,27,61,61,115,379,Drew Eubanks
2024-25,UTA,C,23,0,311,44,73,.603,2,4,.500,42,69,.609,.616,19,31,.613,26,64,90,25,5,15,17,27,109,Drew Eubanks
2018-19,GSW,SG,30,1,204,18,53,.340,4,15,.267,14,38,.368,.377,0,1,.000,6,19,25,23,5,3,11,28,40,Jacob Evans
2019-20,2TM,SG,29,1,418,45,134,.336,13,39,.333,32,95,.337,.384,25,29,.862,9,32,41,31,11,12,25,41,128,Jacob Evans
2019-20,GSW,SG,27,1,414,45,133,.338,13,38,.342,32,95,.337,.387,25,29,.862,9,32,41,31,11,12,25,41,128,Jacob Evans
2019-20,MIN,SG,2,0,4,0,1,.000,0,1,.000,0,0,,.000,0,0,,0,0,0,0,0,0,0,0,0,Jacob Evans
2023-24,2TM,SF,17,8,367,36,71,.507,12,32,.375,24,39,.615,.592,17,25,.680,18,42,60,16,6,5,9,23,101,Tosan Evbuomwan
2023-24,MEM,SF,4,0,74,4,15,.267,2,8,.250,2,7,.286,.333,0,0,,8,6,14,6,0,1,1,5,10,Tosan Evbuomwan
2023-24,DET,SF,13,8,293,32,56,.571,10,24,.417,22,32,.688,.661,17,25,.680,10,36,46,10,6,4,8,18,91,Tosan Evbuomwan
2014-15,UTA,PG,82,41,1817,145,416,.349,83,264,.314,62,152,.408,.448,20,32,.625,27,104,131,198,41,14,118,147,393,Dante Exum
2016-17,UTA,PG,66,26,1228,155,363,.427,44,149,.295,111,214,.519,.488,58,73,.795,30,102,132,111,21,12,80,146,412,Dante Exum
2017-18,UTA,PG,14,0,235,42,87,.483,5,18,.278,37,69,.536,.511,25,31,.806,4,22,26,43,8,3,20,20,114,Dante Exum
2018-19,UTA,PG,42,1,664,101,241,.419,18,62,.290,83,179,.464,.456,68,86,.791,16,52,68,110,14,5,52,69,288,Dante Exum
2019-20,2TM,SG,35,1,485,56,119,.471,15,43,.349,41,76,.539,.534,32,43,.744,12,55,67,40,13,8,31,38,159,Dante Exum
2019-20,UTA,SG,11,0,83,10,23,.435,2,6,.333,8,17,.471,.478,2,2,1.000,3,9,12,7,1,2,10,8,24,Dante Exum
2019-20,CLE,SG,24,1,402,46,96,.479,13,37,.351,33,59,.559,.547,30,41,.732,9,46,55,33,12,6,21,30,135,Dante Exum
2020-21,CLE,SG,6,3,116,10,26,.385,2,11,.182,8,15,.533,.423,1,2,.500,2,15,17,13,4,2,7,9,23,Dante Exum
2023-24,DAL,PG,55,17,1088,161,302,.533,53,108,.491,108,194,.557,.621,53,68,.779,25,124,149,157,22,5,49,85,428,Dante Exum
2010-11,2TM,PF,78,27,1535,215,416,.517,0,0,,215,416,.517,.517,103,173,.595,171,241,412,39,29,68,77,246,533,Derrick Favors
2010-11,NJN,PF,56,23,1091,141,276,.511,0,0,,141,276,.511,.511,71,116,.612,126,171,297,21,18,41,56,183,353,Derrick Favors
2010-11,UTA,PF,22,4,444,74,140,.529,0,0,,74,140,.529,.529,32,57,.561,45,70,115,18,11,27,21,63,180,Derrick Favors
2011-12,UTA,PF,65,9,1376,222,445,.499,0,0,,222,445,.499,.499,126,194,.649,158,267,425,43,38,65,103,145,570,Derrick Favors
2012-13,UTA,PF,77,8,1787,274,568,.482,0,5,.000,274,563,.487,.482,179,260,.688,184,362,546,75,67,130,129,247,727,Derrick Favors
2013-14,UTA,PF,73,73,2201,390,747,.522,0,1,.000,390,746,.523,.522,190,284,.669,199,438,637,91,75,108,129,236,970,Derrick Favors
2014-15,UTA,PF,74,74,2280,482,918,.525,1,6,.167,481,912,.527,.526,222,332,.669,196,411,607,112,60,123,121,210,1187,Derrick Favors
2015-16,UTA,PF,62,59,1983,418,811,.515,0,4,.000,418,807,.518,.515,180,254,.709,169,334,503,94,74,91,104,150,1016,Derrick Favors
2016-17,UTA,PF,50,39,1186,203,417,.487,3,10,.300,200,407,.491,.490,67,109,.615,92,213,305,56,45,40,60,103,476,Derrick Favors
2017-18,UTA,C,77,77,2153,395,702,.563,14,63,.222,381,639,.596,.573,140,215,.651,198,354,552,102,54,82,88,164,944,Derrick Favors
2018-19,UTA,C,76,70,1766,363,619,.586,17,78,.218,346,541,.640,.600,154,228,.675,207,353,560,89,56,106,84,163,897,Derrick Favors
2019-20,NOP,C,51,49,1243,209,339,.617,1,7,.143,208,332,.627,.618,40,71,.563,163,338,501,81,30,46,55,107,459,Derrick Favors
2020-21,UTA,C,68,0,1039,155,243,.638,0,2,.000,155,241,.643,.638,59,80,.738,138,238,376,44,32,68,36,143,369,Derrick Favors
2021-22,OKC,C,39,18,653,94,182,.516,2,16,.125,92,166,.554,.522,16,25,.640,58,126,184,25,17,12,9,62,206,Derrick Favors
2019-20,ATL,C,56,13,713,103,199,.518,5,37,.135,98,162,.605,.530,29,51,.569,67,131,198,49,18,17,42,107,240,Bruno Fernando
2020-21,ATL,C,33,0,226,18,44,.409,0,2,.000,18,42,.429,.409,15,22,.682,16,62,78,10,4,3,21,23,51,Bruno Fernando
2021-22,2TM,C,30,0,152,36,55,.655,1,2,.500,35,53,.660,.664,15,24,.625,18,37,55,7,1,11,14,24,88,Bruno Fernando
2021-22,BOS,C,20,0,58,7,14,.500,1,1,1.000,6,13,.462,.536,4,5,.800,7,8,15,4,0,3,5,6,19,Bruno Fernando
2021-22,HOU,C,10,0,94,29,41,.707,0,1,.000,29,40,.725,.707,11,19,.579,11,29,40,3,1,8,9,18,69,Bruno Fernando
2022-23,2TM,C,39,4,405,59,112,.527,0,4,.000,59,108,.546,.527,35,50,.700,54,83,137,31,6,34,25,74,153,Bruno Fernando
2022-23,HOU,C,31,4,364,48,93,.516,0,1,.000,48,92,.522,.516,30,44,.682,48,74,122,30,6,31,20,68,126,Bruno Fernando
2022-23,ATL,C,8,0,41,11,19,.579,0,3,.000,11,16,.688,.579,5,6,.833,6,9,15,1,0,3,5,6,27,Bruno Fernando
2023-24,ATL,C,45,2,682,109,187,.583,0,4,.000,109,183,.596,.583,64,96,.667,59,134,193,46,25,28,44,107,282,Bruno Fernando
2024-25,TOR,C,16,2,143,26,48,.542,0,0,,26,48,.542,.542,6,8,.750,21,29,50,18,4,9,14,26,58,Bruno Fernando
2024-25,UTA,C,19,8,333,45,87,.517,12,35,.343,33,52,.635,.586,20,36,.556,17,66,83,35,9,2,19,35,122,Kyle Filipowski
2016-17,DAL,PF,81,35,1642,124,333,.372,56,191,.293,68,142,.479,.456,46,61,.754,55,167,222,67,52,25,45,125,350,Dorian Finney-Smith
2017-18,DAL,PF,21,13,448,46,121,.380,20,67,.299,26,54,.481,.463,11,15,.733,22,53,75,26,10,4,21,43,123,Dorian Finney-Smith
2018-19,DAL,SF,81,26,1985,228,528,.432,79,254,.311,149,274,.544,.507,73,103,.709,138,251,389,95,69,36,74,186,608,Dorian Finney-Smith
2019-20,DAL,PF,71,68,2120,243,522,.466,114,303,.376,129,219,.589,.575,78,108,.722,145,260,405,114,45,39,69,178,678,Dorian Finney-Smith
2020-21,DAL,PF,60,60,1921,220,466,.472,119,302,.394,101,164,.616,.600,31,41,.756,98,228,326,102,52,25,48,138,590,Dorian Finney-Smith
2021-22,DAL,PF,80,80,2644,326,692,.471,172,435,.395,154,257,.599,.595,56,83,.675,122,253,375,150,88,39,80,183,880,Dorian Finney-Smith
2022-23,2TM,PF,66,66,2009,196,501,.391,114,338,.337,82,163,.503,.505,45,59,.763,114,202,316,100,55,36,62,144,551,Dorian Finney-Smith
2022-23,DAL,PF,40,40,1288,129,310,.416,77,217,.355,52,93,.559,.540,30,40,.750,67,121,188,59,38,20,36,80,365,Dorian Finney-Smith
2022-23,BRK,PF,26,26,721,67,191,.351,37,121,.306,30,70,.429,.448,15,19,.789,47,81,128,41,17,16,26,64,186,Dorian Finney-Smith
2023-24,BRK,PF,68,56,1934,215,511,.421,117,336,.348,98,175,.560,.535,33,46,.717,109,208,317,107,56,38,59,150,580,Dorian Finney-Smith
2024-25,BRK,PF,20,20,579,73,159,.459,47,108,.435,26,51,.510,.607,15,24,.625,31,60,91,31,18,12,18,54,208,Dorian Finney-Smith
2020-21,LAC,PF,3,0,11,1,3,.333,1,2,.500,0,1,.000,.500,0,0,0,3,3,0,0,0,0,3,3,0,Malik Fitts
2021-22,2TM,PF,15,0,63,8,19,.421,5,10,.500,3,9,.333,.553,0,0,2,15,17,5,0,0,2,4,21,0,Malik Fitts
2021-22,UTA,PF,7,0,35,2,9,.222,2,4,.500,0,5,.000,.333,0,0,0,10,10,0,0,0,2,3,6,0,Malik Fitts
2021-22,BOS,PF,8,0,28,6,10,.600,3,6,.500,3,4,.750,.750,0,0,2,5,7,5,0,0,0,1,15,0,Malik Fitts
2023-24,OKC,SG,2,0,14,1,7,.143,1,6,.167,0,1,.000,.214,0,0,0,0,0,4,0,0,0,0,3,0,Adam Flagler
2024-25,OKC,SG,11,0,40,5,20,.250,5,19,.263,0,1,.000,.375,0,0,2,4,6,0,2,0,0,4,15,0,Adam Flagler
2024-25,LAC,SF,1,0,14,4,9,.444,0,2,.000,4,7,.571,.444,1,1,1.000,1,3,4,0,0,0,1,3,9,Trentyn Flowers
2020-21,TOR,PG,47,14,928,127,340,.374,54,168,.321,73,172,.424,.453,45,56,.804,10,106,116,137,38,7,43,68,353,Malachi Flynn
2021-22,TOR,PG,44,5,537,72,183,.393,30,90,.333,42,93,.452,.475,15,24,.625,10,53,63,70,20,4,13,45,189,Malachi Flynn
2022-23,TOR,PG,53,2,691,87,242,.360,47,133,.353,40,109,.367,.457,25,33,.758,15,61,76,70,21,4,25,65,246,Malachi Flynn
2023-24,3TM,PG,69,0,876,136,325,.418,56,169,.331,80,156,.513,.505,52,71,.732,21,93,114,130,38,8,63,66,380,Malachi Flynn
2023-24,TOR,PG,31,0,474,56,137,.409,28,80,.350,28,57,.491,.511,17,22,.773,13,52,65,73,18,6,33,42,157,Malachi Flynn
2023-24,NYK,PG,14,0,60,9,23,.391,4,13,.308,5,10,.500,.478,9,11,.818,0,6,6,6,1,0,3,3,31,Malachi Flynn
2023-24,DET,PG,24,0,342,71,165,.430,24,76,.316,47,89,.528,.503,26,38,.684,8,35,43,51,19,2,27,21,192,Malachi Flynn
2022-23,UTA,SF,52,6,766,115,312,.369,63,191,.330,52,121,.430,.470,35,44,.795,31,55,86,42,15,8,39,62,328,Simone Fontecchio
2023-24,2TM,SF,66,43,1644,252,548,.460,134,334,.401,118,214,.551,.582,54,66,.818,64,182,246,101,44,23,68,110,692,Simone Fontecchio
2023-24,UTA,SF,50,34,1160,161,358,.450,91,233,.391,70,125,.560,.577,32,40,.800,52,124,176,73,30,18,51,81,445,Simone Fontecchio
2023-24,DET,SF,16,9,484,91,190,.479,43,101,.426,48,89,.539,.592,22,26,.846,12,58,70,28,14,5,17,29,247,Simone Fontecchio
2024-25,DET,SF,29,0,523,61,147,.415,34,97,.351,27,50,.540,.531,34,41,.829,16,65,81,25,10,5,24,38,190,Simone Fontecchio
2016-17,SAS,SG,36,0,285,36,99,.364,17,53,.321,19,46,.413,.449,5,6,.833,2,21,23,23,1,0,11,20,94,Bryn Forbes
2017-18,SAS,SG,80,12,1517,209,497,.421,89,228,.390,120,269,.446,.510,48,72,.667,12,98,110,80,28,2,37,108,555,Bryn Forbes
2018-19,SAS,SG,82,81,2293,361,791,.456,176,413,.426,185,378,.489,.568,69,78,.885,18,221,239,175,45,4,80,159,967,Bryn Forbes
2019-20,SAS,SG,63,62,1579,242,581,.417,148,381,.388,94,200,.470,.544,75,90,.833,12,114,126,108,33,0,57,113,707,Bryn Forbes
2020-21,MIL,SG,70,10,1354,250,529,.473,154,341,.452,96,188,.511,.618,47,61,.770,11,101,112,45,24,1,44,77,701,Bryn Forbes
2021-22,2TM,SG,75,2,1286,231,539,.429,122,295,.414,109,244,.447,.542,79,87,.908,10,83,93,75,25,5,56,95,663,Bryn Forbes
2021-22,SAS,SG,40,1,676,128,296,.432,63,151,.417,65,145,.448,.539,44,49,.898,4,59,63,41,17,3,33,42,363,Bryn Forbes
2021-22,DEN,SG,35,1,610,103,243,.424,59,144,.410,44,99,.444,.545,35,38,.921,6,24,30,34,8,2,23,53,300,Bryn Forbes
2022-23,MIN,SG,25,0,268,30,83,.361,14,46,.304,16,37,.432,.446,15,15,1.000,4,11,15,17,7,2,12,22,89,Bryn Forbes
2021-22,ORL,SF,5,0,74,6,20,.300,2,15,.133,4,5,.800,.350,0,0,2,13,15,2,1,0,4,7,14,0,Aleem Ford
2023-24,SAC,PG,6,0,22,4,7,.571,2,3,.667,2,4,.500,.714,2,2,1.000,0,2,2,2,0,0,1,0,12,Jordan Ford
2020-21,UTA,PG,30,0,302,32,71,.451,5,26,.192,27,45,.600,.486,19,19,1.000,11,33,44,45,9,4,21,22,88,Trent Forrest
2021-22,UTA,PG,60,6,765,76,155,.490,5,27,.185,71,128,.555,.506,38,48,.792,23,76,99,106,30,6,48,43,195,Trent Forrest
2022-23,ATL,SG,23,3,277,25,60,.417,0,2,.000,25,58,.431,.417,2,3,.667,5,32,37,38,7,2,15,17,52,Trent Forrest
2023-24,ATL,SG,38,0,414,34,90,.378,2,10,.200,32,80,.400,.389,13,17,.765,11,40,51,92,11,3,20,25,83,Trent Forrest
2012-13,DEN,SG,38,4,428,75,152,.493,22,54,.407,53,98,.541,.566,30,39,.769,6,29,35,44,19,1,32,65,202,Evan Fournier
2013-14,DEN,SG,76,4,1503,228,544,.419,89,237,.376,139,307,.453,.501,93,123,.756,34,168,202,112,34,7,100,179,638,Evan Fournier
2014-15,ORL,SG,58,32,1661,253,575,.440,85,225,.378,168,350,.480,.514,107,147,.728,28,125,153,120,40,2,82,116,698,Evan Fournier
2015-16,ORL,SF,79,71,2566,429,929,.462,156,390,.400,273,539,.506,.546,199,238,.836,33,192,225,213,96,2,133,214,1213,Evan Fournier
2016-17,ORL,SG,68,66,2234,408,930,.439,128,360,.356,280,570,.491,.508,223,277,.805,44,165,209,202,66,4,141,180,1167,Evan Fournier
2017-18,ORL,SF,57,57,1837,368,802,.459,127,335,.379,241,467,.516,.538,150,173,.867,23,157,180,165,47,16,95,138,1013,Evan Fournier
2018-19,ORL,SG,81,81,2553,468,1069,.438,153,450,.340,315,619,.509,.509,137,170,.806,38,220,258,295,71,12,154,225,1226,Evan Fournier
2019-20,ORL,SF,66,66,2076,434,929,.467,173,434,.399,261,495,.527,.560,180,220,.818,18,153,171,209,71,15,125,161,1221,Evan Fournier
2020-21,2TM,SF,42,36,1259,247,541,.457,117,283,.413,130,258,.504,.565,108,137,.788,10,118,128,144,47,19,73,96,719,Evan Fournier
2020-21,ORL,SF,26,26,787,170,369,.461,73,188,.388,97,181,.536,.560,98,123,.797,5,70,75,95,27,9,54,55,511,Evan Fournier
2020-21,BOS,SF,16,10,472,77,172,.448,44,95,.463,33,77,.429,.576,10,14,.714,5,48,53,49,20,10,19,41,208,Evan Fournier
2021-22,NYK,SG,80,80,2358,402,965,.417,241,619,.389,161,346,.465,.541,80,113,.708,34,176,210,171,79,20,105,180,1125,Evan Fournier
2022-23,NYK,SG,27,7,459,56,166,.337,35,114,.307,21,52,.404,.443,18,21,.857,4,45,49,36,16,3,22,46,165,Evan Fournier
2023-24,2TM,SG,32,0,580,79,221,.357,33,130,.254,46,91,.505,.432,29,36,.806,5,53,58,48,29,7,21,48,220,Evan Fournier
2023-24,NYK,SG,3,0,39,4,20,.200,2,15,.133,2,5,.400,.250,2,2,1.000,0,4,4,3,4,0,1,4,12,Evan Fournier
2023-24,DET,SG,29,0,541,75,201,.373,31,115,.270,44,86,.512,.450,27,34,.794,5,49,54,45,25,7,20,44,208,Evan Fournier
2017-18,SAC,PG,73,61,2026,328,797,.412,47,153,.307,281,644,.436,.441,141,195,.723,33,171,204,320,70,20,173,163,844,De'Aaron Fox
2018-19,SAC,PG,81,81,2546,505,1102,.458,86,232,.371,419,870,.482,.497,303,417,.727,43,261,304,590,133,45,227,204,1399,De'Aaron Fox
2019-20,SAC,PG,51,49,1634,391,815,.480,54,185,.292,337,630,.535,.513,241,342,.705,35,161,196,348,74,25,158,145,1077,De'Aaron Fox
2020-21,SAC,PG,58,58,2036,529,1110,.477,103,320,.322,426,790,.539,.523,300,417,.719,33,170,203,417,87,27,174,170,1461,De'Aaron Fox
2021-22,SAC,PG,59,59,2084,516,1092,.473,74,249,.297,442,843,.524,.506,261,348,.750,25,206,231,330,68,25,168,172,1367,De'Aaron Fox
2022-23,SAC,PG,73,73,2435,682,1331,.512,119,367,.324,563,964,.584,.557,343,440,.780,40,266,306,447,83,23,181,172,1826,De'Aaron Fox
2023-24,SAC,PG,74,74,2659,720,1549,.465,214,580,.369,506,969,.522,.534,312,423,.738,67,273,340,418,150,31,194,193,1966,De'Aaron Fox
2024-25,SAC,PG,31,31,1154,300,623,.482,64,193,.332,236,430,.549,.533,149,184,.810,34,122,156,189,49,10,107,84,813,De'Aaron Fox
2018-19,ORL,SG,10,0,44,7,21,.333,0,6,.000,7,15,.467,.333,1,4,.250,3,2,5,1,1,0,1,6,15,Melvin Frazier
2019-20,ORL,SG,19,0,126,15,34,.441,8,16,.500,7,18,.389,.559,2,4,.500,2,8,10,3,9,2,5,11,40,Melvin Frazier
2021-22,OKC,SG,3,0,120,13,48,.271,1,21,.048,12,27,.444,.281,5,7,.714,5,8,13,1,1,0,3,8,32,Melvin Frazier
2024-25,IND,PF,17,1,119,10,22,.455,1,6,.167,9,16,.563,.477,5,9,.556,4,10,14,6,2,2,4,15,26,Enrique Freeman
2023-24,TOR,PG,22,6,403,55,124,.444,10,42,.238,45,82,.549,.484,33,36,.917,16,54,70,40,10,4,25,28,153,Javon Freeman-Liberty
2023-24,2TM,SF,6,0,40,6,15,.400,1,5,.200,5,10,.500,.433,2,2,1.000,4,1,5,0,3,0,2,2,15,Alex Fudge
2023-24,LAL,SF,4,0,14,1,6,.167,0,2,.000,1,4,.250,.167,2,2,1.000,2,0,2,0,0,0,1,1,4,Alex Fudge
2023-24,DAL,SF,2,0,26,5,9,.556,1,3,.333,4,6,.667,.611,0,0,,2,1,3,0,3,0,1,1,11,Alex Fudge
2017-18,PHI,SG,14,0,253,45,111,.405,0,1,.000,45,110,.409,.405,10,21,.476,11,32,43,53,12,4,17,22,100,Markelle Fultz
2018-19,PHI,SG,19,15,427,65,155,.419,4,14,.286,61,141,.433,.432,21,37,.568,26,44,70,59,17,5,25,52,155,Markelle Fultz
2019-20,ORL,PG,72,60,1996,359,772,.465,36,135,.267,323,637,.507,.488,116,159,.730,41,197,238,369,90,11,147,142,870,Markelle Fultz
2020-21,ORL,PG,8,8,215,41,104,.394,4,16,.250,37,88,.420,.413,17,19,.895,5,20,25,43,8,2,18,18,103,Markelle Fultz
2021-22,ORL,PG,18,3,360,83,175,.474,4,17,.235,79,158,.500,.486,25,31,.806,4,45,49,99,20,5,40,22,195,Markelle Fultz
2022-23,ORL,PG,60,60,1778,349,679,.514,27,87,.310,322,592,.544,.534,112,143,.783,69,165,234,341,87,26,139,131,837,Markelle Fultz
2023-24,ORL,PG,43,18,910,154,326,.472,4,18,.222,150,308,.487,.479,23,33,.697,56,82,138,120,42,15,50,65,335,Markelle Fultz
2023-24,CHI,SG,5,0,13,0,4,.000,0,3,.000,0,1,.000,.000,0,0,0,0,0,0,1,1,0,0,0,0,Andrew Funk
2024-25,IND,SG,19,0,205,20,54,.370,11,32,.344,9,22,.409,.472,7,7,1.000,13,16,29,9,8,6,9,19,58,Johnny Furphy
2019-20,2TM,PF,30,1,235,21,48,.438,6,20,.300,15,28,.536,.500,15,22,.682,21,31,52,8,11,7,16,39,63,Wenyen Gabriel
2019-20,SAC,PF,11,0,61,6,17,.353,1,8,.125,5,9,.556,.382,6,10,.600,4,6,10,3,3,2,5,7,19,Wenyen Gabriel
2019-20,POR,PF,19,1,174,15,31,.484,5,12,.417,10,19,.526,.565,9,12,.750,17,25,42,5,8,5,11,32,44,Wenyen Gabriel
2020-21,NOP,PF,21,0,241,24,60,.400,13,32,.406,11,28,.393,.508,11,17,.647,20,34,54,11,9,8,15,32,72,Wenyen Gabriel
2021-22,3TM,PF,26,5,358,54,110,.491,8,28,.286,46,82,.561,.527,25,42,.595,39,58,97,14,5,11,16,68,141,Wenyen Gabriel
2021-22,BRK,PF,1,0,1,0,0,,0,0,,0,0,,,0,0,,0,1,1,0,0,0,0,0,0,Wenyen Gabriel
2021-22,LAC,PF,6,0,46,5,13,.385,2,5,.400,3,8,.375,.462,2,4,.500,5,9,14,2,1,2,3,11,14,Wenyen Gabriel
2021-22,LAL,PF,19,5,311,49,97,.505,6,23,.261,43,74,.581,.536,23,38,.605,34,48,82,12,4,9,13,57,127,Wenyen Gabriel
2022-23,LAL,C,68,2,1024,155,260,.596,10,36,.278,145,224,.647,.615,52,84,.619,116,170,286,36,26,35,46,144,372,Wenyen Gabriel
2023-24,MEM,PF,5,0,81,8,22,.364,1,6,.167,7,16,.438,.386,0,5,.000,7,18,25,3,2,2,8,10,17,Wenyen Gabriel
2019-20,CHI,C,43,7,609,94,134,.701,0,0,,94,134,.701,.701,32,60,.533,52,54,106,21,13,56,29,98,220,Daniel Gafford
2020-21,2TM,C,54,11,791,154,225,.684,0,0,,154,225,.684,.684,72,108,.667,94,137,231,29,26,75,41,98,380,Daniel Gafford
2020-21,CHI,C,31,11,383,60,87,.690,0,0,,60,87,.690,.690,27,41,.659,44,59,103,17,11,34,22,54,147,Daniel Gafford
2020-21,WAS,C,23,0,408,94,138,.681,0,0,,94,138,.681,.681,45,67,.672,50,78,128,12,15,41,19,44,233,Daniel Gafford
2021-22,WAS,C,72,53,1444,285,411,.693,0,1,.000,285,410,.695,.693,107,153,.699,155,252,407,68,30,99,65,170,677,Daniel Gafford
2022-23,WAS,C,78,47,1604,289,395,.732,0,0,,289,395,.732,.732,127,187,.679,163,270,433,84,33,99,85,187,705,Daniel Gafford
2023-24,2TM,PF,74,66,1815,348,480,.725,0,0,,348,480,.725,.725,118,175,.674,195,367,562,115,65,153,74,227,814,Daniel Gafford
2023-24,WAS,C,45,45,1192,203,294,.690,0,0,,203,294,.690,.690,84,119,.706,131,230,361,69,44,97,46,147,490,Daniel Gafford
2023-24,DAL,PF,29,21,623,145,186,.780,0,0,,145,186,.780,.780,34,56,.607,64,137,201,46,21,56,28,80,324,Daniel Gafford
2024-25,DAL,C,30,13,613,150,208,.721,0,0,,150,208,.721,.721,64,95,.674,75,108,183,38,13,36,29,76,364,Daniel Gafford
2008-09,NYK,SG,28,2,412,56,125,.448,32,72,.444,24,53,.453,.576,26,27,.963,13,42,55,15,14,4,15,48,170,Danilo Gallinari
2009-10,NYK,SF,81,74,2747,392,927,.423,186,488,.381,206,439,.469,.523,251,307,.818,65,333,398,135,75,58,110,191,1221,Danilo Gallinari
2010-11,2TM,SF,62,60,2104,265,640,.414,103,293,.352,162,347,.467,.495,337,391,.862,59,246,305,104,51,27,83,144,970,Danilo Gallinari
2010-11,NYK,PF,48,48,1671,211,509,.415,83,239,.347,128,270,.474,.496,259,290,.893,48,181,229,82,38,18,58,117,764,Danilo Gallinari
2010-11,DEN,SF,14,12,433,54,131,.412,20,54,.370,34,77,.442,.489,78,101,.772,11,65,76,22,13,9,25,27,206,Danilo Gallinari
2011-12,DEN,SF,43,40,1351,193,466,.414,60,183,.328,133,283,.470,.479,182,209,.871,28,174,202,116,42,23,68,86,628,Danilo Gallinari
2012-13,DEN,SF,71,71,2309,364,871,.418,135,362,.373,229,509,.450,.495,286,348,.822,65,302,367,176,64,36,111,130,1149,Danilo Gallinari
2014-15,DEN,SF,59,27,1426,228,568,.401,107,301,.355,121,267,.453,.496,171,191,.895,31,187,218,83,47,20,57,94,734,Danilo Gallinari
2015-16,DEN,SF,53,53,1839,287,700,.410,87,239,.364,200,461,.434,.472,375,432,.868,52,229,281,135,42,19,77,87,1036,Danilo Gallinari
2016-17,DEN,SF,63,63,2134,335,750,.447,126,324,.389,209,426,.491,.531,349,387,.902,39,286,325,135,40,15,82,93,1145,Danilo Gallinari
2017-18,LAC,SF,21,21,671,102,256,.398,36,111,.324,66,145,.455,.469,81,87,.931,9,92,101,41,12,10,26,30,321,Danilo Gallinari
2018-19,LAC,SF,68,68,2059,409,884,.463,161,372,.433,248,512,.484,.554,367,406,.904,54,363,417,178,49,23,99,129,1346,Danilo Gallinari
2019-20,OKC,PF,62,62,1834,358,817,.438,178,439,.405,180,378,.476,.547,266,298,.893,34,288,322,119,42,5,76,75,1160,Danilo Gallinari
2020-21,ATL,PF,51,4,1222,206,475,.434,103,254,.406,103,221,.466,.542,161,174,.925,17,194,211,76,30,10,43,105,676,Danilo Gallinari
2021-22,ATL,PF,66,18,1672,259,597,.434,112,294,.381,147,303,.485,.528,141,156,.904,35,273,308,101,28,12,38,93,771,Danilo Gallinari
2023-24,3TM,SF,49,0,630,83,190,.437,30,93,.323,53,97,.546,.516,84,98,.857,20,88,108,55,14,6,23,50,280,Danilo Gallinari
2023-24,WAS,PF,26,0,385,57,131,.435,20,64,.313,37,67,.552,.511,47,56,.839,12,64,76,31,6,3,12,26,181,Danilo Gallinari
2023-24,DET,SF,6,0,90,12,22,.545,7,12,.583,5,10,.500,.705,21,24,.875,2,12,14,12,2,2,1,9,52,Danilo Gallinari
2023-24,MIL,SF,17,0,155,14,37,.378,3,17,.176,11,20,.550,.419,16,18,.889,6,12,18,12,6,1,10,15,47,Danilo Gallinari
2014-15,NYK,PG,45,41,1457,204,511,.399,62,176,.352,142,335,.424,.460,63,78,.808,37,153,190,150,52,12,61,129,533,Langston Galloway
2015-16,NYK,PG,82,7,2033,231,588,.393,77,224,.344,154,364,.423,.458,86,114,.754,43,245,288,207,77,22,61,177,625,Langston Galloway
2016-17,2TM,PG,74,2,1495,207,545,.380,120,308,.390,87,237,.367,.490,51,64,.797,27,129,156,93,46,6,46,96,585,Langston Galloway
2016-17,NOP,PG,55,0,1120,165,441,.374,101,268,.377,64,173,.370,.489,40,52,.769,20,101,121,65,40,5,28,76,471,Langston Galloway
2016-17,SAC,PG,19,2,375,42,104,.404,19,40,.475,23,64,.359,.495,11,12,.917,7,28,35,28,6,1,18,20,114,Langston Galloway
2017-18,DET,SG,58,2,863,126,340,.371,75,218,.344,51,122,.418,.481,33,41,.805,13,79,92,58,35,5,18,39,360,Langston Galloway
2018-19,DET,SG,80,4,1745,228,587,.388,135,380,.355,93,207,.449,.503,81,96,.844,49,122,171,85,37,8,24,135,672,Langston Galloway
2019-20,DET,SG,66,6,1702,236,542,.435,132,331,.399,104,211,.493,.557,73,85,.859,33,116,149,101,48,11,40,96,677,Langston Galloway
2020-21,PHO,SG,40,0,438,66,147,.449,36,85,.424,30,62,.484,.571,22,23,.957,7,35,42,26,8,0,13,25,190,Langston Galloway
2021-22,2TM,SG,7,0,107,6,26,.231,2,16,.125,4,10,.400,.269,0,0,,3,15,18,12,1,0,6,7,14,Langston Galloway
2021-22,BRK,SG,4,0,58,5,13,.385,2,8,.250,3,5,.600,.462,0,0,,1,7,8,5,0,0,5,5,12,Langston Galloway
2021-22,MIL,SG,3,0,49,1,13,.077,0,8,.000,1,5,.200,.077,0,0,,2,8,10,7,1,0,1,2,2,Langston Galloway
2019-20,CLE,SG,59,59,1824,280,699,.401,105,296,.355,175,403,.434,.476,63,72,.875,27,84,111,229,42,4,151,92,728,Darius Garland
2020-21,CLE,PG,54,50,1790,362,802,.451,105,266,.395,257,536,.479,.517,112,132,.848,23,106,129,329,66,6,164,110,941,Darius Garland
2021-22,CLE,PG,68,68,2430,542,1173,.462,174,454,.383,368,719,.512,.536,215,241,.892,39,185,224,583,89,7,248,115,1473,Darius Garland
2022-23,CLE,PG,69,69,2447,522,1129,.462,169,412,.410,353,717,.492,.537,277,321,.863,28,157,185,538,85,9,199,148,1490,Darius Garland
2023-24,CLE,PG,57,57,1901,375,841,.446,132,356,.371,243,485,.501,.524,146,175,.834,30,122,152,373,74,7,176,95,1028,Darius Garland
2024-25,CLE,PG,30,30,900,221,446,.496,89,204,.436,132,242,.545,.595,86,93,.925,16,61,77,193,33,7,73,66,617,Darius Garland
2021-22,MIA,SG,12,0,128,5,21,.238,1,4,.250,4,17,.235,.262,2,5,.400,9,14,23,7,5,3,2,16,13,Marcus Garrett
2021-22,HOU,PF,24,2,240,19,44,.432,5,20,.250,14,24,.583,.489,5,7,.714,21,62,83,17,10,11,6,28,48,Usman Garuba
2022-23,HOU,C,75,1,970,86,177,.486,24,59,.407,62,118,.525,.554,29,47,.617,120,187,307,64,44,29,47,135,225,Usman Garuba
2023-24,GSW,PF,6,0,18,1,6,.167,0,1,.000,1,5,.200,.167,1,2,.500,3,4,7,1,1,3,2,2,3,Usman Garuba
2021-22,DET,C,32,5,389,66,147,.449,16,49,.327,50,98,.510,.503,38,61,.623,58,42,100,20,9,6,18,55,186,Luka Garza
2022-23,MIN,C,28,0,243,63,116,.543,14,39,.359,49,77,.636,.603,41,52,.788,33,30,63,18,3,2,14,43,181,Luka Garza
2023-24,MIN,C,25,0,122,36,75,.480,9,32,.281,27,43,.628,.540,18,25,.720,19,12,31,4,4,1,6,24,99,Luka Garza
2024-25,MIN,C,9,0,46,14,25,.560,2,8,.250,12,17,.706,.600,5,8,.625,4,7,11,1,1,0,3,4,35,Luka Garza
2023-24,NOP,SF,1,0,7,0,4,.000,0,2,.000,0,2,.000,.000,0,0,0,1,1,0,0,0,0,0,0,0,Kaiser Gates
2023-24,UTA,PG,75,44,2023,319,815,.391,147,440,.334,172,375,.459,.482,189,223,.848,15,196,211,332,36,7,188,91,974,Keyonte George
2024-25,UTA,PG,25,25,791,135,343,.394,68,195,.349,67,148,.453,.493,67,83,.807,12,72,84,143,18,5,83,45,405,Keyonte George
2024-25,WAS,SG,23,6,588,57,171,.333,28,113,.248,29,58,.500,.415,22,30,.733,17,75,92,55,17,16,25,68,164,Kyshawn George
2010-11,IND,SG,61,19,1265,179,395,.453,41,138,.297,138,257,.537,.505,77,101,.762,37,187,224,65,62,26,70,127,476,Paul George
2011-12,IND,SG,66,66,1958,281,639,.440,90,234,.385,191,405,.472,.510,146,182,.802,56,314,370,158,108,38,117,191,798,Paul George
2012-13,IND,SF,79,79,2972,493,1176,.419,170,469,.362,323,707,.457,.491,221,274,.807,88,515,603,327,143,51,233,227,1377,Paul George
2013-14,IND,SF,80,80,2898,577,1362,.424,182,500,.364,395,862,.458,.490,401,464,.864,64,478,542,283,151,22,224,198,1737,Paul George
2014-15,IND,SF,6,0,91,18,49,.367,9,22,.409,9,27,.333,.459,8,11,.727,4,18,22,6,5,1,12,11,53,Paul George
2015-16,IND,SF,81,81,2819,605,1449,.418,210,566,.371,395,883,.447,.490,454,528,.860,79,484,563,329,152,29,265,230,1874,Paul George
2016-17,IND,SF,75,75,2689,622,1348,.461,195,496,.393,427,852,.501,.534,336,374,.898,58,434,492,251,119,27,220,206,1775,Paul George
2017-18,OKC,SF,79,79,2891,576,1340,.430,244,609,.401,332,731,.454,.521,338,411,.822,72,375,447,263,161,39,212,233,1734,Paul George
2018-19,OKC,SF,77,77,2841,707,1614,.438,292,757,.386,415,857,.484,.529,453,540,.839,105,523,628,318,170,34,205,214,2159,Paul George
2019-20,LAC,SF,48,48,1419,343,782,.439,157,381,.412,186,401,.464,.539,190,217,.876,24,248,272,185,68,20,125,113,1033,Paul George
2020-21,LAC,SF,54,54,1821,445,953,.467,171,416,.411,274,537,.510,.557,198,228,.868,45,314,359,280,62,24,179,132,1259,Paul George
2021-22,LAC,PF,31,31,1077,268,636,.421,91,257,.354,177,379,.467,.493,127,148,.858,12,201,213,176,67,13,126,74,754,Paul George
2022-23,LAC,SF,56,56,1939,459,1004,.457,158,426,.371,301,578,.521,.536,256,294,.871,45,297,342,288,83,20,176,159,1332,Paul George
2023-24,LAC,PF,74,74,2502,582,1236,.471,243,588,.413,339,648,.523,.569,264,291,.907,37,351,388,262,113,37,153,202,1671,Paul George
2024-25,PHI,PF,18,18,578,103,254,.406,36,116,.310,67,138,.486,.476,45,56,.804,13,89,102,89,33,9,47,38,287,Paul George
2009-10,CHI,PF,82,70,2204,311,629,.494,0,0,,311,629,.494,.494,113,175,.646,226,385,611,70,50,104,114,282,735,Taj Gibson
2010-11,CHI,PF,80,19,1742,234,502,.466,1,8,.125,233,494,.472,.467,100,148,.676,162,296,458,58,39,106,71,203,569,Taj Gibson
2011-12,CHI,PF,63,0,1284,200,404,.495,0,0,,200,404,.495,.495,84,135,.622,135,197,332,47,27,81,60,131,484,Taj Gibson
2012-13,CHI,PF,65,5,1459,214,441,.485,0,4,.000,214,437,.490,.485,89,131,.679,125,220,345,61,27,90,76,166,517,Taj Gibson
2013-14,CHI,PF,82,8,2351,429,896,.479,0,7,.000,429,889,.483,.479,211,281,.751,200,358,558,91,41,112,150,207,1069,Taj Gibson
2014-15,CHI,PF,62,17,1692,254,506,.502,0,0,,254,506,.502,.502,132,184,.717,162,234,396,71,36,75,77,162,640,Taj Gibson
2015-16,CHI,PF,73,55,1936,263,500,.526,0,3,.000,263,497,.529,.526,101,146,.692,206,298,504,106,47,77,78,180,627,Taj Gibson
2016-17,2TM,PF,78,71,1989,365,709,.515,3,13,.231,362,696,.520,.517,113,158,.715,158,327,485,73,41,65,105,163,846,Taj Gibson
2016-17,CHI,PF,55,55,1502,276,530,.521,2,12,.167,274,518,.529,.523,85,119,.714,120,262,382,60,27,50,77,123,639,Taj Gibson
2016-17,OKC,PF,23,16,487,89,179,.497,1,1,1.000,88,178,.494,.500,28,39,.718,38,65,103,13,14,15,28,40,207,Taj Gibson
2017-18,MIN,PF,82,82,2726,425,737,.577,7,35,.200,418,702,.595,.581,142,185,.768,194,390,584,99,62,59,89,218,999,Taj Gibson
2018-19,MIN,PF,70,57,1686,304,537,.566,11,34,.324,293,503,.583,.576,134,177,.757,172,286,458,84,53,39,73,186,753,Taj Gibson
2019-20,NYK,C,62,56,1025,167,286,.584,4,14,.286,163,272,.599,.591,41,56,.732,111,156,267,52,27,30,47,122,379,Taj Gibson
2020-21,NYK,C,45,3,936,99,158,.627,3,15,.200,96,143,.671,.636,40,55,.727,99,151,250,36,31,49,22,99,241,Taj Gibson
2021-22,NYK,C,52,4,946,86,166,.518,15,38,.395,71,128,.555,.563,42,52,.808,88,141,229,32,22,40,27,137,229,Taj Gibson
2022-23,WAS,C,49,2,480,65,125,.520,8,24,.333,57,101,.564,.552,30,42,.714,32,61,93,34,15,12,26,84,168,Taj Gibson
2023-24,2TM,PF,20,1,204,15,37,.405,2,10,.200,13,27,.481,.432,2,2,1.000,12,25,37,11,3,7,5,31,34,Taj Gibson
2023-24,NYK,PF,16,1,165,7,23,.304,0,6,.000,7,17,.412,.304,2,2,1.000,10,18,28,9,2,6,5,28,16,Taj Gibson
2023-24,DET,PF,4,0,39,8,14,.571,2,4,.500,6,10,.600,.643,0,0,,2,7,9,2,1,1,0,3,18,Taj Gibson
2024-25,CHO,C,14,8,151,16,34,.471,1,2,.500,15,32,.469,.485,4,6,.667,21,24,45,7,6,3,9,18,37,Taj Gibson
2021-22,OKC,SF,54,54,1700,281,670,.419,56,213,.263,225,457,.492,.461,56,79,.709,98,323,421,345,51,20,171,88,674,Josh Giddey
2022-23,OKC,PF,76,76,2367,539,1118,.482,76,234,.325,463,884,.524,.516,106,145,.731,148,451,599,469,57,31,211,143,1260,Josh Giddey
2023-24,OKC,SG,80,80,2011,402,847,.475,82,243,.337,320,604,.530,.523,100,124,.806,111,403,514,386,51,44,168,111,986,Josh Giddey
2024-25,CHI,PG,27,27,732,122,270,.452,33,101,.327,89,169,.527,.513,44,62,.710,33,140,173,187,26,12,73,41,321,Josh Giddey
2018-19,SAC,PF,58,0,820,175,348,.503,0,6,.000,175,342,.512,.503,58,91,.637,66,156,222,85,31,22,73,150,408,Harry Giles
2019-20,SAC,C,46,17,667,139,251,.554,0,2,.000,139,249,.558,.554,38,49,.776,43,145,188,60,22,18,44,119,316,Harry Giles
2020-21,POR,C,38,0,348,42,97,.433,8,23,.348,34,74,.459,.474,16,27,.593,31,102,133,29,8,13,20,54,108,Harry Giles
2023-24,2TM,C,23,0,100,23,50,.460,3,14,.214,20,36,.556,.490,7,13,.538,12,18,30,6,2,3,6,15,56,Harry Giles
2023-24,BRK,C,16,0,81,22,44,.500,3,11,.273,19,33,.576,.534,7,13,.538,12,14,26,6,1,3,6,15,54,Harry Giles
2023-24,LAL,C,7,0,19,1,6,.167,0,3,.000,1,3,.333,.167,0,0,,0,4,4,0,1,0,0,0,2,Harry Giles
2018-19,LAC,PG,82,73,2174,341,716,.476,51,139,.367,290,577,.503,.512,156,195,.800,57,175,232,270,96,45,141,175,889,Shai Gilgeous-Alexander
2019-20,OKC,SG,70,70,2428,478,1015,.471,87,251,.347,391,764,.512,.514,288,357,.807,47,365,412,232,79,47,134,117,1331,Shai Gilgeous-Alexander
2020-21,OKC,SG,35,35,1180,287,565,.508,71,170,.418,216,395,.547,.571,185,229,.808,19,147,166,207,27,23,106,70,830,Shai Gilgeous-Alexander
2021-22,OKC,PG,56,56,1942,477,1052,.453,89,297,.300,388,755,.514,.496,328,405,.810,37,241,278,331,71,46,154,142,1371,Shai Gilgeous-Alexander
2022-23,OKC,PG,68,68,2416,704,1381,.510,58,168,.345,646,1213,.533,.531,669,739,.905,59,270,329,371,112,65,192,192,2135,Shai Gilgeous-Alexander
2023-24,OKC,PG,75,75,2553,796,1487,.535,95,269,.353,701,1218,.576,.567,567,649,.874,65,350,415,465,150,67,162,184,2254,Shai Gilgeous-Alexander
2024-25,OKC,PG,29,29,1008,317,614,.516,64,181,.354,253,433,.584,.568,205,233,.880,25,139,164,178,57,32,76,62,903,Shai Gilgeous-Alexander
2020-21,WAS,PF,26,4,218,30,60,.500,7,24,.292,23,36,.639,.558,13,16,.813,16,35,51,11,10,4,8,27,80,Anthony Gill
2021-22,WAS,PF,44,0,463,62,109,.569,14,26,.538,48,83,.578,.633,42,52,.808,33,52,85,27,5,11,18,58,180,Anthony Gill
2022-23,WAS,PF,59,8,624,71,132,.538,4,29,.138,67,103,.650,.553,49,67,.731,37,62,99,34,7,12,15,70,195,Anthony Gill
2023-24,WAS,PF,50,3,466,75,160,.469,10,41,.244,65,119,.546,.500,29,36,.806,37,57,94,34,13,11,23,48,189,Anthony Gill
2024-25,WAS,PF,20,0,149,17,34,.500,4,12,.333,13,22,.591,.559,10,18,.556,5,20,25,6,5,1,5,12,48,Anthony Gill
2023-24,DEN,PG,24,0,225,32,69,.464,15,38,.395,17,31,.548,.572,8,12,.667,1,20,21,27,13,0,14,24,87,Collin Gillespie
2024-25,PHO,PG,1,0,3,1,2,.500,1,1,1.000,0,1,.000,.750,0,0,,0,0,0,0,0,0,0,0,3,Collin Gillespie
2022-23,MEM,PG,1,0,41,1,3,.333,1,3,.333,0,0,,.500,0,0,,0,4,4,7,3,0,2,3,3,Jacob Gilyard
2023-24,2TM,PG,41,14,699,60,150,.400,51,126,.405,9,24,.375,.570,2,2,1.000,9,37,46,137,33,5,30,39,173,Jacob Gilyard
2023-24,MEM,PG,37,14,654,60,144,.417,51,120,.425,9,24,.375,.594,2,2,1.000,8,35,43,131,27,5,29,35,173,Jacob Gilyard
2023-24,BRK,PG,4,0,45,0,6,.000,0,6,.000,0,0,,.000,0,0,,1,2,3,6,6,0,1,4,0,Jacob Gilyard
2013-14,UTA,C,45,0,434,36,74,.486,0,0,,36,74,.486,.486,32,65,.492,51,104,155,7,8,41,32,57,104,Rudy Gobert
2014-15,UTA,C,82,37,2158,258,427,.604,0,2,.000,258,425,.607,.604,170,273,.623,265,510,775,109,64,189,111,175,686,Rudy Gobert
2015-16,UTA,C,61,60,1932,198,354,.559,0,0,,198,354,.559,.559,161,283,.569,208,460,668,91,45,135,114,163,557,Rudy Gobert
2016-17,UTA,C,81,81,2744,413,625,.661,0,1,.000,413,624,.662,.661,311,476,.653,314,721,1035,97,49,214,147,246,1137,Rudy Gobert
2017-18,UTA,C,56,56,1816,276,444,.622,0,0,,276,444,.622,.622,204,299,.682,165,436,601,80,44,129,107,153,756,Rudy Gobert
2018-19,UTA,C,81,80,2577,476,712,.669,0,0,,476,712,.669,.669,332,522,.636,309,732,1041,161,66,187,130,231,1284,Rudy Gobert
2019-20,UTA,C,68,68,2333,386,557,.693,0,0,,386,557,.693,.693,254,403,.630,230,686,916,101,51,135,130,215,1026,Rudy Gobert
2020-21,UTA,C,71,71,2187,391,579,.675,0,4,.000,391,575,.680,.675,233,374,.623,240,720,960,89,40,190,118,163,1015,Rudy Gobert
2021-22,UTA,C,66,66,2120,362,508,.713,0,4,.000,362,504,.718,.713,303,439,.690,241,727,968,72,45,137,119,176,1027,Rudy Gobert
2022-23,MIN,C,70,70,2148,360,546,.659,0,3,.000,360,543,.663,.659,219,340,.644,231,583,814,87,56,95,122,210,939,Rudy Gobert
2023-24,MIN,C,76,76,2593,406,614,.661,0,3,.000,406,611,.664,.661,249,390,.638,285,697,982,102,52,162,118,238,1061,Rudy Gobert
2024-25,MIN,C,30,30,1016,118,183,.645,0,0,,118,183,.645,.645,73,104,.702,96,220,316,52,22,42,46,78,309,Rudy Gobert
2018-19,DEN,PG,16,0,57,6,23,.261,2,6,.333,4,17,.235,.304,9,11,.818,1,2,3,14,0,0,3,7,23,Brandon Goodwin
2019-20,ATL,PG,34,1,430,76,190,.400,26,87,.299,50,103,.485,.468,28,30,.933,11,61,72,51,12,4,29,43,206,Brandon Goodwin
2020-21,ATL,PG,47,5,620,84,223,.377,32,103,.311,52,120,.433,.448,28,43,.651,8,61,69,95,17,0,36,41,228,Brandon Goodwin
2021-22,CLE,PG,36,5,502,64,154,.416,19,55,.345,45,99,.455,.477,24,38,.632,14,53,67,91,25,1,36,39,171,Brandon Goodwin
2021-22,WAS,SG,2,0,6,0,3,.000,0,1,.000,0,2,.000,.000,0,0,,0,1,1,0,0,0,0,1,0,Jordan Goodwin
2022-23,WAS,PG,62,7,1106,158,353,.448,38,118,.322,120,235,.511,.501,53,69,.768,57,148,205,168,58,26,57,95,407,Jordan Goodwin
2023-24,2TM,PG,57,12,1055,141,382,.369,42,141,.298,99,241,.411,.424,44,59,.746,88,165,253,155,48,18,56,76,368,Jordan Goodwin
2023-24,PHO,PG,40,0,558,75,193,.389,23,80,.288,52,113,.460,.448,25,29,.862,40,77,117,78,23,9,29,43,198,Jordan Goodwin
2023-24,MEM,PG,17,12,497,66,189,.349,19,61,.311,47,128,.367,.399,19,30,.633,48,88,136,77,25,9,27,33,170,Jordan Goodwin
2014-15,ORL,PF,47,8,797,93,208,.447,13,48,.271,80,160,.500,.478,44,61,.721,46,123,169,33,21,22,38,83,243,Aaron Gordon
2015-16,ORL,PF,78,37,1863,274,579,.473,42,142,.296,232,437,.531,.509,129,193,.668,154,353,507,128,59,55,66,153,719,Aaron Gordon
2016-17,ORL,SF,80,72,2298,393,865,.454,77,267,.288,316,598,.528,.499,156,217,.719,116,289,405,150,65,40,89,172,1019,Aaron Gordon
2017-18,ORL,PF,58,57,1909,375,865,.434,115,342,.336,260,523,.497,.500,157,225,.698,87,370,457,136,59,45,107,111,1022,Aaron Gordon
2018-19,ORL,PF,78,78,2633,470,1046,.449,121,347,.349,349,699,.499,.507,185,253,.731,129,445,574,289,57,56,162,172,1246,Aaron Gordon
2019-20,ORL,PF,62,62,2017,335,767,.437,73,237,.308,262,530,.494,.484,151,224,.674,107,368,475,228,51,39,100,125,894,Aaron Gordon
2020-21,2TM,PF,50,50,1384,231,499,.463,59,176,.335,172,323,.533,.522,97,149,.651,77,207,284,161,33,34,97,89,618,Aaron Gordon
2020-21,ORL,PF,25,25,736,128,293,.437,42,112,.375,86,181,.475,.509,66,105,.629,39,127,166,105,16,20,67,49,364,Aaron Gordon
2020-21,DEN,PF,25,25,648,103,206,.500,17,64,.266,86,142,.606,.541,31,44,.705,38,80,118,56,17,14,30,40,254,Aaron Gordon
2021-22,DEN,PF,75,75,2376,434,834,.520,87,260,.335,347,574,.605,.573,171,230,.743,125,314,439,188,44,44,133,148,1126,Aaron Gordon
2022-23,DEN,PF,68,68,2055,429,761,.564,60,173,.347,369,588,.628,.603,191,314,.608,164,282,446,203,54,51,98,129,1109,Aaron Gordon
2023-24,DEN,PF,73,73,2297,398,716,.556,40,138,.290,358,578,.619,.584,177,269,.658,174,297,471,259,56,45,105,142,1013,Aaron Gordon
2024-25,DEN,PF,17,16,489,81,155,.523,22,50,.440,59,105,.562,.594,49,65,.754,32,66,98,52,8,3,23,31,233,Aaron Gordon
2008-09,LAC,SG,78,65,2677,411,901,.456,131,337,.389,280,564,.496,.529,299,350,.854,45,156,201,215,78,35,164,172,1252,Eric Gordon
2009-10,LAC,SG,62,60,2229,352,784,.449,119,321,.371,233,463,.503,.525,222,299,.742,25,135,160,186,69,14,144,96,1045,Eric Gordon
2010-11,LAC,SG,56,56,2112,427,949,.450,106,291,.364,321,658,.488,.506,287,348,.825,45,119,164,244,71,18,151,115,1247,Eric Gordon
2011-12,NOH,SG,9,9,310,63,140,.450,10,40,.250,53,100,.530,.486,49,65,.754,2,23,25,31,13,4,24,20,185,Eric Gordon
2012-13,NOH,SG,42,40,1264,235,584,.402,56,173,.324,179,411,.436,.450,187,222,.842,10,67,77,137,45,8,117,75,713,Eric Gordon
2013-14,NOP,SG,64,64,2057,356,817,.436,101,258,.391,255,559,.456,.498,175,223,.785,30,135,165,208,74,12,134,114,988,Eric Gordon
2014-15,NOP,SG,61,60,2018,285,694,.411,141,315,.448,144,379,.380,.512,107,133,.805,28,131,159,229,50,14,122,145,818,Eric Gordon
2015-16,NOP,SG,45,44,1481,231,552,.418,113,294,.384,118,258,.457,.521,111,125,.888,10,89,99,121,43,14,73,98,686,Eric Gordon
2016-17,HOU,SG,75,15,2323,412,1016,.406,246,661,.372,166,355,.468,.527,147,175,.840,29,172,201,188,48,41,121,150,1217,Eric Gordon
2017-18,HOU,SG,69,30,2154,415,970,.428,218,608,.359,197,362,.544,.540,195,241,.809,25,145,170,154,44,27,130,116,1243,Eric Gordon
2018-19,HOU,SG,68,53,2158,384,938,.409,216,600,.360,168,338,.497,.525,119,152,.783,17,131,148,129,41,27,90,143,1103,Eric Gordon
2019-20,HOU,SF,36,15,1016,171,463,.369,96,303,.317,75,160,.469,.473,82,107,.766,9,62,71,54,23,13,43,70,520,Eric Gordon
2020-21,HOU,SG,27,13,789,159,367,.433,69,210,.329,90,157,.573,.527,94,114,.825,8,50,58,71,14,13,51,44,481,Eric Gordon
2021-22,HOU,SG,57,46,1670,268,564,.475,124,301,.412,144,263,.548,.585,105,135,.778,15,98,113,154,28,18,107,63,765,Eric Gordon
2022-23,2TM,SG,69,58,1965,291,653,.446,132,356,.371,159,297,.535,.547,142,173,.821,16,118,134,183,43,25,104,78,856,Eric Gordon
2022-23,HOU,SG,47,47,1418,210,478,.439,85,245,.347,125,233,.536,.528,110,135,.815,12,85,97,136,30,17,83,45,615,Eric Gordon
2022-23,LAC,SG,22,11,547,81,175,.463,47,111,.423,34,64,.531,.597,32,38,.842,4,33,37,47,13,8,21,33,241,Eric Gordon
2023-24,PHO,SG,68,24,1893,274,618,.443,150,397,.378,124,221,.561,.565,51,64,.797,16,106,122,139,66,30,73,79,749,Eric Gordon
2024-25,PHI,SG,19,1,316,32,89,.360,14,51,.275,18,38,.474,.438,17,22,.773,3,15,18,24,13,5,14,13,95,Eric Gordon
2024-25,DAL,PG,11,0,36,6,15,.400,3,7,.429,3,8,.375,.500,1,2,.500,1,2,3,3,1,1,2,5,16,Jazian Gortman
2018-19,CHO,PG,46,3,676,74,216,.343,34,121,.281,40,95,.421,.421,35,46,.761,10,53,63,121,23,2,30,48,217,Devonte' Graham
2019-20,CHO,PG,63,53,2211,368,963,.382,218,585,.373,150,378,.397,.495,191,233,.820,42,170,212,471,62,15,181,115,1145,Devonte' Graham
2020-21,CHO,PG,55,44,1659,252,669,.377,179,477,.375,73,192,.380,.510,133,158,.842,22,126,148,295,48,6,84,77,816,Devonte' Graham
2021-22,NOP,PG,76,63,2162,296,815,.363,192,563,.341,104,252,.413,.481,118,140,.843,37,140,177,316,71,12,105,95,902,Devonte' Graham
2022-23,2TM,PG,73,8,1338,161,431,.374,119,338,.352,42,93,.452,.512,98,131,.748,19,103,122,196,45,16,53,79,539,Devonte' Graham
2022-23,NOP,PG,53,0,811,85,231,.368,66,190,.347,19,41,.463,.511,44,59,.746,12,60,72,116,30,10,27,48,280,Devonte' Graham
2022-23,SAS,PG,20,8,527,76,200,.380,53,148,.358,23,52,.442,.513,54,72,.750,7,43,50,80,15,6,26,31,259,Devonte' Graham
2023-24,SAS,PG,23,0,313,38,108,.352,25,83,.301,13,25,.520,.468,13,16,.813,5,31,36,49,9,2,17,14,114,Devonte' Graham
2016-17,CHO,SG,27,1,189,19,40,.475,9,15,.600,10,25,.400,.588,10,15,.667,5,17,22,6,6,1,3,18,57,Treveon Graham
2017-18,CHO,SG,63,2,1050,96,221,.434,40,97,.412,56,124,.452,.525,41,59,.695,42,79,121,59,33,2,27,109,273,Treveon Graham
2018-19,BRK,SG,35,21,715,64,191,.335,38,128,.297,26,63,.413,.435,18,22,.818,23,84,107,34,13,7,17,68,184,Treveon Graham
2019-20,2TM,SF,55,20,929,87,242,.360,33,120,.275,54,122,.443,.428,36,56,.643,51,99,150,45,24,6,29,102,243,Treveon Graham
2019-20,MIN,SF,33,20,663,62,175,.354,20,83,.241,42,92,.457,.411,27,37,.730,29,71,100,30,17,2,19,66,171,Treveon Graham
2019-20,ATL,SF,22,0,266,25,67,.373,13,37,.351,12,30,.400,.470,9,19,.474,22,28,50,15,7,4,10,36,72,Treveon Graham
2014-15,PHI,SF,65,11,1377,124,352,.352,49,156,.314,75,196,.383,.422,114,193,.591,49,149,198,79,40,68,85,144,411,Jerami Grant
2015-16,PHI,PF,77,52,2066,251,599,.419,35,146,.240,216,453,.477,.448,212,322,.658,99,262,361,135,54,127,110,215,749,Jerami Grant
2016-17,2TM,PF,80,4,1531,152,328,.463,43,116,.371,109,212,.514,.529,90,147,.612,38,167,205,46,33,79,44,149,437,Jerami Grant
2016-17,PHI,PF,2,0,41,6,17,.353,0,2,.000,6,15,.400,.353,4,8,.500,0,6,6,0,0,4,3,5,16,Jerami Grant
2016-17,OKC,PF,78,4,1490,146,311,.469,43,114,.377,103,197,.523,.539,86,139,.619,38,161,199,46,33,75,41,144,421,Jerami Grant
2017-18,OKC,PF,81,1,1647,244,456,.535,32,110,.291,212,346,.613,.570,162,240,.675,86,233,319,57,31,77,54,155,682,Jerami Grant
2018-19,OKC,PF,80,77,2612,409,823,.497,115,293,.392,294,530,.555,.567,157,221,.710,96,321,417,79,61,100,67,214,1090,Jerami Grant
2019-20,DEN,PF,71,24,1892,303,634,.478,98,252,.389,205,382,.537,.555,147,196,.750,58,190,248,88,50,57,63,154,851,Jerami Grant
2020-21,DET,SF,54,54,1829,400,932,.429,115,329,.350,285,603,.473,.491,290,343,.845,35,215,250,152,35,58,109,125,1205,Jerami Grant
2021-22,DET,PF,47,47,1500,298,699,.426,91,254,.358,207,445,.465,.491,217,259,.838,28,163,191,111,44,49,85,107,904,Jerami Grant
2022-23,POR,PF,63,63,2246,434,913,.475,144,359,.401,290,554,.523,.554,278,342,.813,53,230,283,150,51,53,116,152,1290,Jerami Grant
2023-24,POR,PF,54,54,1830,383,850,.451,111,276,.402,272,574,.474,.516,255,312,.817,37,154,191,152,45,34,116,117,1132,Jerami Grant
2024-25,POR,PF,28,28,906,137,360,.381,68,182,.374,69,178,.388,.475,79,96,.823,13,83,96,65,25,27,41,63,421,Jerami Grant
2021-22,ORL,PG,8,3,171,18,38,.474,11,26,.423,7,12,.583,.618,3,4,.750,1,20,21,20,5,1,9,13,50,Hassani Gravett
2022-23,BRK,PF,1,0,35,6,12,.500,2,5,.400,4,7,.571,.583,2,2,1.000,3,6,9,7,0,1,4,5,16,RaiQuan Gray
2023-24,SAS,PF,3,0,39,10,17,.588,3,7,.429,7,10,.700,.676,0,0,,2,5,7,6,1,1,1,0,23,RaiQuan Gray
2022-23,MIL,SG,35,1,345,53,125,.424,44,105,.419,9,20,.450,.600,4,4,1.000,6,39,45,22,6,0,9,31,154,A.J. Green
2023-24,MIL,SG,56,0,614,83,196,.423,69,169,.408,14,27,.519,.599,17,19,.895,9,55,64,30,9,4,12,49,252,A.J. Green
2024-25,MIL,SG,28,4,608,73,163,.448,64,145,.441,9,18,.500,.644,8,9,.889,5,59,64,38,15,3,18,55,218,A.J. Green
2012-13,GSW,SF,79,1,1061,84,257,.327,14,67,.209,70,190,.368,.354,45,55,.818,58,202,260,53,42,25,51,159,227,Draymond Green
2013-14,GSW,SF,82,12,1797,187,459,.407,55,165,.333,132,294,.449,.467,82,123,.667,86,323,409,152,102,72,91,231,511,Draymond Green
2014-15,GSW,PF,79,79,2490,339,765,.443,111,329,.337,228,436,.523,.516,132,200,.660,114,533,647,291,123,99,133,253,921,Draymond Green
2015-16,GSW,PF,81,81,2808,401,819,.490,100,258,.388,301,561,.537,.551,229,329,.696,134,635,769,598,119,113,259,240,1131,Draymond Green
2016-17,GSW,PF,76,76,2471,272,650,.418,81,263,.308,191,387,.494,.481,151,213,.709,98,501,599,533,154,106,184,217,776,Draymond Green
2017-18,GSW,PF,70,70,2287,281,619,.454,77,256,.301,204,363,.562,.516,134,173,.775,75,460,535,508,95,91,202,185,773,Draymond Green
2018-19,GSW,PF,66,66,2065,188,422,.445,47,165,.285,141,257,.549,.501,63,91,.692,60,421,481,454,95,70,169,197,486,Draymond Green
2019-20,GSW,PF,43,43,1222,123,316,.389,36,129,.279,87,187,.465,.446,63,83,.759,23,243,266,266,59,33,98,110,345,Draymond Green
2020-21,GSW,PF,63,63,1982,170,380,.447,34,126,.270,136,254,.535,.492,70,88,.795,55,394,449,558,105,52,188,194,444,Draymond Green
2021-22,GSW,PF,46,44,1329,135,257,.525,16,54,.296,119,203,.586,.556,60,91,.659,45,291,336,320,61,50,139,136,346,Draymond Green
2022-23,GSW,PF,73,73,2297,250,474,.527,40,131,.305,210,343,.612,.570,77,108,.713,66,459,525,500,74,60,204,229,617,Draymond Green
2023-24,GSW,PF,55,52,1490,185,372,.497,51,129,.395,134,243,.551,.566,54,74,.730,76,322,398,332,55,47,135,166,475,Draymond Green
2024-25,GSW,PF,26,24,737,74,178,.416,37,99,.374,37,79,.468,.520,35,57,.614,26,134,160,146,27,27,65,86,220,Draymond Green
2021-22,HOU,SG,67,67,2138,406,954,.426,157,458,.343,249,496,.502,.508,188,236,.797,33,193,226,176,44,18,135,103,1157,Jalen Green
2022-23,HOU,SG,76,76,2602,566,1359,.416,187,554,.338,379,805,.471,.485,364,463,.786,43,241,284,281,59,18,200,131,1683,Jalen Green
2023-24,HOU,SG,82,82,2601,563,1332,.423,201,605,.332,362,727,.498,.498,283,352,.804,41,382,423,291,66,28,191,115,1610,Jalen Green
2024-25,HOU,SG,31,31,1006,208,506,.411,78,239,.326,130,267,.487,.488,105,122,.861,15,124,139,82,32,8,78,50,599,Jalen Green
2014-15,2TM,PF,24,1,164,27,47,.574,0,6,.000,27,41,.659,.574,8,10,.800,19,26,45,4,5,5,14,25,62,JaMychal Green
2014-15,SAS,PF,4,0,25,4,7,.571,0,2,.000,4,5,.800,.571,0,0,,3,3,6,0,0,2,2,6,8,JaMychal Green
2014-15,MEM,PF,20,1,139,23,40,.575,0,4,.000,23,36,.639,.575,8,10,.800,16,23,39,4,5,3,12,19,54,JaMychal Green
2015-16,MEM,PF,78,15,1446,230,495,.465,15,45,.333,215,450,.478,.480,103,137,.752,139,234,373,67,46,33,83,189,578,JaMychal Green
2016-17,MEM,PF,77,75,2101,250,500,.500,55,145,.379,195,355,.549,.555,134,167,.802,167,377,544,84,47,34,94,248,689,JaMychal Green
2017-18,MEM,PF,55,54,1542,223,488,.457,43,127,.339,180,361,.499,.501,80,111,.721,147,317,464,79,32,25,76,153,569,JaMychal Green
2018-19,2TM,PF,65,6,1371,230,476,.483,71,176,.403,159,300,.530,.558,80,101,.792,104,305,409,50,45,34,87,193,611,JaMychal Green
2018-19,MEM,PF,41,4,900,151,312,.484,38,96,.396,113,216,.523,.545,63,80,.788,72,180,252,36,33,26,64,123,403,JaMychal Green
2018-19,LAC,PF,24,2,471,79,164,.482,33,80,.413,46,84,.548,.582,17,21,.810,32,125,157,14,12,8,23,70,208,JaMychal Green
2019-20,LAC,PF,63,1,1307,151,352,.429,92,238,.387,59,114,.518,.560,36,48,.750,77,311,388,49,29,24,54,174,430,JaMychal Green
2020-21,DEN,PF,58,5,1120,173,374,.463,79,198,.399,94,176,.534,.568,46,57,.807,85,192,277,53,26,22,53,144,471,JaMychal Green
2021-22,DEN,PF,67,8,1085,159,327,.486,33,124,.266,126,203,.621,.537,81,93,.871,81,200,281,59,43,26,57,158,432,JaMychal Green
2022-23,GSW,PF,57,1,797,136,252,.540,42,111,.378,94,141,.667,.623,52,67,.776,72,133,205,51,25,23,52,105,366,JaMychal Green
2019-20,BOS,SG,48,2,468,63,126,.500,9,33,.273,54,93,.581,.536,28,42,.667,24,69,93,26,24,8,23,43,163,Javonte Green
2020-21,2TM,SF,41,2,473,53,102,.520,10,30,.333,43,72,.597,.569,30,40,.750,26,45,71,17,28,6,19,45,146,Javonte Green
2020-21,BOS,SF,25,2,345,39,71,.549,7,22,.318,32,49,.653,.599,20,30,.667,20,32,52,11,18,2,13,32,105,Javonte Green
2020-21,CHI,SG,16,0,128,14,31,.452,3,8,.375,11,23,.478,.500,10,10,1.000,6,13,19,6,10,4,6,13,41,Javonte Green
2021-22,CHI,SF,65,45,1519,176,325,.542,36,101,.356,140,224,.625,.597,80,96,.833,91,185,276,60,67,32,30,132,468,Javonte Green
2022-23,CHI,SF,32,1,480,61,108,.565,13,35,.371,48,73,.658,.625,30,45,.667,27,61,88,23,24,21,20,52,165,Javonte Green
2023-24,CHI,SF,9,5,230,45,75,.600,10,27,.370,35,48,.729,.667,10,13,.769,20,47,67,5,10,8,7,19,110,Javonte Green
2024-25,NOP,SG,30,12,645,64,142,.451,20,59,.339,44,83,.530,.521,32,43,.744,30,67,97,21,30,19,19,42,180,Javonte Green
2007-08,SEA,SF,80,52,2253,320,749,.427,21,76,.276,299,673,.444,.441,177,238,.744,101,278,379,119,46,49,158,198,838,Jeff Green
2008-09,OKC,PF,78,78,2873,476,1068,.446,96,247,.389,380,821,.463,.491,242,307,.788,120,399,519,155,81,33,173,202,1290,Jeff Green
2009-10,OKC,PF,82,82,3043,485,1070,.453,104,312,.333,381,758,.503,.502,165,223,.740,112,378,490,134,104,72,135,221,1239,Jeff Green
2010-11,2TM,SF,75,51,2427,368,820,.449,64,211,.303,304,609,.499,.488,198,244,.811,73,287,360,108,53,37,99,210,998,Jeff Green
2010-11,OKC,PF,49,49,1815,270,618,.437,56,184,.304,214,434,.493,.482,148,181,.818,57,217,274,89,40,21,76,142,744,Jeff Green
2010-11,BOS,SF,26,2,612,98,202,.485,8,27,.296,90,175,.514,.505,50,63,.794,16,70,86,19,13,16,23,68,254,Jeff Green
2012-13,BOS,PF,81,17,2252,376,806,.467,70,182,.385,306,624,.490,.510,214,265,.808,55,263,318,128,56,68,132,175,1036,Jeff Green
2013-14,BOS,SF,82,82,2805,482,1171,.412,135,396,.341,347,775,.448,.469,283,356,.795,54,326,380,138,57,47,165,180,1382,Jeff Green
2014-15,2TM,SF,78,70,2454,416,967,.430,97,292,.332,319,675,.473,.480,239,287,.833,64,264,328,134,53,34,108,147,1168,Jeff Green
2014-15,BOS,SF,33,33,1093,206,475,.434,47,154,.305,159,321,.495,.483,121,144,.840,21,120,141,53,27,13,56,66,580,Jeff Green
2014-15,MEM,SF,45,37,1361,210,492,.427,50,138,.362,160,354,.452,.478,118,143,.825,43,144,187,81,26,21,52,81,588,Jeff Green
2015-16,2TM,SF,80,41,2253,354,824,.430,67,213,.315,287,611,.470,.470,164,220,.745,74,258,332,138,58,40,93,164,939,Jeff Green
2015-16,MEM,SF,53,31,1544,240,557,.431,42,136,.309,198,421,.470,.469,124,155,.800,55,186,241,98,40,19,69,102,646,Jeff Green
2015-16,LAC,SF,27,10,709,114,267,.427,25,77,.325,89,190,.468,.474,40,65,.615,19,72,91,40,18,21,24,62,293,Jeff Green
2016-17,ORL,PF,69,11,1534,220,558,.394,53,193,.275,167,365,.458,.442,145,168,.863,39,175,214,81,37,13,75,103,638,Jeff Green
2017-18,CLE,PF,78,14,1828,295,618,.477,53,170,.312,242,448,.540,.520,203,234,.868,60,186,246,99,41,34,75,149,846,Jeff Green
2018-19,WAS,PF,77,44,2097,326,687,.475,111,320,.347,215,367,.586,.555,183,206,.888,57,252,309,137,43,39,101,160,946,Jeff Green
2019-20,2TM,C,48,4,960,159,344,.462,62,183,.339,97,161,.602,.552,73,91,.802,24,109,133,50,26,19,42,89,453,Jeff Green
2019-20,UTA,PF,30,2,553,75,195,.385,34,104,.327,41,91,.451,.472,49,63,.778,14,67,81,20,12,10,27,46,233,Jeff Green
2019-20,HOU,C,18,2,407,84,149,.564,28,79,.354,56,70,.800,.658,24,28,.857,10,42,52,30,14,9,15,43,220,Jeff Green
2020-21,BRK,PF,68,38,1835,261,530,.492,103,250,.412,158,280,.564,.590,125,161,.776,34,229,263,108,36,27,54,122,750,Jeff Green
2021-22,DEN,PF,75,63,1849,277,529,.524,53,168,.315,224,361,.620,.574,165,198,.833,41,190,231,96,28,27,71,151,772,Jeff Green
2022-23,DEN,PF,56,4,1091,160,328,.488,30,104,.288,130,224,.580,.534,87,117,.744,38,106,144,69,18,17,46,99,437,Jeff Green
2023-24,HOU,PF,78,6,1307,167,366,.456,53,160,.331,114,206,.553,.529,122,149,.819,46,132,178,70,16,31,46,100,509,Jeff Green
2024-25,HOU,PF,9,0,55,9,18,.500,4,11,.364,5,7,.714,.611,1,2,.500,1,6,7,1,2,0,2,4,23,Jeff Green
2020-21,DAL,SG,39,5,445,42,93,.452,4,25,.160,38,68,.559,.473,13,23,.565,28,50,78,28,16,3,17,35,101,Josh Green
2021-22,DAL,SG,67,3,1039,130,256,.508,28,78,.359,102,178,.573,.563,31,45,.689,52,109,161,79,45,14,44,115,319,Josh Green
2022-23,DAL,SG,60,21,1539,205,382,.537,68,169,.402,137,213,.643,.626,68,94,.723,55,127,182,103,42,5,72,156,546,Josh Green
2023-24,DAL,SG,57,33,1505,179,374,.479,72,187,.385,107,187,.572,.575,39,57,.684,40,144,184,130,47,9,60,107,469,Josh Green
2024-25,CHO,SG,28,27,785,73,173,.422,39,95,.411,34,78,.436,.535,15,27,.556,29,43,72,44,25,11,27,85,200,Josh Green
2022-23,ATL,SF,72,12,1401,248,533,.465,101,259,.390,147,274,.536,.560,42,47,.894,37,116,153,73,42,12,42,87,639,AJ Griffin
2023-24,ATL,SF,20,0,171,18,62,.290,10,39,.256,8,23,.348,.371,2,2,1.000,2,16,18,5,1,2,8,6,48,AJ Griffin
2021-22,NYK,SG,46,6,786,95,235,.404,72,189,.381,23,46,.500,.557,13,19,.684,24,70,94,44,31,11,28,72,275,Quentin Grimes
2022-23,NYK,SG,71,66,2121,282,602,.468,157,407,.386,125,195,.641,.599,78,98,.796,49,180,229,150,47,26,69,177,799,Quentin Grimes
2023-24,2TM,SG,51,18,1025,122,328,.372,81,240,.338,41,88,.466,.495,34,45,.756,15,85,100,66,35,7,28,75,359,Quentin Grimes
2023-24,NYK,SG,45,18,910,113,286,.395,77,212,.363,36,74,.486,.530,24,34,.706,14,74,88,52,30,3,21,66,327,Quentin Grimes
2023-24,DET,SG,6,0,115,9,42,.214,4,28,.143,5,14,.357,.262,10,11,.909,1,11,12,14,5,4,7,9,32,Quentin Grimes
2024-25,DAL,SG,29,9,611,91,192,.474,45,109,.413,46,83,.554,.591,36,50,.720,21,90,111,45,19,6,33,47,263,Quentin Grimes
2023-24,TOR,PF,11,0,120,11,38,.289,0,3,.000,11,35,.314,.289,4,9,.444,12,11,23,5,3,18,12,15,26,Mouhamadou Gueye
2023-24,ATL,PF,6,0,73,8,23,.348,3,9,.333,5,14,.357,.413,5,6,.833,10,12,22,4,5,4,1,13,24,Mouhamed Gueye
2024-25,ATL,PF,2,0,11,1,4,.250,0,2,.000,1,2,.500,.250,0,0,,0,2,2,0,0,0,1,0,2,Mouhamed Gueye
2019-20,SAC,SG,3,0,10,2,5,.400,0,3,.000,2,2,1.000,.400,0,0,,0,1,1,1,0,0,0,1,4,Kyle Guy
2020-21,SAC,PG,31,0,235,29,88,.330,13,46,.283,16,42,.381,.403,16,20,.800,5,30,35,32,6,0,11,20,87,Kyle Guy
2021-22,MIA,SG,19,0,186,26,65,.400,14,40,.350,12,25,.480,.508,8,12,.667,4,13,17,17,7,1,13,12,74,Kyle Guy
2019-20,WAS,PF,48,48,1444,254,545,.466,25,87,.287,229,458,.500,.489,116,140,.829,78,216,294,87,37,8,53,105,649,Rui Hachimura
2020-21,WAS,PF,57,57,1797,310,648,.478,45,137,.328,265,511,.519,.513,124,161,.770,49,263,312,82,44,7,68,120,789,Rui Hachimura
2021-22,WAS,PF,42,13,943,187,381,.491,55,123,.447,132,258,.512,.563,46,66,.697,25,135,160,48,23,9,33,53,475,Rui Hachimura
2022-23,2TM,PF,63,9,1466,284,584,.486,51,160,.319,233,424,.550,.530,88,119,.739,53,230,283,58,19,26,53,72,707,Rui Hachimura
2022-23,WAS,PF,30,0,728,158,324,.488,30,89,.337,128,235,.545,.534,44,58,.759,19,109,128,35,11,12,36,39,390,Rui Hachimura
2022-23,LAL,PF,33,9,738,126,260,.485,21,71,.296,105,189,.556,.525,44,61,.721,34,121,155,23,8,14,17,33,317,Rui Hachimura
2023-24,LAL,PF,68,39,1826,363,676,.537,98,232,.422,265,444,.597,.609,99,134,.739,58,236,294,81,41,25,46,101,923,Rui Hachimura
2024-25,LAL,PF,25,25,836,112,235,.477,38,88,.432,74,147,.503,.557,42,51,.824,43,93,136,41,24,16,24,52,304,Rui Hachimura
2020-21,MIN,PG,2,0,4,0,0,,0,0,,0,0,,,0,0,,0,0,0,0,0,0,1,0,0,Ashton Hagans
2023-24,POR,PG,19,1,316,29,71,.408,8,25,.320,21,46,.457,.465,14,17,.824,14,31,45,54,11,9,30,40,80,Ashton Hagans
2020-21,SAC,PG,58,20,1746,292,619,.472,121,296,.409,171,323,.529,.569,48,56,.857,39,134,173,309,77,28,92,83,753,Tyrese Haliburton
2021-22,2TM,PG,77,77,2695,430,909,.473,161,389,.414,269,520,.517,.562,160,190,.842,61,250,311,628,134,49,199,121,1181,Tyrese Haliburton
2021-22,SAC,SG,51,51,1757,268,586,.457,104,252,.413,164,334,.491,.546,87,104,.837,39,160,199,379,86,34,115,71,727,Tyrese Haliburton
2021-22,IND,PG,26,26,938,162,323,.502,57,137,.416,105,186,.565,.590,73,86,.849,22,90,112,249,48,15,84,50,454,Tyrese Haliburton
2022-23,IND,PG,56,56,1883,412,841,.490,161,402,.400,251,439,.572,.586,175,201,.871,33,172,205,585,91,25,141,69,1160,Tyrese Haliburton
2023-24,IND,PG,69,68,2224,500,1048,.477,195,535,.364,305,513,.595,.570,194,227,.855,35,236,271,752,83,48,159,75,1389,Tyrese Haliburton
2024-25,IND,PG,32,32,1124,191,443,.431,95,269,.353,96,174,.552,.538,79,93,.849,22,90,112,280,38,18,62,45,556,Tyrese Haliburton
2019-20,OKC,PG,11,0,81,6,30,.200,4,17,.235,2,13,.154,.267,4,8,.500,2,5,7,13,4,1,5,6,20,Devon Hall
2022-23,SAS,SF,9,0,83,9,28,.321,3,15,.200,6,13,.462,.375,7,9,.778,3,9,12,11,1,0,7,6,28,Jordan Hall
2020-21,OKC,SF,21,1,336,30,99,.303,4,37,.108,26,62,.419,.323,22,44,.500,6,53,59,28,4,1,25,37,86,Josh Hall
2024-25,DEN,C,6,0,14,2,5,.400,0,2,.000,2,3,.667,.400,0,0,0,3,3,0,0,1,0,1,4,0,PJ Hall
2020-21,2TM,SG,51,1,888,136,313,.435,27,87,.310,109,226,.482,.478,55,82,.671,29,150,179,87,21,10,53,61,354,R.J. Hampton
2020-21,DEN,SG,25,0,233,25,60,.417,5,18,.278,20,42,.476,.458,9,12,.750,10,40,50,14,5,2,11,22,64,R.J. Hampton
2020-21,ORL,SG,26,1,655,111,253,.439,22,69,.319,89,184,.484,.482,46,70,.657,19,110,129,73,16,8,42,39,290,R.J. Hampton
2021-22,ORL,SG,64,14,1402,175,457,.383,64,183,.350,111,274,.405,.453,75,117,.641,23,171,194,158,42,13,87,101,489,R.J. Hampton
2022-23,2TM,SG,47,3,750,102,237,.430,41,116,.353,61,121,.504,.517,57,76,.750,18,69,87,54,27,9,42,51,302,R.J. Hampton
2022-23,ORL,SG,26,0,361,50,114,.439,18,53,.340,32,61,.525,.518,31,37,.838,9,30,39,34,16,4,21,22,149,R.J. Hampton
2022-23,DET,SG,21,3,389,52,123,.423,23,63,.365,29,60,.483,.516,26,39,.667,9,39,48,20,11,5,21,29,153,R.J. Hampton
2023-24,MIA,PG,8,2,76,4,14,.286,1,8,.125,3,6,.500,.321,1,2,.500,2,4,6,8,0,0,3,8,10,R.J. Hampton
2018-19,MEM,SG,2,0,26,3,12,.250,0,5,.000,3,7,.429,.250,2,2,1.000,0,1,1,5,1,0,1,1,8,Dusty Hannahs
2019-20,MEM,SG,2,0,13,4,9,.444,2,3,.667,2,6,.333,.556,2,2,1.000,0,1,1,0,0,0,0,1,12,Dusty Hannahs
2013-14,NYK,SG,81,1,1875,294,687,.428,130,358,.363,164,329,.498,.523,106,128,.828,19,102,121,66,44,7,47,144,824,Tim Hardaway Jr.
2014-15,NYK,SG,70,30,1681,279,717,.389,121,354,.342,158,363,.435,.474,125,156,.801,12,144,156,127,20,14,82,119,804,Tim Hardaway Jr.
2015-16,ATL,SG,51,1,864,114,265,.430,48,142,.338,66,123,.537,.521,50,56,.893,7,79,86,51,21,7,23,48,326,Tim Hardaway Jr.
2016-17,ATL,SG,79,30,2154,415,912,.455,149,417,.357,266,495,.537,.537,164,214,.766,35,189,224,182,55,15,106,103,1143,Tim Hardaway Jr.
2017-18,NYK,SG,57,54,1885,360,856,.421,130,410,.317,230,446,.516,.496,146,179,.816,32,192,224,155,62,10,92,123,996,Tim Hardaway Jr.
2018-19,2TM,SG,65,63,2057,390,993,.393,162,477,.340,228,516,.442,.474,232,276,.841,33,189,222,159,54,8,105,141,1174,Tim Hardaway Jr.
2018-19,NYK,SG,46,46,1499,282,726,.388,117,337,.347,165,389,.424,.469,199,233,.854,26,135,161,122,42,6,81,106,880,Tim Hardaway Jr.
2018-19,DAL,SG,19,17,558,108,267,.404,45,140,.321,63,127,.496,.489,33,43,.767,7,54,61,37,12,2,24,35,294,Tim Hardaway Jr.
2019-20,DAL,SG,71,58,2091,384,884,.434,204,513,.398,180,371,.485,.550,149,182,.819,25,207,232,137,41,5,69,125,1121,Tim Hardaway Jr.
2020-21,DAL,SG,70,31,1985,407,911,.447,207,529,.391,200,382,.524,.560,142,174,.816,20,209,229,126,31,11,64,111,1163,Tim Hardaway Jr.
2021-22,DAL,SG,42,20,1245,209,530,.394,102,304,.336,107,226,.473,.491,78,103,.757,13,143,156,92,38,6,34,74,598,Tim Hardaway Jr.
2022-23,DAL,SF,71,45,2152,340,847,.401,212,550,.385,128,297,.431,.527,127,165,.770,21,230,251,129,49,12,60,120,1019,Tim Hardaway Jr.
2023-24,DAL,SF,79,12,2120,392,976,.402,211,597,.353,181,379,.478,.510,144,169,.852,22,232,254,139,42,6,69,106,1139,Tim Hardaway Jr.
2024-25,DET,SG,28,28,770,94,226,.416,55,154,.357,39,72,.542,.538,39,45,.867,6,51,57,44,10,0,19,36,282,Tim Hardaway Jr.
2009-10,OKC,SG,76,0,1738,233,578,.403,93,248,.375,140,330,.424,.484,194,240,.808,47,197,244,137,80,20,106,200,753,James Harden
2010-11,OKC,SG,82,5,2189,298,684,.436,113,324,.349,185,360,.514,.518,289,343,.843,42,213,255,176,92,24,106,207,998,James Harden
2011-12,OKC,SG,62,2,1946,309,629,.491,114,292,.390,195,337,.579,.582,312,369,.846,30,222,252,229,62,15,137,150,1044,James Harden
2012-13,HOU,SG,78,78,2985,585,1337,.438,179,486,.368,406,851,.477,.504,674,792,.851,62,317,379,455,142,38,295,178,2023,James Harden
2013-14,HOU,SG,73,73,2777,549,1205,.456,177,483,.366,372,722,.515,.529,576,665,.866,61,283,344,446,115,29,265,177,1851,James Harden
2014-15,HOU,SG,81,81,2981,647,1470,.440,208,555,.375,439,915,.480,.511,715,824,.868,75,384,459,565,154,60,321,208,2217,James Harden
2015-16,HOU,SG,82,82,3125,710,1617,.439,236,657,.359,474,960,.494,.512,720,837,.860,63,438,501,612,139,51,374,229,2376,James Harden
2016-17,HOU,PG,81,81,2947,674,1533,.440,262,756,.347,412,777,.530,.525,746,881,.847,95,564,659,907,121,38,464,215,2356,James Harden
2017-18,HOU,SG,72,72,2551,651,1449,.449,265,722,.367,386,727,.531,.541,624,727,.858,41,348,389,630,126,50,315,169,2191,James Harden
2018-19,HOU,PG,78,78,2867,843,1909,.442,378,1028,.368,465,881,.528,.541,754,858,.879,66,452,518,586,158,58,387,244,2818,James Harden
2019-20,HOU,SG,68,68,2483,672,1514,.444,299,843,.355,373,671,.556,.543,692,800,.865,70,376,446,512,125,60,308,227,2335,James Harden
2020-21,2TM,PG,44,43,1609,342,734,.466,121,334,.362,221,400,.553,.548,278,323,.861,35,313,348,475,53,33,177,99,1083,James Harden
2020-21,HOU,PG,8,8,290,60,135,.444,25,72,.347,35,63,.556,.537,53,60,.883,5,36,41,83,7,6,34,14,198,James Harden
2020-21,BRK,PG,36,35,1319,282,599,.471,96,262,.366,186,337,.552,.551,225,263,.856,30,277,307,392,46,27,143,85,885,James Harden
2021-22,2TM,PG,65,65,2419,407,992,.410,148,448,.330,259,544,.476,.485,470,536,.877,55,445,500,667,82,36,284,153,1432,James Harden
2021-22,BRK,PG,44,44,1627,292,706,.414,102,307,.332,190,399,.476,.486,304,350,.869,42,309,351,447,56,31,212,105,990,James Harden
2021-22,PHI,PG,21,21,792,115,286,.402,46,141,.326,69,145,.476,.483,166,186,.892,13,136,149,220,26,5,72,48,442,James Harden
2022-23,PHI,PG,58,58,2135,371,842,.441,161,418,.385,210,424,.495,.536,313,361,.867,40,314,354,618,71,31,195,112,1216,James Harden
2023-24,LAC,PG,72,72,2470,352,822,.428,186,488,.381,166,334,.497,.541,302,344,.878,34,335,369,614,77,57,185,127,1192,James Harden
2024-25,LAC,PG,30,30,1023,189,484,.390,84,246,.341,105,238,.441,.477,195,218,.894,18,173,191,243,45,19,141,61,657,James Harden
2022-23,DAL,SG,48,5,708,146,333,.438,63,156,.404,83,177,.469,.533,65,79,.823,11,78,89,65,17,7,46,64,420,Jaden Hardy
2023-24,DAL,SG,73,7,989,195,479,.407,81,224,.362,114,255,.447,.492,59,76,.776,20,111,131,109,22,4,62,80,530,Jaden Hardy
2024-25,DAL,SG,23,2,321,52,134,.388,18,60,.300,34,74,.459,.455,22,25,.880,4,26,30,27,14,1,31,30,144,Jaden Hardy
2012-13,ORL,SF,76,59,1974,260,564,.461,32,117,.274,228,447,.510,.489,73,128,.570,122,213,335,50,88,62,69,144,625,Maurice Harkless
2013-14,ORL,SF,80,41,1950,224,483,.464,59,154,.383,165,329,.502,.525,85,143,.594,69,195,264,80,97,50,86,140,592,Maurice Harkless
2014-15,ORL,SF,45,4,674,63,158,.399,10,56,.179,53,102,.520,.430,22,41,.537,38,68,106,25,32,9,27,66,158,Maurice Harkless
2015-16,POR,SF,78,14,1457,195,411,.474,39,140,.279,156,271,.576,.522,69,111,.622,101,179,280,67,49,35,62,124,498,Maurice Harkless
2016-17,POR,SF,77,69,2223,314,624,.503,68,194,.351,246,430,.572,.558,77,124,.621,125,216,341,88,85,70,86,214,773,Maurice Harkless
2017-18,POR,SF,59,37,1264,147,297,.495,49,118,.415,98,179,.547,.577,42,59,.712,46,116,162,53,48,43,40,103,385,Maurice Harkless
2018-19,POR,SF,60,53,1415,189,388,.487,33,120,.275,156,268,.582,.530,49,73,.671,77,192,269,74,67,53,45,163,460,Maurice Harkless
2019-20,2TM,PF,62,48,1427,142,283,.502,34,98,.347,108,185,.584,.562,39,66,.591,55,185,240,68,58,33,53,148,357,Maurice Harkless
2019-20,LAC,PF,50,38,1141,112,217,.516,27,73,.370,85,144,.590,.578,24,42,.571,47,153,200,48,49,30,46,120,275,Maurice Harkless
2019-20,NYK,SF,12,10,286,30,66,.455,7,25,.280,23,41,.561,.508,15,24,.625,8,32,40,20,9,3,7,28,82,Maurice Harkless
2020-21,2TM,SF,37,23,772,69,165,.418,23,84,.274,46,81,.568,.488,33,43,.767,13,76,89,44,30,20,22,86,194,Maurice Harkless
2020-21,MIA,SF,11,3,124,5,13,.385,5,11,.455,0,2,.000,.577,0,2,.000,2,11,13,7,2,4,3,14,15,Maurice Harkless
2020-21,SAC,PF,26,20,648,64,152,.421,18,73,.247,46,79,.582,.480,33,41,.805,11,65,76,37,28,16,19,72,179,Maurice Harkless
2021-22,SAC,SF,47,24,863,83,181,.459,31,101,.307,52,80,.650,.544,20,28,.714,12,100,112,23,29,24,31,77,217,Maurice Harkless
2022-23,TOR,PF,9,0,48,8,16,.500,3,9,.333,5,7,.714,.594,1,1,1.000,3,4,7,4,0,1,0,3,20,Ron Harper Jr.
2023-24,TOR,PF,1,0,4,0,0,,0,0,,0,0,,,0,0,,0,0,0,1,0,0,0,2,0,Ron Harper Jr.
2015-16,HOU,PF,39,1,379,58,90,.644,0,1,.000,58,89,.652,.644,24,46,.522,25,40,65,17,11,11,17,48,140,Montrezl Harrell
2016-17,HOU,C,58,14,1064,225,345,.652,1,7,.143,224,338,.663,.654,76,121,.628,81,138,219,64,20,42,44,126,527,Montrezl Harrell
2017-18,LAC,C,76,3,1293,348,548,.635,1,7,.143,347,541,.641,.636,139,222,.626,103,203,306,74,36,52,68,143,836,Montrezl Harrell
2018-19,LAC,C,82,5,2158,546,888,.615,3,17,.176,543,871,.623,.617,266,414,.643,184,351,535,162,71,110,132,255,1361,Montrezl Harrell
2019-20,LAC,C,63,2,1749,471,812,.580,0,18,.000,471,794,.593,.580,231,351,.658,163,282,445,107,39,72,108,146,1173,Montrezl Harrell
2020-21,LAL,C,69,1,1580,375,603,.622,0,10,.000,375,593,.632,.622,181,256,.707,158,270,428,73,46,49,74,128,931,Montrezl Harrell
2021-22,2TM,C,71,3,1641,358,555,.645,4,17,.235,354,538,.658,.649,212,296,.716,149,282,431,145,29,43,72,137,932,Montrezl Harrell
2021-22,WAS,C,46,3,1117,247,383,.645,4,15,.267,243,368,.660,.650,149,205,.727,96,213,309,96,18,31,50,88,647,Montrezl Harrell
2021-22,CHO,C,25,0,524,111,172,.645,0,2,.000,111,170,.653,.645,63,91,.692,53,69,122,49,11,12,22,49,285,Montrezl Harrell
2022-23,PHI,C,57,7,681,125,209,.598,0,6,.000,125,203,.616,.598,70,101,.693,67,92,159,33,17,25,35,75,320,Montrezl Harrell
2014-15,DEN,SG,55,6,719,66,217,.304,21,103,.204,45,114,.395,.353,35,47,.745,21,43,64,29,39,7,38,71,188,Gary Harris
2015-16,DEN,SG,76,76,2439,359,765,.469,105,297,.354,254,468,.543,.538,109,133,.820,54,166,220,147,97,18,98,143,932,Gary Harris
2016-17,DEN,SG,57,56,1782,320,637,.502,107,255,.420,213,382,.558,.586,104,134,.776,48,130,178,164,71,8,76,92,851,Gary Harris
2017-18,DEN,SG,67,65,2304,440,908,.485,156,394,.396,284,514,.553,.570,134,162,.827,37,139,176,194,122,15,119,119,1170,Gary Harris
2018-19,DEN,SG,57,48,1639,270,637,.424,82,242,.339,188,395,.476,.488,115,144,.799,41,119,160,127,55,19,68,113,737,Gary Harris
2019-20,DEN,SG,56,55,1780,218,519,.420,70,210,.333,148,309,.479,.487,75,92,.815,26,137,163,118,76,14,60,116,581,Gary Harris
2020-21,2TM,SG,39,38,1080,138,345,.400,48,141,.340,90,204,.441,.470,64,78,.821,21,58,79,78,28,11,37,71,388,Gary Harris
2020-21,DEN,SG,19,19,581,69,156,.442,24,75,.320,45,81,.556,.519,22,30,.733,13,34,47,32,17,4,14,37,184,Gary Harris
2020-21,ORL,SG,20,19,499,69,189,.365,24,66,.364,45,123,.366,.429,42,48,.875,8,24,32,46,11,7,23,34,204,Gary Harris
2021-22,ORL,SG,61,30,1730,240,553,.434,116,302,.384,124,251,.494,.539,83,95,.874,36,86,122,108,59,9,61,112,679,Gary Harris
2022-23,ORL,SG,48,42,1184,138,307,.450,94,218,.431,44,89,.494,.603,27,30,.900,21,77,98,59,45,12,28,93,397,Gary Harris
2023-24,ORL,SG,54,27,1297,131,297,.441,76,205,.371,55,92,.598,.569,34,45,.756,24,67,91,87,49,14,31,91,372,Gary Harris
2024-25,ORL,SG,18,2,296,25,63,.397,17,48,.354,8,15,.533,.532,4,6,.667,9,14,23,8,9,5,7,13,71,Gary Harris
2020-21,TOR,SG,13,2,172,36,72,.500,17,36,.472,19,36,.528,.618,7,9,.778,3,15,18,17,8,0,14,15,96,Jalen Harris
2022-23,ORL,SG,34,0,457,47,107,.439,16,43,.372,31,64,.484,.514,31,41,.756,28,42,70,16,17,5,21,53,141,Kevon Harris
2023-24,ORL,SG,2,0,6,2,3,.667,0,0,,2,3,.667,.667,0,0,,0,2,2,1,0,0,1,3,4,Kevon Harris
2011-12,MIL,SF,42,9,479,79,169,.467,6,23,.261,73,146,.500,.485,44,54,.815,30,71,101,22,13,7,31,45,208,Tobias Harris
2012-13,2TM,SF,55,34,1299,233,512,.455,34,108,.315,199,404,.493,.488,103,137,.752,73,214,287,69,32,44,66,120,603,Tobias Harris
2012-13,MIL,SF,28,14,325,53,115,.461,7,21,.333,46,94,.489,.491,23,26,.885,17,40,57,13,8,7,18,31,136,Tobias Harris
2012-13,ORL,PF,27,20,974,180,397,.453,27,87,.310,153,310,.494,.487,80,111,.721,56,174,230,56,24,37,48,89,467,Tobias Harris
2013-14,ORL,PF,61,36,1850,332,716,.464,32,126,.254,300,590,.508,.486,197,244,.807,88,336,424,82,41,24,78,143,893,Tobias Harris
2014-15,ORL,SF,68,63,2369,442,949,.466,87,239,.364,355,710,.500,.512,193,245,.788,73,357,430,124,69,36,115,134,1164,Tobias Harris
2015-16,2TM,PF,76,74,2513,417,889,.469,80,239,.335,337,650,.518,.514,202,243,.831,96,414,510,169,65,40,108,153,1116,Tobias Harris
2015-16,ORL,PF,49,49,1610,251,541,.464,47,151,.311,204,390,.523,.507,120,153,.784,71,271,342,99,47,28,78,91,669,Tobias Harris
2015-16,DET,PF,27,25,903,166,348,.477,33,88,.375,133,260,.512,.524,82,90,.911,25,143,168,70,18,12,30,62,447,Tobias Harris
2016-17,DET,PF,82,48,2567,511,1063,.481,109,314,.347,402,749,.537,.532,190,226,.841,63,353,416,142,60,39,96,133,1321,Tobias Harris
2017-18,2TM,PF,80,80,2668,562,1221,.460,183,445,.411,379,776,.488,.535,179,216,.829,58,379,437,192,71,35,105,164,1486,Tobias Harris
2017-18,DET,PF,48,48,1563,320,709,.451,113,276,.409,207,433,.478,.531,115,136,.846,36,208,244,94,34,15,51,91,868,Tobias Harris
2017-18,LAC,PF,32,32,1105,242,512,.473,70,169,.414,172,343,.501,.541,64,80,.800,22,171,193,98,37,20,54,73,618,Tobias Harris
2018-19,2TM,PF,82,82,2847,611,1254,.487,156,393,.397,455,861,.528,.549,266,307,.866,69,576,645,229,51,37,151,184,1644,Tobias Harris
2018-19,LAC,PF,55,55,1903,424,855,.496,112,258,.434,312,597,.523,.561,192,219,.877,37,395,432,150,40,24,109,123,1152,Tobias Harris
2018-19,PHI,PF,27,27,944,187,399,.469,44,135,.326,143,264,.542,.524,74,88,.841,32,181,213,79,11,13,42,61,492,Tobias Harris
2019-20,PHI,PF,72,72,2469,553,1173,.471,131,357,.367,422,816,.517,.527,174,216,.806,69,426,495,227,53,40,104,165,1411,Tobias Harris
2020-21,PHI,PF,62,62,2014,473,924,.512,82,208,.394,391,716,.546,.556,182,204,.892,62,357,419,220,55,51,107,119,1210,Tobias Harris
2021-22,PHI,PF,73,73,2543,493,1022,.482,101,275,.367,392,747,.525,.532,170,202,.842,77,419,496,252,47,43,116,164,1257,Tobias Harris
2022-23,PHI,SF,74,74,2436,423,845,.501,126,324,.389,297,521,.570,.575,113,129,.876,67,357,424,186,68,40,89,149,1085,Tobias Harris
2023-24,PHI,PF,70,70,2368,463,951,.487,91,258,.353,372,693,.537,.535,187,213,.878,80,373,453,217,70,46,93,115,1204,Tobias Harris
2024-25,DET,PF,29,29,922,141,327,.431,39,121,.322,102,206,.495,.491,54,64,.844,28,159,187,70,23,26,33,58,375,Tobias Harris
2017-18,PHO,PG,23,2,384,59,124,.476,6,26,.231,53,98,.541,.500,28,38,.737,9,52,61,55,26,7,22,42,152,Shaquille Harrison
2018-19,CHI,SG,73,11,1430,184,426,.432,24,89,.270,160,337,.475,.460,82,123,.667,33,189,222,139,89,30,60,124,474,Shaquille Harrison
2019-20,CHI,SG,43,10,484,77,165,.467,16,42,.381,61,123,.496,.515,39,50,.780,22,64,86,49,34,19,19,55,209,Shaquille Harrison
2020-21,2TM,SG,34,0,333,26,78,.333,3,16,.188,23,62,.371,.353,18,22,.818,7,41,48,25,17,5,11,33,73,Shaquille Harrison
2020-21,UTA,SG,17,0,56,6,20,.300,0,2,.000,6,18,.333,.300,5,6,.833,3,6,9,9,2,0,5,3,17,Shaquille Harrison
2020-21,DEN,SG,17,0,277,20,58,.345,3,14,.214,17,44,.386,.371,13,16,.813,4,35,39,16,15,5,6,30,56,Shaquille Harrison
2021-22,BRK,SG,2,0,23,2,6,.333,0,2,.000,2,4,.500,.333,0,0,,1,3,4,3,1,1,2,3,4,Shaquille Harrison
2022-23,POR,SG,5,0,120,15,36,.417,3,10,.300,12,26,.462,.458,11,15,.733,1,21,22,30,11,2,6,12,44,Shaquille Harrison
2023-24,MEM,SG,3,0,6,1,2,.500,0,0,,1,2,.500,.500,0,0,,0,2,2,0,0,1,0,0,2,Shaquille Harrison
2017-18,LAL,SG,63,23,1461,176,375,.469,78,197,.396,98,178,.551,.573,66,94,.702,42,221,263,80,47,16,47,107,496,Josh Hart
2018-19,LAL,SG,67,22,1715,189,464,.407,92,274,.336,97,190,.511,.506,55,80,.688,35,213,248,93,64,40,58,147,525,Josh Hart
2019-20,NOP,SF,65,16,1755,225,532,.423,121,354,.342,104,178,.584,.537,85,115,.739,61,364,425,108,63,23,75,160,656,Josh Hart
2020-21,NOP,SF,47,4,1349,151,344,.439,63,193,.326,88,151,.583,.531,69,89,.775,53,324,377,109,38,12,49,111,434,Josh Hart
2021-22,2TM,SG,54,53,1791,287,569,.504,73,213,.343,214,356,.601,.569,160,211,.758,62,326,388,224,61,13,114,150,807,Josh Hart
2021-22,NOP,SG,41,40,1374,195,386,.505,42,130,.323,153,256,.598,.560,116,154,.753,53,265,318,168,45,11,81,118,548,Josh Hart
2021-22,POR,SG,13,13,417,92,183,.503,31,83,.373,61,100,.610,.587,44,57,.772,9,61,70,56,16,2,33,32,259,Josh Hart
2022-23,2TM,SF,76,52,2454,275,520,.529,61,164,.372,214,356,.601,.588,132,176,.750,142,451,593,290,88,21,117,195,743,Josh Hart
2022-23,POR,SF,51,51,1704,183,363,.504,34,112,.304,149,251,.594,.551,87,119,.731,95,322,417,200,54,9,79,133,487,Josh Hart
2022-23,NYK,SF,25,1,750,92,157,.586,27,52,.519,65,105,.619,.672,45,57,.789,47,129,176,90,34,12,38,62,256,Josh Hart
2023-24,NYK,SF,81,42,2707,295,679,.434,80,258,.310,215,421,.511,.493,91,115,.791,128,547,675,331,75,23,118,171,761,Josh Hart
2024-25,NYK,SG,30,30,1106,162,277,.585,40,101,.396,122,176,.693,.657,62,76,.816,49,200,249,159,44,12,55,73,426,Josh Hart
2018-19,HOU,PF,28,0,221,20,41,.488,2,6,.333,18,35,.514,.512,11,14,.786,21,26,47,15,7,12,13,56,53,Isaiah Hartenstein
2019-20,HOU,C,23,2,266,44,67,.657,0,5,.000,44,62,.710,.657,19,28,.679,29,61,90,18,9,12,16,41,107,Isaiah Hartenstein
2020-21,2TM,C,46,2,559,94,171,.550,2,6,.333,92,165,.558,.556,46,71,.648,65,116,181,55,19,39,44,104,236,Isaiah Hartenstein
2020-21,DEN,C,30,0,272,41,80,.513,0,0,,41,80,.513,.513,22,36,.611,40,45,85,15,11,20,21,59,104,Isaiah Hartenstein
2020-21,CLE,C,16,2,287,53,91,.582,2,6,.333,51,85,.600,.593,24,35,.686,25,71,96,40,8,19,23,45,132,Isaiah Hartenstein
2021-22,LAC,C,68,0,1216,229,366,.626,14,30,.467,215,336,.640,.645,91,132,.689,117,215,332,160,50,77,84,167,563,Isaiah Hartenstein
2022-23,NYK,C,82,8,1626,175,327,.535,8,37,.216,167,290,.576,.547,48,71,.676,209,327,536,102,53,64,66,213,406,Isaiah Hartenstein
2023-24,NYK,C,75,49,1896,235,365,.644,1,3,.333,234,362,.646,.645,111,157,.707,244,382,626,188,87,85,93,210,582,Isaiah Hartenstein
2024-25,OKC,C,14,13,429,74,128,.578,0,4,.000,74,124,.597,.578,29,45,.644,43,134,177,51,12,16,25,43,177,Isaiah Hartenstein
2021-22,BOS,SF,26,0,158,23,50,.460,19,44,.432,4,6,.667,.650,0,0,,5,24,29,10,1,2,2,7,65,Sam Hauser
2022-23,BOS,SF,80,8,1290,180,396,.455,140,335,.418,40,61,.656,.631,12,17,.706,35,169,204,71,29,21,30,99,512,Sam Hauser
2023-24,BOS,SF,79,13,1741,249,558,.446,197,465,.424,52,93,.559,.623,17,19,.895,45,231,276,82,40,25,32,99,712,Sam Hauser
2024-25,BOS,PF,24,3,520,68,160,.425,47,132,.356,21,28,.750,.572,2,2,1.000,20,60,80,26,20,5,8,30,185,Sam Hauser
2023-24,NOP,SG,67,10,1160,174,456,.382,109,298,.366,65,158,.411,.501,67,80,.838,29,119,148,70,19,7,40,72,524,Jordan Hawkins
2024-25,NOP,SG,16,3,406,64,176,.364,32,98,.327,32,78,.410,.455,37,42,.881,6,42,48,17,7,9,16,13,197,Jordan Hawkins
2019-20,NOP,C,64,14,1080,174,259,.672,1,4,.250,173,255,.678,.674,123,190,.647,97,162,259,56,26,55,53,161,472,Jaxson Hayes
2020-21,NOP,C,60,3,964,175,280,.625,6,14,.429,169,266,.635,.636,93,120,.775,92,165,257,35,25,38,39,101,449,Jaxson Hayes
2021-22,NOP,C,70,28,1398,245,398,.616,20,57,.351,225,341,.660,.641,144,188,.766,115,200,315,43,33,55,54,155,654,Jaxson Hayes
2022-23,NOP,C,47,2,610,86,156,.551,3,29,.103,83,127,.654,.561,58,83,.699,39,93,132,34,20,19,31,67,233,Jaxson Hayes
2023-24,LAL,C,70,5,877,126,175,.720,0,8,.000,126,167,.754,.720,51,82,.622,69,142,211,33,34,29,43,123,303,Jaxson Hayes
2024-25,LAL,C,11,1,192,26,36,.722,0,0,,26,36,.722,.722,18,23,.783,21,29,50,9,4,9,8,28,70,Jaxson Hayes
2020-21,DET,PG,26,18,670,71,201,.353,20,72,.278,51,129,.395,.403,14,17,.824,6,63,69,138,27,10,83,57,176,Killian Hayes
2021-22,DET,PG,66,40,1647,176,459,.383,44,167,.263,132,292,.452,.431,57,74,.770,36,174,210,277,78,35,111,183,453,Killian Hayes
2022-23,DET,PG,76,56,2154,307,815,.377,80,286,.280,227,529,.429,.426,92,112,.821,28,193,221,470,104,28,173,219,786,Killian Hayes
2023-24,DET,PG,42,31,1008,117,283,.413,22,74,.297,95,209,.455,.452,33,50,.660,11,108,119,205,36,20,51,75,289,Killian Hayes
2023-24,POR,PG,62,32,1765,307,797,.385,87,268,.325,220,529,.416,.440,167,204,.819,53,141,194,336,48,13,212,195,868,Scoot Henderson
2024-25,POR,PG,23,3,593,90,229,.393,25,79,.316,65,150,.433,.448,52,67,.776,16,49,65,115,21,5,62,63,257,Scoot Henderson
2023-24,UTA,PF,40,23,856,108,240,.450,53,140,.379,55,100,.550,.560,23,29,.793,46,139,185,32,28,30,27,77,292,Taylor Hendricks
2024-25,UTA,PF,3,3,75,4,18,.222,3,12,.250,1,6,.167,.306,3,4,.750,5,10,15,2,5,4,2,8,14,Taylor Hendricks
2019-20,TOR,C,6,0,28,5,14,.357,1,2,.500,4,12,.333,.393,3,5,.600,5,9,14,3,1,0,3,6,14,Dewan Hernandez
2016-17,DEN,PF,62,9,842,101,224,.451,46,113,.407,55,111,.495,.554,57,76,.750,43,144,187,29,30,12,31,62,305,Juancho Hernangómez
2017-18,DEN,PF,25,3,277,29,75,.387,14,50,.280,15,25,.600,.480,10,12,.833,18,36,54,12,6,3,9,25,82,Juancho Hernangómez
2018-19,DEN,PF,70,25,1358,138,314,.439,66,181,.365,72,133,.541,.545,66,86,.767,64,201,265,55,27,24,37,94,408,Juancho Hernangómez
2019-20,2TM,PF,48,14,833,100,247,.405,44,129,.341,56,118,.475,.494,44,71,.620,43,154,197,40,19,9,32,64,288,Juancho Hernangómez
2019-20,DEN,PF,34,0,422,38,110,.345,15,60,.250,23,50,.460,.414,16,25,.640,24,71,95,22,5,5,18,29,107,Juancho Hernangómez
2019-20,MIN,PF,14,14,411,62,137,.453,29,69,.420,33,68,.485,.558,28,46,.609,19,83,102,18,14,4,14,35,181,Juancho Hernangómez
2020-21,MIN,PF,52,6,900,130,299,.435,55,168,.327,75,131,.573,.527,60,97,.619,45,160,205,35,19,7,27,52,375,Juancho Hernangómez
2021-22,3TM,PF,40,9,445,44,106,.415,24,69,.348,20,37,.541,.528,19,34,.559,28,72,100,20,14,10,16,25,131,Juancho Hernangómez
2021-22,BOS,PF,18,0,96,5,27,.185,3,18,.167,2,9,.222,.241,6,9,.667,9,16,25,3,4,2,6,7,19,Juancho Hernangómez
2021-22,SAS,PF,5,0,51,2,6,.333,0,3,.000,2,3,.667,.333,3,4,.750,4,11,15,3,1,1,2,0,7,Juancho Hernangómez
2021-22,UTA,PF,17,9,298,37,73,.507,21,48,.438,16,25,.640,.651,10,21,.476,15,45,60,14,9,7,8,18,105,Juancho Hernangómez
2022-23,TOR,PF,42,10,614,48,114,.421,17,67,.254,31,47,.660,.496,9,16,.563,27,96,123,25,16,6,15,43,122,Juancho Hernangómez
2016-17,NYK,C,72,22,1324,246,465,.529,4,15,.267,242,450,.538,.533,91,125,.728,170,332,502,96,41,36,100,150,587,Willy Hernangómez
2017-18,2TM,C,48,1,495,91,164,.555,5,12,.417,86,152,.566,.570,59,90,.656,61,122,183,33,18,16,35,64,246,Willy Hernangómez
2017-18,NYK,C,26,0,233,49,81,.605,1,5,.200,48,76,.632,.611,12,28,.429,22,45,67,21,8,7,26,32,111,Willy Hernangómez
2017-18,CHO,C,22,1,262,42,83,.506,4,7,.571,38,76,.500,.530,47,62,.758,39,77,116,12,10,9,9,32,135,Willy Hernangómez
2018-19,CHO,C,58,3,812,153,295,.519,15,39,.385,138,256,.539,.544,100,144,.694,117,194,311,60,16,20,58,98,421,Willy Hernangómez
2019-20,CHO,C,31,0,375,74,139,.532,5,22,.227,69,117,.590,.550,37,59,.627,43,91,134,29,10,7,30,32,190,Willy Hernangómez
2020-21,NOP,C,47,12,846,151,268,.563,1,10,.100,150,258,.581,.565,62,93,.667,117,217,334,50,22,23,34,68,365,Willy Hernangómez
2021-22,NOP,C,50,8,839,170,327,.520,4,12,.333,166,315,.527,.526,109,141,.773,143,195,338,63,21,19,51,97,453,Willy Hernangómez
2022-23,NOP,C,38,2,458,89,169,.527,3,11,.273,86,158,.544,.536,81,104,.779,58,122,180,33,17,13,39,64,262,Willy Hernangómez
2019-20,MIA,SG,55,8,1508,270,631,.428,116,298,.389,154,333,.462,.520,87,100,.870,16,208,224,121,34,9,87,76,743,Tyler Herro
2020-21,MIA,SG,54,15,1635,307,699,.439,107,297,.360,200,402,.498,.516,94,117,.803,25,243,268,184,35,17,101,71,815,Tyler Herro
2021-22,MIA,SG,66,10,2151,501,1122,.447,175,439,.399,326,683,.477,.525,190,219,.868,32,297,329,263,44,8,174,95,1367,Tyler Herro
2022-23,MIA,SG,67,67,2337,487,1109,.439,203,537,.378,284,572,.497,.531,170,182,.934,27,333,360,280,51,16,158,101,1347,Tyler Herro
2023-24,MIA,SG,42,40,1407,324,735,.441,132,333,.396,192,402,.478,.531,95,111,.856,19,203,222,188,30,3,93,63,875,Tyler Herro
2024-25,MIA,SG,28,28,982,232,493,.471,111,274,.405,121,219,.553,.583,91,107,.850,10,149,159,137,22,3,71,42,666,Tyler Herro
2019-20,OKC,PF,10,0,52,7,27,.259,3,20,.150,4,7,.571,.315,0,0,1,11,12,5,1,1,0,4,17,0,Kevin Hervey
2016-17,2TM,SG,82,55,1888,327,767,.426,148,379,.391,179,388,.461,.523,64,76,.842,35,234,269,121,38,9,101,115,866,Buddy Hield
2016-17,NOP,SG,57,37,1161,185,471,.393,89,241,.369,96,230,.417,.487,29,33,.879,19,147,166,77,18,7,48,81,488,Buddy Hield
2016-17,SAC,SG,25,18,727,142,296,.480,59,138,.428,83,158,.525,.579,35,43,.814,16,87,103,44,20,2,53,34,378,Buddy Hield
2017-18,SAC,SG,80,13,2024,416,933,.446,176,408,.431,240,525,.457,.540,71,81,.877,55,252,307,155,85,22,124,148,1079,Buddy Hield
2018-19,SAC,SG,82,82,2615,623,1360,.458,278,651,.427,345,709,.487,.560,171,193,.886,106,306,412,205,58,33,146,202,1695,Buddy Hield
2019-20,SAC,SG,72,44,2216,498,1162,.429,271,688,.394,227,474,.479,.545,115,136,.846,57,271,328,213,66,17,168,165,1382,Buddy Hield
2020-21,SAC,SG,71,71,2433,403,992,.406,282,721,.391,121,271,.446,.548,88,104,.846,29,305,334,257,63,30,130,175,1176,Buddy Hield
2021-22,2TM,SG,81,32,2499,446,1098,.406,262,716,.366,184,382,.482,.526,111,127,.874,66,287,353,229,73,25,153,184,1265,Buddy Hield
2021-22,SAC,SG,55,6,1574,265,693,.382,182,495,.368,83,198,.419,.514,80,92,.870,43,178,221,105,48,15,90,113,792,Buddy Hield
2021-22,IND,SG,26,26,925,181,405,.447,80,221,.362,101,184,.549,.546,31,35,.886,23,109,132,124,25,10,63,71,473,Buddy Hield
2022-23,IND,SF,80,73,2482,475,1038,.458,288,677,.425,187,361,.518,.596,106,129,.822,67,333,400,225,92,26,139,156,1344,Buddy Hield
2023-24,2TM,SF,84,42,2160,371,850,.436,219,568,.386,152,282,.539,.565,52,59,.881,61,208,269,236,70,42,103,169,1013,Buddy Hield
2023-24,IND,SF,52,28,1336,229,517,.443,137,357,.384,92,160,.575,.575,28,33,.848,34,133,167,139,43,31,62,103,623,Buddy Hield
2023-24,PHI,SG,32,14,824,142,333,.426,82,211,.389,60,122,.492,.550,24,26,.923,27,75,102,97,27,11,41,66,390,Buddy Hield
2024-25,GSW,SG,30,6,696,143,321,.445,90,219,.411,53,102,.520,.586,24,26,.923,19,86,105,38,25,9,39,58,400,Buddy Hield
2018-19,PHI,SF,5,0,40,4,10,.400,1,5,.200,3,5,.600,.450,0,2,.000,0,5,5,2,1,0,1,1,9,Haywood Highsmith
2021-22,MIA,SF,19,1,163,16,46,.348,9,28,.321,7,18,.389,.446,2,5,.400,10,16,26,6,2,3,3,13,43,Haywood Highsmith
2022-23,MIA,PF,54,11,969,93,216,.431,37,109,.339,56,107,.523,.516,13,28,.464,57,131,188,43,36,17,45,82,236,Haywood Highsmith
2023-24,MIA,PF,66,26,1366,153,329,.465,76,192,.396,77,137,.562,.581,23,36,.639,65,145,210,70,53,30,34,117,405,Haywood Highsmith
2024-25,MIA,SF,26,19,624,62,133,.466,34,79,.430,28,54,.519,.594,13,19,.684,17,60,77,25,27,17,21,55,171,Haywood Highsmith
2008-09,SAS,PG,77,7,1270,150,372,.403,24,73,.329,126,299,.421,.435,114,146,.781,30,128,158,136,45,21,74,150,438,George Hill
2009-10,SAS,PG,78,43,2276,353,738,.478,75,188,.399,278,550,.505,.529,183,237,.772,42,163,205,226,69,26,101,222,964,George Hill
2010-11,SAS,PG,76,5,2148,287,633,.453,77,204,.377,210,429,.490,.514,233,270,.863,24,175,199,193,66,21,99,153,884,George Hill
2011-12,IND,PG,50,9,1274,168,380,.442,54,147,.367,114,233,.489,.513,91,117,.778,31,120,151,145,42,17,52,98,481,George Hill
2012-13,IND,PG,76,76,2620,386,871,.443,130,353,.368,256,518,.494,.518,174,213,.817,47,237,284,355,81,26,116,134,1076,George Hill
2013-14,IND,PG,76,76,2434,272,616,.442,95,260,.365,177,356,.497,.519,142,176,.807,53,230,283,265,75,23,92,158,781,George Hill
2014-15,IND,PG,43,36,1267,255,535,.477,69,193,.358,186,342,.544,.541,113,143,.790,25,154,179,220,44,14,69,111,692,George Hill
2015-16,IND,PG,74,73,2524,326,739,.441,128,314,.408,198,425,.466,.528,114,150,.760,58,240,298,259,83,17,101,149,894,George Hill
2016-17,UTA,PG,49,49,1544,289,606,.477,94,233,.403,195,373,.523,.554,157,196,.801,23,144,167,204,50,11,85,114,829,George Hill
2017-18,2TM,PG,67,60,1812,236,513,.460,85,205,.415,151,308,.490,.543,110,140,.786,42,139,181,186,61,27,88,128,667,George Hill
2017-18,SAC,PG,43,36,1143,153,326,.469,58,128,.453,95,198,.480,.558,77,99,.778,22,95,117,119,39,12,60,75,441,George Hill
2017-18,CLE,PG,24,24,669,83,187,.444,27,77,.351,56,110,.509,.516,33,41,.805,20,44,64,67,22,15,28,53,226,George Hill
2018-19,2TM,PG,60,13,1302,170,376,.452,48,153,.314,122,223,.547,.516,70,85,.824,39,109,148,135,52,8,51,102,458,George Hill
2018-19,CLE,PG,13,13,344,55,107,.514,13,28,.464,42,79,.532,.575,17,20,.850,12,15,27,36,12,1,20,35,140,George Hill
2018-19,MIL,PG,47,0,958,115,269,.428,35,125,.280,80,144,.556,.493,53,65,.815,27,94,121,99,40,7,31,67,318,George Hill
2019-20,MIL,PG,59,2,1271,194,376,.516,81,176,.460,113,200,.565,.624,85,101,.842,50,127,177,180,47,5,57,84,554,George Hill
2020-21,2TM,PG,30,17,672,95,197,.482,31,80,.388,64,117,.547,.561,40,50,.800,16,45,61,73,23,5,31,31,261,George Hill
2020-21,OKC,PG,14,14,369,61,120,.508,22,57,.386,39,63,.619,.600,21,25,.840,8,21,29,43,12,2,12,12,165,George Hill
2020-21,PHI,PG,16,3,303,34,77,.442,9,23,.391,25,54,.463,.500,19,25,.760,8,24,32,30,11,3,19,19,96,George Hill
2021-22,MIL,PG,54,17,1253,118,275,.429,41,134,.306,77,141,.546,.504,57,62,.919,38,117,155,120,42,6,41,70,334,George Hill
2022-23,2TM,SG,46,1,834,78,166,.470,34,95,.358,44,71,.620,.572,42,55,.764,15,70,85,110,26,6,34,55,232,George Hill
2022-23,MIL,PG,35,0,668,59,132,.447,23,74,.311,36,58,.621,.534,34,46,.739,13,54,67,89,19,3,27,41,175,George Hill
2022-23,IND,SG,11,1,166,19,34,.559,11,21,.524,8,13,.615,.721,8,9,.889,2,16,18,21,7,3,7,14,57,George Hill
2021-22,2TM,SG,19,0,212,24,52,.462,13,36,.361,11,16,.688,.587,11,14,.786,11,24,35,8,7,3,3,24,72,Malcolm Hill
2021-22,ATL,SG,3,0,46,5,8,.625,3,5,.600,2,3,.667,.813,4,4,1.000,2,4,6,1,4,1,0,7,17,Malcolm Hill
2021-22,CHI,SF,16,0,166,19,44,.432,10,31,.323,9,13,.692,.545,7,10,.700,9,20,29,7,3,2,3,17,55,Malcolm Hill
2022-23,CHI,SF,5,0,9,2,4,.500,1,3,.333,1,1,1.000,.625,0,0,,0,3,3,0,0,0,0,1,5,Malcolm Hill
2020-21,DAL,SG,21,0,93,15,42,.357,4,19,.211,11,23,.478,.405,7,10,.700,1,8,9,8,7,2,5,8,41,Nate Hinton
2021-22,IND,SG,2,0,2,0,1,.000,0,0,,0,1,.000,.000,0,0,,0,0,0,0,0,0,1,0,0,Nate Hinton
2023-24,HOU,SG,15,0,75,11,26,.423,7,14,.500,4,12,.333,.558,4,5,.800,7,15,22,10,3,2,3,11,33,Nate Hinton
2023-24,LAL,SG,7,0,41,5,15,.333,3,12,.250,2,3,.667,.433,1,2,.500,0,0,0,5,1,1,1,4,14,D'Moi Hodge
2018-19,IND,PG,50,0,646,105,262,.401,43,127,.339,62,135,.459,.483,41,50,.820,5,62,67,87,21,13,40,71,294,Aaron Holiday
2019-20,IND,PG,66,33,1617,233,563,.414,87,221,.394,146,342,.427,.491,74,87,.851,22,134,156,225,55,16,88,120,627,Aaron Holiday
2020-21,IND,PG,66,8,1176,170,436,.390,67,182,.368,103,254,.406,.467,68,83,.819,15,74,89,123,46,13,66,94,475,Aaron Holiday
2021-22,2TM,PG,63,15,1021,151,338,.447,39,103,.379,112,235,.477,.504,59,68,.868,24,98,122,153,42,9,67,92,400,Aaron Holiday
2021-22,WAS,PG,41,14,663,100,214,.467,23,67,.343,77,147,.524,.521,28,35,.800,9,58,67,78,24,9,39,60,251,Aaron Holiday
2021-22,PHO,PG,22,1,358,51,124,.411,16,36,.444,35,88,.398,.476,31,33,.939,15,40,55,75,18,0,28,32,149,Aaron Holiday
2022-23,ATL,PG,63,6,845,92,220,.418,36,88,.409,56,132,.424,.500,27,32,.844,25,49,74,89,37,12,36,79,247,Aaron Holiday
2023-24,HOU,PG,78,1,1269,186,417,.446,84,217,.387,102,200,.510,.547,58,63,.921,23,100,123,140,42,6,53,125,514,Aaron Holiday
2024-25,HOU,PG,20,0,184,26,55,.473,17,39,.436,9,16,.563,.627,11,13,.846,0,18,18,23,5,2,6,12,80,Aaron Holiday
2009-10,PHI,PG,73,51,1767,230,520,.442,62,159,.390,168,361,.465,.502,65,86,.756,56,135,191,280,79,18,156,153,587,Jrue Holiday
2010-11,PHI,PG,82,82,2901,446,999,.446,81,222,.365,365,777,.470,.487,172,209,.823,68,264,332,531,120,29,218,203,1145,Jrue Holiday
2011-12,PHI,PG,65,65,2196,360,834,.432,65,171,.380,295,663,.445,.471,94,120,.783,57,155,212,290,103,18,135,137,879,Jrue Holiday
2012-13,PHI,PG,78,78,2926,555,1288,.431,91,247,.368,464,1041,.446,.466,182,242,.752,89,240,329,625,123,32,292,170,1383,Jrue Holiday
2013-14,NOP,PG,34,34,1143,203,454,.447,30,77,.390,173,377,.459,.480,51,63,.810,28,114,142,268,56,12,105,92,487,Jrue Holiday
2014-15,NOP,PG,40,37,1303,238,534,.446,51,135,.378,187,399,.469,.493,65,76,.855,32,103,135,274,63,23,91,110,592,Jrue Holiday
2015-16,NOP,PG,65,23,1831,410,935,.439,87,259,.336,323,676,.478,.485,182,216,.843,27,168,195,391,88,22,167,148,1089,Jrue Holiday
2016-17,NOP,PG,67,61,2190,405,893,.454,100,281,.356,305,612,.498,.510,119,168,.708,46,218,264,488,100,44,194,133,1029,Jrue Holiday
2017-18,NOP,SG,81,81,2927,615,1244,.494,120,356,.337,495,888,.557,.543,187,238,.786,62,303,365,486,123,64,213,201,1537,Jrue Holiday
2018-19,NOP,SG,67,67,2402,547,1159,.472,118,363,.325,429,796,.539,.523,208,271,.768,75,259,334,518,109,54,210,148,1420,Jrue Holiday
2019-20,NOP,SG,61,61,2117,458,1006,.455,122,346,.353,336,660,.509,.516,129,182,.709,77,216,293,408,99,48,184,145,1167,Jrue Holiday
2020-21,MIL,PG,59,56,1907,414,823,.503,111,283,.392,303,540,.561,.570,107,136,.787,73,195,268,357,96,37,127,98,1046,Jrue Holiday
2021-22,MIL,PG,67,64,2208,478,954,.501,132,321,.411,346,633,.547,.570,137,180,.761,69,232,301,457,108,29,183,133,1225,Jrue Holiday
2022-23,MIL,PG,67,65,2183,490,1023,.479,158,411,.384,332,612,.542,.556,152,177,.859,79,262,341,495,79,25,197,116,1290,Jrue Holiday
2023-24,BOS,PG,69,69,2263,331,689,.480,138,322,.429,193,367,.526,.581,60,72,.833,84,289,373,333,61,53,124,108,860,Jrue Holiday
2024-25,BOS,PG,26,26,796,116,259,.448,46,141,.326,70,118,.593,.537,40,45,.889,29,83,112,96,23,11,39,38,318,Jrue Holiday
2012-13,PHI,SG,9,0,142,16,48,.333,4,16,.250,12,32,.375,.375,6,8,.750,0,14,14,15,3,6,9,7,42,Justin Holiday
2014-15,GSW,SG,59,4,657,91,235,.387,35,109,.321,56,126,.444,.462,37,45,.822,12,61,73,48,40,12,29,54,254,Justin Holiday
2015-16,2TM,SG,53,5,773,88,228,.386,36,105,.343,52,123,.423,.465,27,37,.730,12,78,90,56,32,19,39,61,239,Justin Holiday
2015-16,ATL,SG,26,1,263,24,73,.329,10,45,.222,14,28,.500,.397,5,10,.500,4,23,27,11,13,4,13,21,63,Justin Holiday
2015-16,CHI,SG,27,4,510,64,155,.413,26,60,.433,38,95,.400,.497,22,27,.815,8,55,63,45,19,15,26,40,176,Justin Holiday
2016-17,NYK,SG,82,4,1639,233,538,.433,97,273,.355,136,265,.513,.523,66,80,.825,27,198,225,102,65,31,66,109,629,Justin Holiday
2017-18,CHI,SG,72,72,2265,290,782,.371,161,449,.359,129,333,.387,.474,135,164,.823,31,260,291,153,80,31,93,134,876,Justin Holiday
2018-19,2TM,SG,82,77,2607,300,777,.386,162,465,.348,138,312,.442,.490,95,106,.896,46,277,323,146,121,36,104,164,857,Justin Holiday
2018-19,CHI,SG,38,38,1325,151,394,.383,97,270,.359,54,124,.435,.506,41,46,.891,19,150,169,85,67,21,47,79,440,Justin Holiday
2018-19,MEM,SG,44,39,1282,149,383,.389,65,195,.333,84,188,.447,.474,54,60,.900,27,127,154,61,54,15,57,85,417,Justin Holiday
2019-20,IND,SF,73,6,1826,208,486,.428,134,331,.405,74,155,.477,.566,53,67,.791,32,206,238,93,87,46,44,137,603,Justin Holiday
2020-21,IND,SG,72,52,2183,258,625,.413,173,453,.382,85,172,.494,.551,67,85,.788,32,224,256,119,74,41,54,135,756,Justin Holiday
2021-22,2TM,SF,74,65,2057,261,662,.394,177,482,.367,84,180,.467,.528,50,62,.806,29,161,190,128,57,33,70,154,749,Justin Holiday
2021-22,IND,SF,49,40,1416,190,458,.415,127,336,.378,63,122,.516,.553,34,41,.829,18,117,135,90,36,18,49,105,541,Justin Holiday
2021-22,SAC,SG,25,25,641,71,204,.348,50,146,.342,21,58,.362,.471,16,21,.762,11,44,55,38,21,15,21,49,208,Justin Holiday
2022-23,2TM,SF,46,2,706,77,204,.377,46,143,.322,31,61,.508,.490,5,8,.625,5,50,55,41,19,19,22,68,205,Justin Holiday
2022-23,ATL,SF,28,0,411,48,125,.384,30,87,.345,18,38,.474,.504,0,0,,2,21,23,25,5,10,12,37,126,Justin Holiday
2022-23,DAL,SF,18,2,295,29,79,.367,16,56,.286,13,23,.565,.468,5,8,.625,3,29,32,16,14,9,10,31,79,Justin Holiday
2023-24,DEN,SG,58,9,862,88,194,.454,55,136,.404,33,58,.569,.595,3,4,.750,9,62,71,67,36,9,14,69,234,Justin Holiday
2024-25,DET,SF,31,1,486,76,161,.472,12,59,.203,64,102,.627,.509,27,34,.794,17,77,94,21,15,5,28,48,191,Ron Holland
2015-16,PHI,PF,51,1,702,114,222,.514,8,44,.182,106,178,.596,.532,51,74,.689,62,73,135,33,19,40,32,92,287,Richaun Holmes
2016-17,PHI,C,57,17,1193,230,412,.558,27,77,.351,203,335,.606,.591,72,103,.699,94,217,311,58,42,55,55,136,559,Richaun Holmes
2017-18,PHI,C,48,2,746,135,241,.560,4,31,.129,131,210,.624,.568,37,56,.661,57,154,211,61,20,29,25,97,311,Richaun Holmes
2018-19,PHO,C,70,4,1184,222,365,.608,0,0,,222,365,.608,.608,128,175,.731,115,216,331,60,42,79,52,194,572,Richaun Holmes
2019-20,SAC,C,44,38,1242,223,344,.648,0,0,,223,344,.648,.648,93,118,.788,127,231,358,42,41,56,52,169,539,Richaun Holmes
2020-21,SAC,C,61,61,1782,366,575,.637,2,11,.182,364,564,.645,.638,135,170,.794,144,360,504,101,39,96,75,213,869,Richaun Holmes
2021-22,SAC,C,45,37,1074,198,300,.660,2,5,.400,196,295,.664,.663,70,90,.778,93,224,317,48,17,41,56,128,468,Richaun Holmes
2022-23,SAC,C,42,1,348,55,89,.618,5,8,.625,50,81,.617,.646,15,19,.789,29,51,80,9,3,11,14,50,130,Richaun Holmes
2023-24,2TM,C,40,10,555,82,147,.558,1,3,.333,81,144,.563,.561,34,47,.723,71,111,182,25,11,19,24,74,199,Richaun Holmes
2023-24,DAL,C,23,2,237,33,59,.559,0,0,,33,59,.559,.559,12,21,.571,33,45,78,15,3,9,12,33,78,Richaun Holmes
2023-24,WAS,PF,17,8,318,49,88,.557,1,3,.333,48,85,.565,.563,22,26,.846,38,66,104,10,8,10,12,41,121,Richaun Holmes
2024-25,WAS,PF,4,0,24,5,11,.455,0,1,.000,5,10,.500,.455,2,2,1.000,3,4,7,0,0,2,2,1,12,Richaun Holmes
2023-24,OKC,C,82,82,2413,505,953,.530,129,349,.370,376,604,.623,.598,218,275,.793,129,519,648,200,53,190,131,197,1357,Chet Holmgren
2024-25,OKC,C,10,10,265,56,111,.505,14,37,.378,42,74,.568,.568,38,49,.776,16,71,87,20,8,26,23,18,164,Chet Holmgren
2023-24,LAL,SG,21,0,109,10,45,.222,2,15,.133,8,30,.267,.244,12,20,.600,2,11,13,8,3,2,9,13,34,Jalen Hood-Schifino
2024-25,LAL,SG,2,0,14,1,1,1.000,0,0,,1,1,1.000,1.000,2,2,1.000,1,0,1,1,0,1,1,3,4,Jalen Hood-Schifino
2013-14,CLE,SG,2,0,7,0,4,.000,0,2,.000,0,2,.000,.000,1,2,.500,0,0,0,1,1,0,0,0,1,Scotty Hopson
2017-18,DAL,SG,1,0,8,0,1,.000,0,0,,0,1,.000,.000,1,2,.500,0,0,0,1,0,0,1,0,1,Scotty Hopson
2021-22,OKC,SG,1,0,18,2,4,.500,0,1,.000,2,3,.667,.500,0,0,,0,1,1,1,0,0,2,1,4,Scotty Hopson
2007-08,ATL,C,81,77,2540,333,668,.499,0,5,.000,333,663,.502,.499,155,212,.731,248,537,785,124,60,76,137,267,821,Al Horford
2008-09,ATL,C,67,67,2242,312,594,.525,0,1,.000,312,593,.526,.525,149,205,.727,145,479,624,163,53,95,103,190,773,Al Horford
2009-10,ATL,C,81,81,2845,467,847,.551,1,1,1.000,466,846,.551,.552,213,270,.789,236,563,799,189,59,91,122,225,1148,Al Horford
2010-11,ATL,C,77,77,2704,513,921,.557,2,4,.500,511,917,.557,.558,150,188,.798,182,536,718,266,59,80,119,193,1178,Al Horford
2011-12,ATL,C,11,11,348,57,103,.553,0,1,.000,57,102,.559,.553,22,30,.733,26,51,77,24,10,14,16,21,136,Al Horford
2012-13,ATL,C,74,74,2756,576,1060,.543,3,6,.500,573,1054,.544,.545,134,208,.644,195,562,757,240,78,78,147,163,1289,Al Horford
2013-14,ATL,C,29,29,958,238,420,.567,4,11,.364,234,409,.572,.571,58,85,.682,66,178,244,76,27,44,64,56,538,Al Horford
2014-15,ATL,C,76,76,2318,519,965,.538,11,36,.306,508,929,.547,.544,107,141,.759,131,413,544,244,68,98,100,121,1156,Al Horford
2015-16,ATL,C,82,82,2631,529,1048,.505,88,256,.344,441,792,.557,.547,103,129,.798,148,448,596,263,68,121,107,163,1249,Al Horford
2016-17,BOS,C,68,68,2193,379,801,.473,86,242,.355,293,559,.524,.527,108,135,.800,95,370,465,337,52,86,115,138,952,Al Horford
2017-18,BOS,C,72,72,2277,368,753,.489,97,226,.429,271,527,.514,.553,94,120,.783,103,427,530,339,43,78,132,138,927,Al Horford
2018-19,BOS,C,68,68,1973,387,723,.535,73,203,.360,314,520,.604,.586,78,95,.821,120,338,458,283,59,86,102,126,925,Al Horford
2019-20,PHI,C,67,61,2025,319,709,.450,99,283,.350,220,426,.516,.520,61,80,.763,103,353,456,270,52,61,80,142,798,Al Horford
2020-21,OKC,C,28,28,782,162,360,.450,56,152,.368,106,208,.510,.528,18,22,.818,29,159,188,94,25,26,29,48,398,Al Horford
2021-22,BOS,C,69,69,2005,266,569,.467,89,265,.336,177,304,.582,.546,80,95,.842,108,422,530,232,49,92,65,130,701,Al Horford
2022-23,BOS,C,63,63,1922,228,479,.476,145,325,.446,83,154,.539,.627,15,21,.714,73,317,390,189,30,61,37,121,616,Al Horford
2023-24,BOS,C,65,33,1740,214,419,.511,108,258,.419,106,161,.658,.640,26,30,.867,82,331,413,168,38,62,48,93,562,Al Horford
2024-25,BOS,C,24,21,667,81,179,.453,51,127,.402,30,52,.577,.595,10,12,.833,22,106,128,52,16,22,23,37,223,Al Horford
2019-20,LAL,SG,6,1,81,14,30,.467,4,13,.308,10,17,.588,.533,2,4,.500,2,5,7,6,8,1,6,10,34,Talen Horton-Tucker
2020-21,LAL,SG,65,4,1304,224,489,.458,37,131,.282,187,358,.522,.496,100,129,.775,25,144,169,181,63,21,105,127,585,Talen Horton-Tucker
2021-22,LAL,SG,60,19,1511,224,538,.416,49,182,.269,175,356,.492,.462,100,125,.800,37,156,193,159,59,29,82,148,597,Talen Horton-Tucker
2022-23,UTA,SG,65,20,1313,257,613,.419,58,203,.286,199,410,.485,.467,126,168,.750,41,169,210,246,41,29,126,108,698,Talen Horton-Tucker
2023-24,UTA,PG,51,11,1009,184,465,.396,60,182,.330,124,283,.438,.460,88,109,.807,21,100,121,177,45,19,65,94,516,Talen Horton-Tucker
2024-25,CHI,SG,25,0,314,60,127,.472,22,57,.386,38,70,.543,.559,25,37,.676,11,39,50,40,9,5,14,26,167,Talen Horton-Tucker
2016-17,WAS,SG,1,0,1,0,0,,0,0,,0,0,,,0,0,,0,1,1,0,0,0,0,0,0,Danuel House Jr.
2017-18,PHO,SG,23,3,403,56,129,.434,15,58,.259,41,71,.577,.492,25,31,.806,13,63,76,25,7,6,11,23,152,Danuel House Jr.
2018-19,HOU,SF,39,13,979,118,252,.468,74,178,.416,44,74,.595,.615,56,71,.789,25,115,140,40,21,11,35,80,366,Danuel House Jr.
2019-20,HOU,SF,63,52,1913,230,539,.427,129,355,.363,101,184,.549,.546,73,90,.811,57,210,267,85,67,34,54,132,662,Danuel House Jr.
2020-21,HOU,SF,36,23,932,110,272,.404,54,156,.346,56,116,.483,.504,41,63,.651,18,114,132,69,20,16,36,67,315,Danuel House Jr.
2021-22,3TM,SF,42,7,727,80,198,.404,44,117,.376,36,81,.444,.515,44,58,.759,18,93,111,44,21,17,33,51,248,Danuel House Jr.
2021-22,HOU,SF,16,1,233,25,74,.338,10,34,.294,15,40,.375,.405,17,19,.895,4,39,43,19,5,5,18,16,77,Danuel House Jr.
2021-22,NYK,SF,1,0,3,0,1,.000,0,1,.000,0,0,,.000,0,0,,0,0,0,0,0,0,0,0,0,Danuel House Jr.
2021-22,UTA,SF,25,6,491,55,123,.447,34,82,.415,21,41,.512,.585,27,39,.692,14,54,68,25,16,12,15,35,171,Danuel House Jr.
2022-23,PHI,SF,56,5,807,93,197,.472,37,110,.336,56,87,.644,.566,45,60,.750,9,85,94,44,14,9,26,69,268,Danuel House Jr.
2023-24,PHI,SF,34,4,509,47,105,.448,15,50,.300,32,55,.582,.519,35,46,.761,16,42,58,28,15,5,19,45,144,Danuel House Jr.
2022-23,ORL,SF,51,4,812,66,182,.363,46,136,.338,20,46,.435,.489,15,18,.833,34,65,99,30,12,7,18,63,193,Caleb Houstan
2023-24,ORL,SF,59,13,815,80,206,.388,72,193,.373,8,13,.615,.563,21,26,.808,28,56,84,29,15,4,16,61,253,Caleb Houstan
2024-25,ORL,SF,20,0,115,8,29,.276,6,24,.250,2,5,.400,.379,2,2,1.000,2,7,9,3,0,2,1,6,24,Caleb Houstan
2023-24,ORL,SF,18,0,67,10,30,.333,7,25,.280,3,5,.600,.450,2,4,.500,1,6,7,6,2,2,3,4,29,Jett Howard
2024-25,ORL,SF,30,0,305,42,114,.368,27,84,.321,15,30,.500,.487,6,7,.857,11,23,34,13,5,6,12,27,117,Jett Howard
2022-23,HOU,PG,5,0,28,2,9,.222,2,8,.250,0,1,.000,.333,3,3,1.000,0,0,0,3,0,0,1,1,9,Trevor Hudgins
2018-19,ATL,SG,75,59,2048,275,657,.419,136,353,.385,139,304,.457,.522,41,56,.732,60,185,245,214,65,25,109,155,727,Kevin Huerter
2019-20,ATL,SG,56,48,1760,252,610,.413,127,334,.380,125,276,.453,.517,53,64,.828,35,193,228,213,51,27,87,139,684,Kevin Huerter
2020-21,ATL,SG,69,49,2126,316,731,.432,140,386,.363,176,345,.510,.528,50,64,.781,38,193,231,241,82,18,79,165,822,Kevin Huerter
2021-22,ATL,SF,74,60,2188,345,760,.454,160,411,.389,185,349,.530,.559,42,52,.808,32,222,254,203,55,26,91,185,892,Kevin Huerter
2022-23,SAC,SG,75,75,2203,420,866,.485,205,510,.402,215,356,.604,.603,95,131,.725,42,209,251,221,80,24,97,181,1140,Kevin Huerter
2023-24,SAC,SG,64,59,1562,248,560,.443,123,341,.361,125,219,.571,.553,36,47,.766,38,186,224,166,45,23,53,135,655,Kevin Huerter
2024-25,SAC,SG,27,15,683,98,228,.430,48,154,.312,50,74,.676,.535,16,23,.696,13,83,96,54,28,13,27,59,260,Kevin Huerter
2021-22,LAL,C,4,0,20,0,3,.000,0,2,.000,0,1,.000,.000,0,0,,1,3,4,1,1,1,1,1,0,Jay Huff
2022-23,WAS,C,7,0,95,15,25,.600,6,12,.500,9,13,.692,.720,15,16,.938,6,15,21,10,3,4,5,15,51,Jay Huff
2023-24,DEN,C,20,0,49,9,15,.600,3,9,.333,6,6,1.000,.700,2,2,1.000,2,9,11,2,2,3,1,9,23,Jay Huff
2024-25,MEM,C,28,1,423,88,171,.515,45,110,.409,43,61,.705,.646,33,43,.767,17,60,77,22,8,32,17,49,254,Jay Huff
2020-21,UTA,SF,18,0,64,10,30,.333,8,23,.348,2,7,.286,.467,3,4,.750,1,8,9,6,1,1,6,1,31,Elijah Hughes
2021-22,2TM,SG,36,4,434,47,144,.326,25,95,.263,22,49,.449,.413,7,9,.778,6,52,58,22,14,8,17,39,126,Elijah Hughes
2021-22,UTA,SF,14,1,112,15,36,.417,10,28,.357,5,8,.625,.556,3,3,1.000,2,15,17,6,4,1,7,7,43,Elijah Hughes
2021-22,POR,SG,22,3,322,32,108,.296,15,67,.224,17,41,.415,.366,4,6,.667,4,37,41,16,10,7,10,32,83,Elijah Hughes
2024-25,NYK,C,12,0,99,9,14,.643,0,0,9,14,.643,.643,4,8,.500,4,18,22,6,0,8,10,14,22,0,Ariel Hukporti
2021-22,NYK,SF,2,0,8,0,2,.000,0,0,0,2,.000,.000,0,0,1,0,1,1,1,0,1,1,0,0,,Feron Hunt
2019-20,ATL,SF,63,62,2018,280,683,.410,108,304,.355,172,379,.454,.489,110,144,.764,44,242,286,112,44,18,103,182,778,De'Andre Hunter
2020-21,ATL,SF,23,19,678,120,248,.484,31,95,.326,89,153,.582,.546,73,85,.859,17,93,110,44,19,12,29,59,344,De'Andre Hunter
2021-22,ATL,SF,53,52,1577,254,575,.442,74,195,.379,180,380,.474,.506,127,166,.765,26,150,176,68,36,21,69,155,709,De'Andre Hunter
2022-23,ATL,SF,67,67,2126,379,822,.461,100,286,.350,279,536,.521,.522,171,207,.826,46,238,284,94,35,17,82,199,1029,De'Andre Hunter
2023-24,ATL,SF,57,37,1681,304,663,.459,117,304,.385,187,359,.521,.547,166,196,.847,31,191,222,87,40,16,83,146,891,De'Andre Hunter
2024-25,ATL,SF,20,2,564,131,269,.487,55,125,.440,76,144,.528,.589,89,99,.899,12,70,82,25,14,3,28,48,406,De'Andre Hunter
2015-16,BOS,SG,36,0,315,36,98,.367,19,63,.302,17,35,.486,.464,6,7,.857,2,35,37,13,14,4,11,29,97,R.J. Hunter
2016-17,CHI,SG,3,0,9,0,1,.000,0,1,.000,0,0,,.000,0,0,,0,1,1,0,0,0,0,0,0,R.J. Hunter
2017-18,HOU,SG,5,1,45,7,20,.350,3,14,.214,4,6,.667,.425,2,2,1.000,0,5,5,3,3,0,2,7,19,R.J. Hunter
2018-19,BOS,SG,1,0,26,6,13,.462,4,10,.400,2,3,.667,.615,1,2,.500,1,2,3,3,1,0,0,3,17,R.J. Hunter
2023-24,MEM,PF,8,0,113,12,34,.353,5,20,.250,7,14,.500,.426,3,3,1.000,9,7,16,4,3,3,2,8,32,Matthew Hurt
2018-19,CHI,SF,44,14,895,96,209,.459,14,50,.280,82,159,.516,.493,23,38,.605,31,154,185,34,23,6,25,59,229,Chandler Hutchison
2019-20,CHI,SF,28,10,527,80,175,.457,12,38,.316,68,137,.496,.491,46,78,.590,18,90,108,26,27,7,27,47,218,Chandler Hutchison
2020-21,2TM,SF,25,1,346,39,103,.379,8,22,.364,31,81,.383,.417,21,25,.840,6,72,78,17,12,5,20,33,107,Chandler Hutchison
2020-21,CHI,SF,7,0,64,5,18,.278,1,3,.333,4,15,.267,.306,2,2,1.000,1,19,20,4,1,0,5,9,13,Chandler Hutchison
2020-21,WAS,SF,18,1,282,34,85,.400,7,19,.368,27,66,.409,.441,19,23,.826,5,53,58,13,11,5,15,24,94,Chandler Hutchison
2021-22,PHO,SF,6,0,22,1,2,.500,0,0,,1,2,.500,.500,2,2,1.000,0,5,5,2,0,0,4,1,4,Chandler Hutchison
2021-22,DEN,SG,69,4,1310,230,571,.403,131,358,.366,99,213,.465,.518,107,125,.856,14,174,188,191,41,20,86,153,698,Bones Hyland
2022-23,2TM,PG,56,1,1085,228,571,.399,117,315,.371,111,256,.434,.502,86,102,.843,20,115,135,172,39,15,82,96,659,Bones Hyland
2022-23,DEN,PG,42,1,820,173,434,.399,91,241,.378,82,193,.425,.503,71,82,.866,10,76,86,125,28,13,67,66,508,Bones Hyland
2022-23,LAC,PG,14,0,265,55,137,.401,26,74,.351,29,63,.460,.496,15,20,.750,10,39,49,47,11,2,15,30,151,Bones Hyland
2023-24,LAC,PG,37,5,540,97,251,.386,44,135,.326,53,116,.457,.474,18,23,.783,5,50,55,93,26,4,44,51,256,Bones Hyland
2024-25,LAC,PG,12,0,137,30,73,.411,23,52,.442,7,21,.333,.568,15,18,.833,3,10,13,14,11,4,15,15,98,Bones Hyland
2024-25,PHO,PF,24,2,376,42,66,.636,0,0,42,66,.636,.636,11,19,.579,23,65,88,21,10,7,12,38,95,0,Oso Ighodaro
2014-15,UTA,SF,79,32,1673,147,354,.415,72,202,.356,75,152,.493,.517,30,40,.750,22,153,175,182,72,10,98,124,396,Joe Ingles
2015-16,UTA,SF,81,2,1241,124,291,.426,81,210,.386,43,81,.531,.565,13,18,.722,19,132,151,96,55,4,65,98,342,Joe Ingles
2016-17,UTA,SF,82,26,1972,204,451,.452,123,279,.441,81,172,.471,.589,50,68,.735,23,238,261,225,96,8,107,163,581,Joe Ingles
2017-18,UTA,SF,82,81,2578,335,718,.467,204,464,.440,131,254,.516,.609,66,83,.795,24,320,344,392,90,20,159,178,940,Joe Ingles
2018-19,UTA,PF,82,82,2568,359,802,.448,189,483,.391,170,319,.533,.565,87,123,.707,35,295,330,469,98,20,193,180,994,Joe Ingles
2019-20,UTA,PF,72,45,2137,246,553,.445,141,353,.399,105,200,.525,.572,74,94,.787,27,251,278,373,65,11,142,154,707,Joe Ingles
2020-21,UTA,SF,67,30,1867,275,562,.489,183,406,.451,92,156,.590,.652,76,90,.844,27,217,244,318,45,12,117,120,809,Joe Ingles
2021-22,UTA,SF,45,15,1122,115,285,.404,78,225,.347,37,60,.617,.540,17,22,.773,12,119,131,158,23,5,46,82,325,Joe Ingles
2022-23,MIL,SF,46,0,1044,108,248,.435,83,203,.409,25,45,.556,.603,18,21,.857,13,115,128,150,33,6,55,74,317,Joe Ingles
2023-24,ORL,SF,68,0,1169,99,227,.436,70,161,.435,29,66,.439,.590,28,34,.824,18,124,142,203,43,5,67,88,296,Joe Ingles
2024-25,MIN,SF,7,0,26,0,2,.000,0,2,.000,0,0,,.000,0,0,,2,0,2,9,0,0,1,5,0,Joe Ingles
2016-17,LAL,SF,79,40,2279,276,686,.402,55,187,.294,221,499,.443,.442,133,214,.621,60,256,316,166,50,36,116,158,740,Brandon Ingram
2017-18,LAL,SF,59,59,1975,358,761,.470,41,105,.390,317,656,.483,.497,192,282,.681,57,257,314,230,45,43,149,163,949,Brandon Ingram
2018-19,LAL,SF,52,52,1760,362,729,.497,31,94,.330,331,635,.521,.518,195,289,.675,41,226,267,154,28,31,129,149,950,Brandon Ingram
2019-20,NOP,PF,62,62,2104,507,1096,.463,150,384,.391,357,712,.501,.531,313,368,.851,51,329,380,259,61,38,189,179,1477,Brandon Ingram
2020-21,NOP,SF,61,61,2093,513,1101,.466,143,375,.381,370,726,.510,.531,281,320,.878,34,265,299,296,42,36,154,124,1450,Brandon Ingram
2021-22,NOP,SF,55,55,1869,453,983,.461,74,226,.327,379,757,.501,.498,266,322,.826,35,285,320,307,34,26,151,119,1246,Brandon Ingram
2022-23,NOP,SF,45,45,1538,404,835,.484,64,164,.390,340,671,.507,.522,240,272,.882,23,223,246,262,32,19,148,116,1112,Brandon Ingram
2023-24,NOP,SF,64,64,2103,500,1017,.492,86,242,.355,414,775,.534,.534,246,307,.801,43,281,324,363,50,40,163,145,1332,Brandon Ingram
2024-25,NOP,SF,18,18,595,155,333,.465,43,115,.374,112,218,.514,.530,47,55,.855,17,83,100,93,16,11,69,45,400,Brandon Ingram
2024-25,SAS,SF,1,0,7,0,1,.000,0,0,0,1,.000,.000,0,0,0,1,1,0,0,0,0,1,0,0,,Harrison Ingram
2011-12,CLE,PG,51,51,1558,350,747,.469,73,183,.399,277,564,.491,.517,171,196,.872,44,147,191,275,54,20,160,110,944,Kyrie Irving
2012-13,CLE,PG,59,59,2048,484,1070,.452,109,279,.391,375,791,.474,.503,248,290,.855,34,182,216,350,89,21,191,146,1325,Kyrie Irving
2013-14,CLE,PG,71,71,2496,532,1237,.430,123,344,.358,409,893,.458,.480,291,338,.861,52,207,259,433,108,23,190,163,1478,Kyrie Irving
2014-15,CLE,PG,75,75,2730,578,1235,.468,157,378,.415,421,857,.491,.532,315,365,.863,55,182,237,389,114,20,186,146,1628,Kyrie Irving
2015-16,CLE,PG,53,53,1667,394,879,.448,84,262,.321,310,617,.502,.496,169,191,.885,44,113,157,249,56,18,124,107,1041,Kyrie Irving
2016-17,CLE,PG,72,72,2525,671,1420,.473,177,441,.401,494,979,.505,.535,297,328,.905,52,178,230,418,83,24,180,157,1816,Kyrie Irving
2017-18,BOS,PG,60,60,1931,534,1087,.491,166,407,.408,368,680,.541,.568,232,261,.889,33,194,227,306,65,17,140,122,1466,Kyrie Irving
2018-19,BOS,PG,67,67,2214,604,1241,.487,174,434,.401,430,807,.533,.557,214,245,.873,71,264,335,464,103,34,172,167,1596,Kyrie Irving
2019-20,BRK,PG,20,20,658,199,416,.478,56,142,.394,143,274,.522,.546,94,102,.922,22,81,103,128,27,10,52,53,548,Kyrie Irving
2020-21,BRK,PG,54,54,1886,549,1086,.506,152,378,.402,397,708,.561,.576,201,218,.922,52,205,257,324,76,37,130,140,1451,Kyrie Irving
2021-22,BRK,PG,29,29,1091,289,616,.469,100,239,.418,189,377,.501,.550,118,129,.915,16,111,127,167,41,17,73,81,796,Kyrie Irving
2022-23,2TM,SG,60,60,2241,594,1203,.494,188,496,.379,406,707,.574,.572,247,273,.905,59,245,304,331,66,45,128,165,1623,Kyrie Irving
2022-23,BRK,PG,40,40,1478,398,819,.486,130,348,.374,268,471,.569,.565,158,179,.883,38,166,204,211,41,33,91,109,1084,Kyrie Irving
2022-23,DAL,SG,20,20,763,196,384,.510,58,148,.392,138,236,.585,.586,89,94,.947,21,79,100,120,25,12,37,56,539,Kyrie Irving
2023-24,DAL,SG,58,58,2030,562,1131,.497,173,421,.411,389,710,.548,.573,190,210,.905,44,246,290,299,74,28,106,112,1487,Kyrie Irving
2024-25,DAL,SG,28,28,992,246,510,.482,88,197,.447,158,313,.505,.569,87,97,.897,30,98,128,143,31,8,60,61,667,Kyrie Irving
2017-18,ORL,PF,27,10,536,55,145,.379,16,46,.348,39,99,.394,.434,19,25,.760,16,83,99,18,33,30,27,48,145,Jonathan Isaac
2018-19,ORL,PF,75,64,1996,262,611,.429,86,266,.323,176,345,.510,.499,110,135,.815,99,312,411,80,59,98,75,143,720,Jonathan Isaac
2019-20,ORL,PF,34,32,980,156,332,.470,32,94,.340,124,238,.521,.518,60,77,.779,58,173,231,48,53,78,49,83,404,Jonathan Isaac
2022-23,ORL,PF,11,0,124,22,53,.415,6,15,.400,16,38,.421,.472,5,9,.556,15,29,44,6,14,4,4,5,55,Jonathan Isaac
2023-24,ORL,PF,58,2,914,146,286,.510,42,112,.375,104,174,.598,.584,59,82,.720,73,187,260,30,43,70,27,64,393,Jonathan Isaac
2024-25,ORL,PF,27,0,448,57,140,.407,19,72,.264,38,68,.559,.475,23,34,.676,43,79,122,8,23,35,12,39,156,Jonathan Isaac
2022-23,DET,SG,74,73,2304,409,983,.416,120,350,.343,289,633,.457,.477,266,356,.747,73,215,288,387,61,17,237,242,1204,Jaden Ivey
2023-24,DET,SG,77,61,2217,417,973,.429,124,369,.336,293,604,.485,.492,227,303,.749,86,178,264,296,57,41,190,204,1185,Jaden Ivey
2024-25,DET,SG,28,28,850,175,393,.445,56,145,.386,119,248,.480,.517,83,113,.735,39,81,120,114,27,11,81,67,489,Jaden Ivey
2017-18,ORL,SF,62,12,1020,93,218,.427,9,46,.196,84,172,.488,.447,34,47,.723,36,101,137,57,33,12,30,81,229,Wes Iwundu
2018-19,ORL,SF,68,13,1233,113,274,.412,29,79,.367,84,195,.431,.465,84,103,.816,37,147,184,73,28,22,44,123,339,Wes Iwundu
2019-20,ORL,SF,52,21,953,97,233,.416,28,82,.341,69,151,.457,.476,78,97,.804,24,107,131,60,25,13,26,80,300,Wes Iwundu
2020-21,2TM,SF,41,4,539,34,102,.333,5,41,.122,29,61,.475,.358,26,31,.839,15,75,90,18,15,4,19,49,99,Wes Iwundu
2020-21,DAL,SF,23,3,288,17,52,.327,3,23,.130,14,29,.483,.356,12,14,.857,6,38,44,10,9,3,6,26,49,Wes Iwundu
2020-21,NOP,SF,18,1,251,17,50,.340,2,18,.111,15,32,.469,.360,14,17,.824,9,37,46,8,6,1,13,23,50,Wes Iwundu
2021-22,ATL,SF,3,1,82,8,18,.444,3,5,.600,5,13,.385,.528,3,4,.750,3,10,13,0,1,0,1,8,22,Wes Iwundu
2023-24,MIL,SG,57,8,572,50,100,.500,17,46,.370,33,54,.611,.585,8,11,.727,43,70,113,50,16,6,28,92,125,Andre Jackson Jr.
2024-25,MIL,SG,28,20,512,40,100,.400,18,50,.360,22,50,.440,.490,7,13,.538,26,65,91,43,19,7,35,68,105,Andre Jackson Jr.
2018-19,NOP,PG,61,16,1169,194,447,.434,53,169,.314,141,278,.507,.493,54,73,.740,25,109,134,69,25,2,48,92,495,Frank Jackson
2019-20,NOP,PG,59,2,797,134,331,.405,47,144,.326,87,187,.465,.476,56,75,.747,22,61,83,61,17,4,49,77,371,Frank Jackson
2020-21,DET,PG,40,6,738,134,293,.457,61,150,.407,73,143,.510,.561,61,75,.813,15,71,86,36,15,1,34,53,390,Frank Jackson
2021-22,DET,PG,53,7,1164,194,483,.402,86,279,.308,108,204,.529,.491,86,104,.827,19,68,87,55,27,9,38,89,560,Frank Jackson
2022-23,UTA,PG,1,0,5,0,3,.000,0,1,.000,0,2,.000,.000,0,0,,1,1,2,1,0,0,0,0,0,Frank Jackson
2023-24,MEM,PF,48,18,1233,241,563,.428,102,286,.357,139,277,.502,.519,115,153,.752,53,143,196,59,28,24,65,64,699,GG Jackson II
2021-22,IND,C,36,15,541,116,206,.563,5,16,.313,111,190,.584,.575,60,88,.682,60,89,149,10,25,52,40,92,297,Isaiah Jackson
2022-23,IND,C,63,12,1042,179,318,.563,2,14,.143,177,304,.582,.566,95,146,.651,113,169,282,51,31,93,51,154,455,Isaiah Jackson
2023-24,IND,C,59,3,771,155,233,.665,0,4,.000,155,229,.677,.665,73,102,.716,94,144,238,50,34,61,39,137,383,Isaiah Jackson
2024-25,IND,C,5,1,84,14,23,.609,0,0,,14,23,.609,.609,7,14,.500,11,17,28,5,3,8,5,14,35,Isaiah Jackson
2018-19,MEM,PF,58,56,1515,298,589,.506,51,142,.359,247,447,.553,.549,151,197,.766,73,199,272,64,52,82,98,220,798,Jaren Jackson Jr.
2019-20,MEM,C,57,57,1622,353,753,.469,145,368,.394,208,385,.540,.565,139,186,.747,55,207,262,78,40,92,99,232,990,Jaren Jackson Jr.
2020-21,MEM,C,11,4,258,53,125,.424,17,60,.283,36,65,.554,.492,35,42,.833,17,45,62,12,12,18,15,42,158,Jaren Jackson Jr.
2021-22,MEM,PF,78,78,2126,430,1036,.415,128,401,.319,302,635,.476,.477,284,345,.823,119,335,454,86,73,177,130,272,1272,Jaren Jackson Jr.
2022-23,MEM,C,63,63,1787,416,822,.506,100,282,.355,316,540,.585,.567,241,306,.788,108,318,426,60,65,189,107,227,1173,Jaren Jackson Jr.
2023-24,MEM,C,66,66,2124,516,1162,.444,117,366,.320,399,796,.501,.494,337,417,.808,85,280,365,154,80,106,160,235,1486,Jaren Jackson Jr.
2024-25,MEM,C,30,30,848,237,471,.503,55,152,.362,182,319,.571,.562,128,157,.815,41,138,179,51,44,52,62,96,657,Jaren Jackson Jr.
2017-18,PHO,SF,77,35,1959,389,932,.417,57,217,.263,332,715,.464,.448,177,279,.634,95,256,351,119,80,35,146,218,1012,Josh Jackson
2018-19,PHO,SG,79,29,1988,347,841,.413,73,225,.324,274,616,.445,.456,143,213,.671,66,281,347,183,74,56,173,209,910,Josh Jackson
2019-20,MEM,SF,22,0,381,70,159,.440,23,72,.319,47,87,.540,.513,35,50,.700,11,55,66,35,18,9,28,40,198,Josh Jackson
2020-21,DET,SG,62,25,1560,296,707,.419,77,257,.300,219,450,.487,.473,159,218,.729,57,197,254,143,53,47,142,178,828,Josh Jackson
2021-22,2TM,SF,51,3,830,120,300,.400,33,130,.254,87,170,.512,.455,55,77,.714,21,120,141,54,26,22,47,88,328,Josh Jackson
2021-22,DET,SF,39,3,707,103,251,.410,30,113,.265,73,138,.529,.470,40,56,.714,17,106,123,49,21,18,38,71,276,Josh Jackson
2021-22,SAC,SF,12,0,123,17,49,.347,3,17,.176,14,32,.438,.378,15,21,.714,4,14,18,5,5,4,9,17,52,Josh Jackson
2017-18,SAC,SF,68,41,1506,185,419,.442,57,185,.308,128,234,.547,.510,26,36,.722,27,160,187,74,28,13,40,81,453,Justin Jackson
2018-19,2TM,SF,81,14,1614,217,485,.447,87,245,.355,130,240,.542,.537,62,79,.785,44,168,212,96,32,14,29,99,583,Justin Jackson
2018-19,SAC,SF,52,3,1083,125,295,.424,55,159,.346,70,136,.515,.517,41,50,.820,25,121,146,68,23,13,22,67,346,Justin Jackson
2018-19,DAL,SF,29,11,531,92,190,.484,32,86,.372,60,104,.577,.568,21,29,.724,19,47,66,28,9,1,7,32,237,Justin Jackson
2019-20,DAL,PF,65,3,1045,135,341,.396,48,163,.294,87,178,.489,.466,42,50,.840,27,127,154,52,15,10,14,69,360,Justin Jackson
2020-21,2TM,SF,34,3,577,89,221,.403,36,117,.308,53,104,.510,.484,31,37,.838,16,61,77,52,15,2,32,32,245,Justin Jackson
2020-21,OKC,SF,33,3,544,86,212,.406,34,111,.306,52,101,.515,.486,30,35,.857,14,57,71,51,15,2,31,31,236,Justin Jackson
2020-21,MIL,SF,1,0,33,3,9,.333,2,6,.333,1,3,.333,.444,1,2,.500,2,4,6,1,0,0,1,1,9,Justin Jackson
2021-22,2TM,SF,7,0,37,5,15,.333,3,9,.333,2,6,.333,.433,2,2,1.000,1,6,7,2,0,0,1,3,15,Justin Jackson
2021-22,BOS,SF,1,0,2,0,1,.000,0,0,,0,1,.000,.000,2,2,1.000,0,0,0,0,0,0,0,0,2,Justin Jackson
2021-22,PHO,SF,6,0,35,5,14,.357,3,9,.333,2,5,.400,.464,0,0,,1,6,7,2,0,0,1,3,13,Justin Jackson
2022-23,BOS,SF,23,0,107,7,27,.259,5,20,.250,2,7,.286,.352,1,2,.500,2,15,17,9,4,4,2,7,20,Justin Jackson
2023-24,MIN,SF,2,0,1,0,0,,0,0,,0,0,,,0,0,,0,0,0,0,0,0,0,0,0,Justin Jackson
2022-23,WAS,PG,9,0,135,19,42,.452,1,12,.083,18,30,.600,.464,17,22,.773,2,6,8,15,4,1,4,10,56,Quenton Jackson
2023-24,IND,PG,3,0,11,0,1,.000,0,0,,0,1,.000,.000,2,2,1.000,0,4,4,2,1,0,0,1,2,Quenton Jackson
2024-25,IND,PG,16,7,251,39,75,.520,9,24,.375,30,51,.588,.580,15,21,.714,10,17,27,31,9,5,11,32,102,Quenton Jackson
2011-12,OKC,PG,45,0,501,51,159,.321,13,62,.210,38,97,.392,.362,25,29,.862,14,39,53,71,25,1,36,31,140,Reggie Jackson
2012-13,OKC,PG,70,0,993,149,325,.458,24,104,.231,125,221,.566,.495,52,62,.839,21,145,166,122,29,13,53,84,374,Reggie Jackson
2013-14,OKC,PG,80,36,2277,403,916,.440,83,245,.339,320,671,.477,.485,158,177,.893,43,270,313,331,85,9,168,142,1047,Reggie Jackson
2014-15,2TM,PG,77,40,2268,432,996,.434,72,241,.299,360,755,.477,.470,181,218,.830,56,271,327,462,62,9,186,167,1117,Reggie Jackson
2014-15,OKC,PG,50,13,1398,249,576,.432,44,158,.278,205,418,.490,.470,99,115,.861,28,173,201,214,42,5,91,94,641,Reggie Jackson
2014-15,DET,PG,27,27,870,183,420,.436,28,83,.337,155,337,.460,.469,82,103,.796,28,98,126,248,20,4,95,73,476,Reggie Jackson
2015-16,DET,PG,79,79,2424,540,1244,.434,118,334,.353,422,910,.464,.482,291,337,.864,58,195,253,492,59,11,223,187,1489,Reggie Jackson
2016-17,DET,PG,52,50,1424,284,677,.419,66,184,.359,218,493,.442,.468,118,136,.868,21,93,114,270,35,5,114,129,752,Reggie Jackson
2017-18,DET,PG,45,45,1201,246,577,.426,52,169,.308,194,408,.475,.471,112,134,.836,29,96,125,238,27,4,99,87,656,Reggie Jackson
2018-19,DET,PG,82,82,2289,441,1047,.421,174,471,.369,267,576,.464,.504,204,236,.864,45,171,216,344,55,9,148,208,1260,Reggie Jackson
2019-20,2TM,PG,31,16,743,134,326,.411,57,145,.393,77,181,.425,.498,45,54,.833,17,75,92,126,13,5,51,59,370,Reggie Jackson
2019-20,DET,PG,14,10,381,76,198,.384,31,82,.378,45,116,.388,.462,26,33,.788,11,30,41,72,8,1,23,21,209,Reggie Jackson
2019-20,LAC,PG,17,6,362,58,128,.453,26,63,.413,32,65,.492,.555,19,21,.905,6,45,51,54,5,4,28,38,161,Reggie Jackson
2020-21,LAC,SG,67,43,1544,263,585,.450,122,282,.433,141,303,.465,.554,67,82,.817,24,168,192,205,41,7,74,127,715,Reggie Jackson
2021-22,LAC,SG,75,75,2337,479,1222,.392,167,512,.326,312,710,.439,.460,138,163,.847,39,232,271,359,55,15,173,159,1263,Reggie Jackson
2022-23,2TM,PG,68,40,1657,263,640,.411,96,288,.333,167,352,.474,.486,71,78,.910,25,119,144,233,47,6,115,114,693,Reggie Jackson
2022-23,LAC,PG,52,38,1338,214,512,.418,77,220,.350,137,292,.469,.493,61,66,.924,22,94,116,183,38,5,96,92,566,Reggie Jackson
2022-23,DEN,PG,16,2,319,49,128,.383,19,68,.279,30,60,.500,.457,10,12,.833,3,25,28,50,9,1,19,22,127,Reggie Jackson
2023-24,DEN,PG,82,23,1817,326,756,.431,102,284,.359,224,472,.475,.499,79,98,.806,33,122,155,308,44,13,106,149,833,Reggie Jackson
2024-25,PHI,PG,13,0,147,18,47,.383,12,30,.400,6,17,.353,.511,0,0,,2,11,13,24,7,3,7,10,48,Reggie Jackson
2023-24,GSW,PF,68,16,1130,233,332,.702,0,1,.000,233,331,.704,.702,74,132,.561,135,206,341,82,29,76,49,108,540,Trayce Jackson-Davis
2024-25,GSW,C,29,22,528,105,168,.625,0,1,.000,105,167,.629,.625,27,46,.587,56,100,156,61,10,22,24,37,237,Trayce Jackson-Davis
2024-25,LAL,SG,7,0,18,1,8,.125,0,4,.000,1,4,.250,.125,2,2,1.000,1,0,1,2,1,1,0,2,4,Bronny James
2019-20,SAC,SF,36,0,232,35,84,.417,9,29,.310,26,55,.473,.470,10,21,.476,6,26,32,18,6,9,8,17,89,Justin James
2020-21,SAC,SF,36,0,310,52,111,.468,14,38,.368,38,73,.521,.532,21,36,.583,9,21,30,22,8,3,15,23,139,Justin James
2003-04,CLE,SG,79,79,3122,622,1492,.417,63,217,.290,559,1275,.438,.438,347,460,.754,99,333,432,465,130,58,273,149,1654,LeBron James
2004-05,CLE,SF,80,80,3388,795,1684,.472,108,308,.351,687,1376,.499,.504,477,636,.750,111,477,588,577,177,52,262,146,2175,LeBron James
2005-06,CLE,SF,79,79,3361,875,1823,.480,127,379,.335,748,1444,.518,.515,601,814,.738,75,481,556,521,123,66,260,181,2478,LeBron James
2006-07,CLE,SF,78,78,3190,772,1621,.476,99,310,.319,673,1311,.513,.507,489,701,.698,83,443,526,470,125,55,250,171,2132,LeBron James
2007-08,CLE,SF,75,74,3027,794,1642,.484,113,359,.315,681,1283,.531,.518,549,771,.712,133,459,592,539,138,81,255,165,2250,LeBron James
2008-09,CLE,SF,81,81,3054,789,1613,.489,132,384,.344,657,1229,.535,.530,594,762,.780,106,507,613,587,137,93,241,139,2304,LeBron James
2009-10,CLE,SF,76,76,2966,768,1528,.503,129,387,.333,639,1141,.560,.545,593,773,.767,71,483,554,651,125,77,261,119,2258,LeBron James
2010-11,MIA,SF,79,79,3063,758,1485,.510,92,279,.330,666,1206,.552,.541,503,663,.759,80,510,590,554,124,50,284,163,2111,LeBron James
2011-12,MIA,SF,62,62,2326,621,1169,.531,54,149,.362,567,1020,.556,.554,387,502,.771,94,398,492,387,115,50,213,96,1683,LeBron James
2012-13,MIA,PF,76,76,2877,765,1354,.565,103,254,.406,662,1100,.602,.603,403,535,.753,97,513,610,551,129,67,226,110,2036,LeBron James
2013-14,MIA,PF,77,77,2902,767,1353,.567,116,306,.379,651,1047,.622,.610,439,585,.750,81,452,533,488,121,26,270,126,2089,LeBron James
2014-15,CLE,SF,69,69,2493,624,1279,.488,120,339,.354,504,940,.536,.535,375,528,.710,51,365,416,511,109,49,272,135,1743,LeBron James
2015-16,CLE,SF,76,76,2709,737,1416,.520,87,282,.309,650,1134,.573,.551,359,491,.731,111,454,565,514,104,49,249,143,1920,LeBron James
2016-17,CLE,SF,74,74,2794,736,1344,.548,124,342,.363,612,1002,.611,.594,358,531,.674,97,542,639,646,92,44,303,134,1954,LeBron James
2017-18,CLE,PF,82,82,3026,857,1580,.542,149,406,.367,708,1174,.603,.590,388,531,.731,97,612,709,747,116,71,347,136,2251,LeBron James
2018-19,LAL,SF,55,55,1937,558,1095,.510,111,327,.339,447,768,.582,.560,278,418,.665,57,408,465,454,72,33,197,94,1505,LeBron James
2019-20,LAL,PG,67,67,2316,643,1303,.493,148,425,.348,495,878,.564,.550,264,381,.693,66,459,525,684,78,36,261,118,1698,LeBron James
2020-21,LAL,PG,45,45,1504,422,823,.513,104,285,.365,318,538,.591,.576,178,255,.698,29,317,346,350,48,25,168,70,1126,LeBron James
2021-22,LAL,C,56,56,2084,640,1221,.524,161,448,.359,479,773,.620,.590,254,336,.756,63,396,459,349,73,59,196,121,1695,LeBron James
2022-23,LAL,PF,55,54,1954,609,1219,.500,121,377,.321,488,842,.580,.549,251,327,.768,65,392,457,375,50,32,178,88,1590,LeBron James
2023-24,LAL,PF,71,71,2504,685,1269,.540,149,363,.410,536,906,.592,.599,303,404,.750,61,457,518,589,89,38,245,78,1822,LeBron James
2024-25,LAL,SF,28,28,981,251,506,.496,56,157,.357,195,349,.559,.551,99,129,.767,27,193,220,252,23,17,108,37,657,LeBron James
2023-24,MIA,SF,75,20,2113,341,697,.489,65,202,.322,276,495,.558,.536,142,175,.811,82,203,285,195,77,20,110,167,889,Jaime Jaquez Jr.
2024-25,MIA,SF,24,3,524,77,182,.423,14,50,.280,63,132,.477,.462,46,61,.754,30,83,113,54,26,3,39,41,214,Jaime Jaquez Jr.
2021-22,IND,SG,1,0,1,0,0,,0,0,,0,0,,,0,0,,0,0,0,0,0,0,0,0,0,DeJon Jarreau
2023-24,MEM,SG,9,0,150,17,50,.340,4,13,.308,13,37,.351,.380,5,11,.455,8,36,44,26,6,2,9,14,43,DeJon Jarreau
2019-20,SAC,SG,13,0,141,20,40,.500,5,18,.278,15,22,.682,.563,5,6,.833,3,15,18,7,4,1,2,19,50,DaQuan Jeffries
2020-21,2TM,SG,31,5,493,50,120,.417,20,67,.299,30,53,.566,.500,7,8,.875,19,52,71,22,15,10,14,48,127,DaQuan Jeffries
2020-21,SAC,SG,18,2,232,24,57,.421,9,28,.321,15,29,.517,.500,6,7,.857,9,20,29,6,7,4,8,23,63,DaQuan Jeffries
2020-21,HOU,SG,13,3,261,26,63,.413,11,39,.282,15,24,.625,.500,1,1,1.000,10,32,42,16,8,6,6,25,64,DaQuan Jeffries
2021-22,MEM,SG,3,0,9,1,2,.500,0,1,.000,1,1,1.000,.500,0,0,,0,2,2,1,0,0,0,1,2,DaQuan Jeffries
2023-24,NYK,SG,17,0,46,6,17,.353,2,10,.200,4,7,.571,.412,0,2,.000,0,5,5,5,0,1,3,2,14,DaQuan Jeffries
2024-25,CHO,SG,6,0,117,19,36,.528,8,16,.500,11,20,.550,.639,3,4,.750,5,12,17,4,4,4,4,11,49,DaQuan Jeffries
2023-24,2TM,C,25,14,573,75,136,.551,0,0,75,136,.551,.551,21,25,.840,64,70,134,27,12,28,34,69,171,0,Trey Jemison
2023-24,WAS,C,2,0,1,0,0,,0,0,0,0,,,0,0,,0,1,1,0,0,0,1,0,0,0,Trey Jemison
2023-24,MEM,C,23,14,572,75,136,.551,0,0,75,136,.551,.551,21,25,.840,64,69,133,27,12,28,33,69,171,0,Trey Jemison
2024-25,NOP,C,16,0,166,15,32,.469,0,0,15,32,.469,.469,8,21,.381,22,22,44,10,7,6,10,27,38,0,Trey Jemison
2024-25,DET,PG,2,0,5,0,2,.000,0,2,.000,0,0,.000,0,0,0,0,0,0,0,0,0,1,0,0,,Daniss Jenkins
2012-13,ATL,SG,61,2,902,131,294,.446,53,138,.384,78,156,.500,.536,59,70,.843,17,77,94,56,12,10,40,37,374,John Jenkins
2013-14,ATL,SG,13,0,158,16,42,.381,4,18,.222,12,24,.500,.429,4,4,1.000,3,19,22,11,1,1,11,11,40,John Jenkins
2014-15,ATL,SG,24,3,297,49,99,.495,21,52,.404,28,47,.596,.601,16,19,.842,2,37,39,13,10,0,8,15,135,John Jenkins
2015-16,2TM,SG,43,3,480,71,160,.444,16,51,.314,55,109,.505,.494,20,24,.833,8,49,57,35,8,1,27,22,178,John Jenkins
2015-16,DAL,SG,21,1,193,29,70,.414,3,19,.158,26,51,.510,.436,8,9,.889,4,18,22,9,3,0,11,11,69,John Jenkins
2015-16,PHO,SG,22,2,287,42,90,.467,13,32,.406,29,58,.500,.539,12,15,.800,4,31,35,26,5,1,16,11,109,John Jenkins
2016-17,PHO,SG,4,0,13,2,5,.400,1,2,.500,1,3,.333,.500,2,2,1.000,0,1,1,1,0,0,0,0,7,John Jenkins
2018-19,2TM,SG,26,0,333,42,105,.400,22,58,.379,20,47,.426,.505,15,18,.833,6,31,37,22,0,2,9,10,121,John Jenkins
2018-19,WAS,SG,4,0,14,2,2,1.000,2,2,1.000,0,0,,1.500,0,0,,0,1,1,1,0,0,0,0,6,John Jenkins
2018-19,NYK,SG,22,0,319,40,103,.388,20,56,.357,20,47,.426,.485,15,18,.833,6,30,36,21,0,2,9,10,115,John Jenkins
2019-20,PHO,SG,31,0,328,38,113,.336,14,50,.280,24,63,.381,.398,12,16,.750,7,39,46,44,15,3,18,29,102,Ty Jerome
2020-21,OKC,SG,33,1,788,128,287,.446,71,168,.423,57,119,.479,.570,26,34,.765,10,81,91,120,20,6,47,61,353,Ty Jerome
2021-22,OKC,SG,48,4,801,124,328,.378,54,186,.290,70,142,.493,.460,38,47,.809,19,59,78,109,30,5,37,73,340,Ty Jerome
2022-23,GSW,SG,45,2,816,118,242,.488,35,90,.389,83,152,.546,.560,38,41,.927,7,71,78,135,23,5,30,64,309,Ty Jerome
2023-24,CLE,SG,2,0,15,2,4,.500,0,1,.000,2,3,.667,.500,0,0,,1,0,1,3,0,0,1,2,4,Ty Jerome
2024-25,CLE,SG,30,2,528,113,222,.509,41,98,.418,72,124,.581,.601,41,46,.891,18,43,61,104,36,1,35,45,308,Ty Jerome
2020-21,PHI,SG,41,1,383,48,133,.361,39,106,.368,9,27,.333,.508,18,24,.750,6,30,36,20,12,4,11,34,153,Isaiah Joe
2021-22,PHI,SG,55,1,609,62,177,.350,45,135,.333,17,42,.405,.477,29,31,.935,6,50,56,35,14,3,19,47,198,Isaiah Joe
2022-23,OKC,SG,73,10,1395,224,508,.441,161,394,.409,63,114,.553,.599,82,100,.820,27,148,175,88,48,8,39,105,691,Isaiah Joe
2023-24,OKC,SG,78,1,1445,222,485,.458,147,353,.416,75,132,.568,.609,45,52,.865,32,148,180,99,46,22,47,87,636,Isaiah Joe
2024-25,OKC,SG,27,10,561,78,201,.388,56,157,.357,22,44,.500,.527,12,16,.750,13,58,71,41,19,6,13,43,224,Isaiah Joe
2024-25,MIL,SG,5,0,11,3,6,.500,1,1,1.000,2,5,.400,.583,0,0,0,2,2,1,0,0,2,0,7,0,AJ Johnson
2018-19,IND,PF,14,0,64,4,16,.250,1,2,.500,3,14,.214,.281,4,8,.500,4,15,19,1,1,3,0,7,13,Alize Johnson
2019-20,IND,PF,17,1,118,12,29,.414,3,8,.375,9,21,.429,.466,7,10,.700,16,32,48,7,3,2,7,12,34,Alize Johnson
2020-21,BRK,PF,18,0,189,40,68,.588,1,6,.167,39,62,.629,.596,13,13,1.000,27,63,90,14,5,5,9,16,94,Alize Johnson
2021-22,3TM,PF,23,0,167,17,39,.436,0,4,.000,17,35,.486,.436,7,12,.583,28,33,61,9,5,0,12,18,41,Alize Johnson
2021-22,CHI,PF,16,0,121,12,23,.522,0,2,.000,12,21,.571,.522,4,7,.571,16,20,36,8,3,0,8,15,28,Alize Johnson
2021-22,WAS,PF,3,0,18,2,6,.333,0,2,.000,2,4,.500,.333,0,1,.000,5,7,12,0,0,0,3,0,4,Alize Johnson
2021-22,NOP,PF,4,0,28,3,10,.300,0,0,,3,10,.300,.300,3,4,.750,7,6,13,1,2,0,1,3,9,Alize Johnson
2022-23,SAS,PF,4,0,30,3,6,.500,0,2,.000,3,4,.750,.500,1,2,.500,2,8,10,1,1,0,4,3,7,Alize Johnson
2019-20,PHO,PF,57,9,1255,176,405,.435,106,272,.390,70,133,.526,.565,46,57,.807,49,138,187,69,36,20,32,88,504,Cameron Johnson
2020-21,PHO,PF,60,11,1437,203,483,.420,117,335,.349,86,148,.581,.541,50,59,.847,33,166,199,86,37,16,40,85,573,Cameron Johnson
2021-22,PHO,PF,66,16,1730,279,607,.460,166,391,.425,113,216,.523,.596,98,114,.860,42,231,273,99,57,16,47,113,822,Cameron Johnson
2022-23,2TM,PF,42,41,1199,223,474,.470,103,255,.404,120,219,.548,.579,101,120,.842,34,151,185,78,50,14,37,83,650,Cameron Johnson
2022-23,PHO,PF,17,16,429,82,173,.474,45,99,.455,37,74,.500,.604,27,33,.818,14,51,65,26,15,6,10,29,236,Cameron Johnson
2022-23,BRK,PF,25,25,770,141,301,.468,58,156,.372,83,145,.572,.565,74,87,.851,20,100,120,52,35,8,27,54,414,Cameron Johnson
2023-24,BRK,PF,58,47,1599,276,619,.446,138,353,.391,138,266,.519,.557,86,109,.789,55,196,251,138,49,15,57,105,776,Cameron Johnson
2024-25,BRK,PF,29,29,953,184,374,.492,94,219,.429,90,155,.581,.618,103,116,.888,21,106,127,90,24,14,43,54,565,Cameron Johnson
2021-22,TOR,SG,2,0,2,0,1,.000,0,1,.000,0,0,.000,0,0,0,0,0,0,0,0,0,0,0,0,,David Johnson
2021-22,ATL,PF,22,0,120,22,41,.537,3,13,.231,19,28,.679,.573,5,7,.714,2,24,26,3,3,2,9,9,52,Jalen Johnson
2022-23,ATL,SF,70,6,1042,158,322,.491,30,104,.288,128,218,.587,.537,49,78,.628,51,231,282,83,38,34,41,113,395,Jalen Johnson
2023-24,ATL,SF,56,52,1889,359,702,.511,71,200,.355,288,502,.574,.562,107,147,.728,74,414,488,203,67,47,101,133,896,Jalen Johnson
2024-25,ATL,SF,29,29,1062,226,447,.506,40,122,.328,186,325,.572,.550,81,106,.764,52,247,299,160,42,30,91,55,573,Jalen Johnson
2009-10,CHI,PF,65,11,757,95,210,.452,15,46,.326,80,164,.488,.488,51,70,.729,34,94,128,48,21,43,62,126,256,James Johnson
2010-11,2TM,SF,38,25,822,108,237,.456,8,34,.235,100,203,.493,.473,47,71,.662,37,105,142,89,33,37,64,95,271,James Johnson
2010-11,CHI,SF,13,0,123,17,41,.415,2,9,.222,15,32,.469,.439,6,13,.462,6,18,24,14,8,9,18,25,42,James Johnson
2010-11,TOR,SF,25,25,699,91,196,.464,6,25,.240,85,171,.497,.480,41,58,.707,31,87,118,75,25,28,46,70,229,James Johnson
2011-12,TOR,SF,62,40,1561,233,518,.450,19,60,.317,214,458,.467,.468,81,115,.704,74,218,292,122,71,84,101,177,566,James Johnson
2012-13,SAC,SF,54,11,878,117,283,.413,2,21,.095,115,262,.439,.417,40,67,.597,49,96,145,58,41,50,68,99,276,James Johnson
2013-14,MEM,SF,52,4,956,143,308,.464,22,87,.253,121,221,.548,.500,76,90,.844,60,106,166,111,42,57,66,102,384,James Johnson
2014-15,TOR,PF,70,17,1370,238,404,.589,11,51,.216,227,353,.643,.603,67,102,.657,61,196,257,95,54,70,79,155,554,James Johnson
2015-16,TOR,PF,57,32,926,114,240,.475,20,66,.303,94,174,.540,.517,39,68,.574,28,98,126,67,29,33,54,84,287,James Johnson
2016-17,MIA,PF,76,5,2085,368,769,.479,87,256,.340,281,513,.548,.535,152,215,.707,66,310,376,276,76,86,171,197,975,James Johnson
2017-18,MIA,PF,73,41,1943,309,614,.503,57,185,.308,252,429,.587,.550,113,162,.698,61,297,358,280,70,51,141,192,788,James Johnson
2018-19,MIA,PF,55,33,1164,164,379,.433,50,149,.336,114,230,.496,.499,50,70,.714,22,154,176,135,35,27,74,114,428,James Johnson
2019-20,2TM,C,32,1,619,103,215,.479,33,91,.363,70,124,.565,.556,31,48,.646,25,93,118,74,25,32,48,80,270,James Johnson
2019-20,MIA,PF,18,0,281,39,87,.448,16,45,.356,23,42,.548,.540,8,14,.571,8,44,52,21,6,13,15,34,102,James Johnson
2019-20,MIN,C,14,1,338,64,128,.500,17,46,.370,47,82,.573,.566,23,34,.676,17,49,66,53,19,19,33,46,168,James Johnson
2020-21,2TM,PF,51,12,1043,146,327,.446,31,120,.258,115,207,.556,.494,45,76,.592,32,145,177,98,42,42,55,120,368,James Johnson
2020-21,DAL,PF,29,1,504,67,145,.462,15,60,.250,52,85,.612,.514,17,29,.586,14,72,86,50,24,23,27,59,166,James Johnson
2020-21,NOP,PF,22,11,539,79,182,.434,16,60,.267,63,122,.516,.478,28,47,.596,18,73,91,48,18,19,28,61,202,James Johnson
2021-22,BRK,PF,62,10,1191,144,307,.469,23,85,.271,121,222,.545,.507,29,55,.527,51,164,215,130,30,34,48,162,340,James Johnson
2022-23,IND,PF,18,1,162,22,49,.449,3,15,.200,19,34,.559,.480,4,8,.500,4,26,30,15,7,6,8,32,51,James Johnson
2023-24,IND,PF,9,0,47,3,10,.300,0,2,.000,3,8,.375,.300,2,2,1.000,1,3,4,8,5,1,5,9,8,James Johnson
2024-25,IND,PF,5,0,22,4,7,.571,0,1,.000,4,6,.667,.571,0,1,.000,0,4,4,3,0,2,4,3,8,James Johnson
2019-20,SAS,SF,17,1,301,53,89,.596,13,22,.591,40,67,.597,.669,35,44,.795,10,47,57,15,14,2,13,28,154,Keldon Johnson
2020-21,SAS,SF,69,67,1968,338,705,.479,60,181,.331,278,524,.531,.522,145,196,.740,93,319,412,121,40,24,78,142,881,Keldon Johnson
2021-22,SAS,SF,75,74,2392,471,1011,.466,159,399,.398,312,612,.510,.545,177,234,.756,80,377,457,158,58,14,92,148,1278,Keldon Johnson
2022-23,SAS,SF,63,63,2063,503,1113,.452,134,407,.329,369,706,.523,.512,245,327,.749,56,262,318,183,46,11,134,125,1385,Keldon Johnson
2023-24,SAS,SF,69,27,2038,391,862,.454,127,367,.346,264,495,.533,.527,175,221,.792,95,282,377,195,51,20,100,149,1084,Keldon Johnson
2024-25,SAS,SF,28,0,700,125,279,.448,29,103,.282,96,176,.545,.500,55,71,.775,32,108,140,46,22,6,23,45,334,Keldon Johnson
2021-22,2TM,SG,37,12,697,96,272,.353,34,100,.340,62,172,.360,.415,41,51,.804,24,57,81,76,28,12,46,69,267,Keon Johnson
2021-22,LAC,SG,15,0,135,17,51,.333,3,11,.273,14,40,.350,.363,16,21,.762,6,15,21,13,7,2,7,21,53,Keon Johnson
2021-22,POR,SG,22,12,562,79,221,.357,31,89,.348,48,132,.364,.428,25,30,.833,18,42,60,63,21,10,39,48,214,Keon Johnson
2022-23,POR,SG,40,0,416,67,178,.376,28,81,.346,39,97,.402,.455,27,41,.659,11,33,44,59,19,6,43,43,189,Keon Johnson
2023-24,BRK,SG,5,0,61,8,21,.381,4,10,.400,4,11,.364,.476,11,12,.917,3,4,7,3,3,1,5,5,31,Keon Johnson
2024-25,BRK,SG,29,10,552,76,213,.357,37,128,.289,39,85,.459,.444,13,18,.722,17,74,91,34,20,10,32,72,202,Keon Johnson
2024-25,MIA,SF,3,0,14,1,2,.500,0,1,.000,1,1,1.000,.500,0,0,0,3,3,0,0,0,0,1,2,0,Keshad Johnson
2023-24,OKC,SF,9,0,66,5,16,.313,1,3,.333,4,13,.308,.344,0,0,4,6,10,4,1,0,4,5,11,0,Keyontae Johnson
2015-16,DET,SF,73,6,1687,225,600,.375,63,205,.307,162,395,.410,.428,80,102,.784,58,248,306,118,55,12,114,178,593,Stanley Johnson
2016-17,DET,SF,77,1,1371,129,365,.353,45,154,.292,84,211,.398,.415,36,53,.679,36,153,189,105,56,24,71,121,339,Stanley Johnson
2017-18,DET,SF,69,50,1894,210,560,.375,67,234,.286,143,326,.439,.435,112,145,.772,33,219,252,112,95,14,77,169,599,Stanley Johnson
2018-19,2TM,SF,66,7,1208,171,440,.389,62,215,.288,109,225,.484,.459,50,64,.781,34,183,217,88,60,14,81,114,454,Stanley Johnson
2018-19,DET,SF,48,7,961,133,349,.381,51,181,.282,82,168,.488,.454,41,51,.804,25,150,175,60,48,13,55,92,358,Stanley Johnson
2018-19,NOP,SF,18,0,247,38,91,.418,11,34,.324,27,57,.474,.478,9,13,.692,9,33,42,28,12,1,26,22,96,Stanley Johnson
2019-20,TOR,PF,25,0,150,22,59,.373,7,24,.292,15,35,.429,.432,9,16,.563,7,30,37,20,6,4,15,16,60,Stanley Johnson
2020-21,TOR,PF,61,13,1006,89,233,.382,45,137,.328,44,96,.458,.479,44,55,.800,29,124,153,89,52,18,54,116,267,Stanley Johnson
2021-22,LAL,PF,48,27,1094,117,251,.466,33,105,.314,84,146,.575,.532,53,74,.716,34,121,155,80,43,14,35,109,320,Stanley Johnson
2022-23,SAS,SF,30,0,469,65,122,.533,18,40,.450,47,82,.573,.607,26,39,.667,22,73,95,67,16,6,33,48,174,Stanley Johnson
2015-16,DEN,C,80,55,1733,307,600,.512,28,84,.333,279,516,.541,.535,154,190,.811,181,379,560,189,79,50,104,208,796,Nikola Jokić
2016-17,DEN,C,73,59,2038,494,854,.578,45,139,.324,449,715,.628,.605,188,228,.825,212,506,718,359,61,55,171,214,1221,Nikola Jokić
2017-18,DEN,C,75,73,2443,504,1010,.499,111,280,.396,393,730,.538,.554,266,313,.850,195,608,803,458,90,61,210,212,1385,Nikola Jokić
2018-19,DEN,C,80,80,2504,616,1206,.511,83,270,.307,533,936,.569,.545,289,352,.821,228,637,865,580,108,55,248,228,1604,Nikola Jokić
2019-20,DEN,C,73,73,2336,565,1071,.528,80,255,.314,485,816,.594,.565,246,301,.817,166,545,711,512,85,44,226,222,1456,Nikola Jokić
2020-21,DEN,C,72,72,2488,732,1293,.566,92,237,.388,640,1056,.606,.602,342,394,.868,205,575,780,599,95,48,222,192,1898,Nikola Jokić
2021-22,DEN,C,74,74,2476,764,1311,.583,97,288,.337,667,1023,.652,.620,379,468,.810,206,813,1019,584,109,63,281,191,2004,Nikola Jokić
2022-23,DEN,C,69,69,2323,646,1022,.632,57,149,.383,589,873,.675,.660,341,415,.822,167,650,817,678,87,47,247,174,1690,Nikola Jokić
2023-24,DEN,C,79,79,2737,822,1411,.583,83,231,.359,739,1180,.626,.612,358,438,.817,223,753,976,708,108,68,237,194,2085,Nikola Jokić
2024-25,DEN,C,26,26,965,305,536,.569,57,117,.487,248,419,.592,.622,127,160,.794,89,240,329,248,45,16,91,53,794,Nikola Jokić
2021-22,2TM,PG,5,0,23,1,9,.111,0,1,.000,1,8,.125,.111,2,2,1.000,1,2,3,5,1,0,3,0,4,Carlik Jones
2021-22,DAL,PG,3,0,19,0,7,.000,0,1,.000,0,6,.000,.000,2,2,1.000,1,2,3,5,1,0,3,0,2,Carlik Jones
2021-22,DEN,PG,2,0,4,1,2,.500,0,0,,1,2,.500,.500,0,0,,0,0,0,0,0,0,0,0,2,Carlik Jones
2022-23,CHI,PG,7,0,56,6,15,.400,3,6,.500,3,9,.333,.500,5,8,.625,1,4,5,6,2,0,2,2,20,Carlik Jones
2023-24,SAC,SG,30,0,192,28,71,.394,2,22,.091,26,49,.531,.408,6,11,.545,17,23,40,20,7,5,10,29,64,Colby Jones
2024-25,SAC,SG,20,0,117,10,24,.417,4,9,.444,6,15,.400,.500,0,0,,6,14,20,5,5,5,7,13,24,Colby Jones
2016-17,GSW,C,10,0,85,8,16,.500,0,0,,8,16,.500,.500,3,10,.300,9,14,23,0,1,4,6,15,19,Damian Jones
2017-18,GSW,C,15,0,89,11,22,.500,0,0,,11,22,.500,.500,3,5,.600,5,9,14,2,1,3,4,14,25,Damian Jones
2018-19,GSW,C,24,22,410,53,74,.716,0,0,,53,74,.716,.716,24,37,.649,31,44,75,28,12,25,16,63,130,Damian Jones
2019-20,ATL,C,55,27,887,121,178,.680,2,9,.222,119,169,.704,.685,62,84,.738,74,132,206,35,26,40,28,149,306,Damian Jones
2020-21,3TM,C,39,10,547,70,103,.680,1,5,.200,69,98,.704,.684,42,58,.724,36,85,121,29,11,29,26,77,183,Damian Jones
2020-21,PHO,C,14,0,94,8,16,.500,0,1,.000,8,15,.533,.500,6,11,.545,7,11,18,4,1,5,6,19,22,Damian Jones
2020-21,LAL,C,8,6,112,16,17,.941,0,0,,16,17,.941,.941,11,12,.917,8,18,26,1,1,7,5,22,43,Damian Jones
2020-21,SAC,C,17,4,341,46,70,.657,1,4,.250,45,66,.682,.664,25,35,.714,21,56,77,24,9,17,15,36,118,Damian Jones
2021-22,SAC,C,56,15,1017,175,266,.658,10,29,.345,165,237,.696,.677,94,131,.718,75,171,246,69,26,47,59,130,454,Damian Jones
2022-23,2TM,C,41,1,477,55,86,.640,10,17,.588,45,69,.652,.698,22,29,.759,42,80,122,15,8,21,23,55,142,Damian Jones
2022-23,LAL,C,22,1,176,20,37,.541,0,3,.000,20,34,.588,.541,15,20,.750,18,37,55,4,3,12,9,17,55,Damian Jones
2022-23,UTA,C,19,0,301,35,49,.714,10,14,.714,25,35,.714,.816,7,9,.778,24,43,67,11,5,9,14,38,87,Damian Jones
2023-24,CLE,C,39,0,270,43,72,.597,3,14,.214,40,58,.690,.618,18,21,.857,20,42,62,15,7,13,13,27,107,Damian Jones
2016-17,PHO,SF,32,8,545,68,121,.562,3,11,.273,65,110,.591,.574,29,41,.707,39,40,79,12,14,13,13,63,168,Derrick Jones Jr.
2017-18,2TM,SF,20,8,245,21,53,.396,3,18,.167,18,35,.514,.425,16,24,.667,21,17,38,9,4,13,7,24,61,Derrick Jones Jr.
2017-18,PHO,SF,6,0,33,2,4,.500,0,2,.000,2,2,1.000,.500,5,6,.833,2,2,4,3,1,4,1,2,9,Derrick Jones Jr.
2017-18,MIA,SF,14,8,212,19,49,.388,3,16,.188,16,33,.485,.418,11,18,.611,19,15,34,6,3,9,6,22,52,Derrick Jones Jr.
2018-19,MIA,SF,60,14,1153,160,324,.494,28,91,.308,132,233,.567,.537,74,122,.607,96,144,240,37,46,42,43,123,422,Derrick Jones Jr.
2019-20,MIA,SF,59,16,1375,184,349,.527,37,132,.280,147,217,.677,.580,95,123,.772,66,167,233,62,58,38,30,130,500,Derrick Jones Jr.
2020-21,POR,SF,58,43,1318,147,304,.484,43,136,.316,104,168,.619,.554,59,91,.648,77,128,205,47,37,54,32,127,396,Derrick Jones Jr.
2021-22,CHI,PF,51,8,899,105,195,.538,20,61,.328,85,134,.634,.590,56,70,.800,60,109,169,30,25,33,30,105,286,Derrick Jones Jr.
2022-23,CHI,PF,64,0,893,115,230,.500,27,80,.338,88,150,.587,.559,62,84,.738,60,93,153,34,29,37,25,86,319,Derrick Jones Jr.
2023-24,DAL,SF,76,66,1783,239,495,.483,82,239,.343,157,256,.613,.566,97,136,.713,82,168,250,75,53,51,65,121,657,Derrick Jones Jr.
2024-25,LAC,SF,29,29,714,114,227,.502,32,82,.390,82,145,.566,.573,30,34,.882,34,63,97,27,38,10,29,60,290,Derrick Jones Jr.
2024-25,OKC,SF,23,0,183,19,56,.339,7,33,.212,12,23,.522,.402,6,10,.600,16,26,42,15,4,1,8,20,51,Dillon Jones
2021-22,NOP,PF,78,69,2335,274,576,.476,57,169,.337,217,407,.533,.525,137,163,.840,98,198,296,167,130,60,100,238,742,Herbert Jones
2022-23,NOP,PF,66,66,1951,235,501,.469,56,167,.335,179,334,.536,.525,123,161,.764,97,172,269,162,103,42,88,208,649,Herbert Jones
2023-24,NOP,SF,76,76,2321,293,588,.498,114,273,.418,179,315,.568,.595,137,158,.867,74,198,272,199,105,62,93,224,837,Herbert Jones
2024-25,NOP,SF,14,14,455,55,131,.420,15,55,.273,40,76,.526,.477,23,30,.767,20,39,59,43,28,7,27,45,148,Herbert Jones
2024-25,SAC,PF,20,0,172,32,48,.667,1,4,.250,31,44,.705,.677,11,20,.550,10,21,31,4,2,8,11,22,76,Isaac Jones
2018-19,LAL,SF,6,2,143,12,33,.364,2,10,.200,10,23,.435,.394,1,2,.500,16,33,49,13,7,5,5,10,27,Jemerrio Jones
2021-22,LAL,SF,2,0,15,2,3,.667,0,0,,2,3,.667,.667,0,0,,2,1,3,0,1,0,0,2,4,Jemerrio Jones
2021-22,CHO,C,21,0,63,9,14,.643,1,2,.500,8,12,.667,.679,3,8,.375,3,8,11,4,1,2,6,8,22,Kai Jones
2022-23,CHO,C,46,0,550,67,120,.558,4,19,.211,63,101,.624,.575,19,26,.731,37,86,123,15,17,30,31,65,157,Kai Jones
2024-25,LAC,C,20,0,154,15,20,.750,0,0,,15,20,.750,.750,9,12,.750,12,22,34,8,6,9,8,19,39,Kai Jones
2020-21,2TM,SG,32,1,334,52,123,.423,24,66,.364,28,57,.491,.520,40,64,.625,7,48,55,42,7,1,29,24,168,Mason Jones
2020-21,HOU,SG,26,1,307,47,114,.412,23,64,.359,24,50,.480,.513,35,57,.614,4,47,51,39,6,1,28,22,152,Mason Jones
2020-21,PHI,SG,6,0,27,5,9,.556,1,2,.500,4,7,.571,.611,5,7,.714,3,1,4,3,1,0,1,2,16,Mason Jones
2021-22,LAL,SG,4,0,51,7,15,.467,1,4,.250,6,11,.545,.500,12,15,.800,1,9,10,4,2,0,1,8,27,Mason Jones
2023-24,SAC,SG,5,0,28,2,8,.250,2,7,.286,0,1,.000,.375,1,2,.500,1,4,5,5,1,0,2,3,7,Mason Jones
2024-25,SAC,SG,3,0,13,0,2,.000,0,2,.000,0,0,,.000,0,0,,1,3,4,7,0,0,0,1,0,Mason Jones
2024-25,DEN,SF,4,0,9,0,2,.000,0,2,.000,0,0,.000,0,0,0,3,3,0,2,0,1,1,0,0,,Spencer Jones
2020-21,SAS,PG,37,1,269,37,78,.474,3,5,.600,34,73,.466,.494,17,19,.895,8,13,21,39,8,0,13,13,94,Tre Jones
2021-22,SAS,PG,69,11,1148,166,339,.490,10,51,.196,156,288,.542,.504,71,91,.780,29,126,155,233,42,7,46,78,413,Tre Jones
2022-23,SAS,PG,68,65,1984,341,743,.459,45,158,.285,296,585,.506,.489,148,172,.860,56,189,245,448,89,9,110,98,875,Tre Jones
2023-24,SAS,PG,77,48,2138,303,600,.505,64,191,.335,239,409,.584,.558,101,118,.856,58,231,289,478,78,9,116,92,771,Tre Jones
2024-25,SAS,PG,13,0,219,16,40,.400,3,14,.214,13,26,.500,.438,13,17,.765,6,19,25,53,10,4,9,17,48,Tre Jones
2015-16,MIN,PG,37,0,573,56,156,.359,16,53,.302,40,103,.388,.410,28,39,.718,7,40,47,108,31,3,33,33,156,Tyus Jones
2016-17,MIN,PG,60,0,774,75,181,.414,26,73,.356,49,108,.454,.486,33,43,.767,10,57,67,156,48,5,38,50,209,Tyus Jones
2017-18,MIN,PG,82,11,1467,150,328,.457,45,129,.349,105,199,.528,.526,71,81,.877,16,116,132,232,95,6,59,110,416,Tyus Jones
2018-19,MIN,PG,68,23,1560,185,446,.415,40,126,.317,145,320,.453,.460,58,69,.841,23,111,134,327,81,5,47,78,468,Tyus Jones
2019-20,MEM,PG,65,6,1232,197,429,.459,47,124,.379,150,305,.492,.514,43,58,.741,9,94,103,285,59,6,55,44,484,Tyus Jones
2020-21,MEM,PG,70,9,1222,178,413,.431,45,140,.321,133,273,.487,.485,41,45,.911,21,119,140,259,64,6,48,31,442,Tyus Jones
2021-22,MEM,PG,73,23,1549,249,552,.451,80,205,.390,169,347,.487,.524,54,66,.818,17,159,176,324,66,2,46,32,632,Tyus Jones
2022-23,MEM,PG,80,22,1940,311,710,.438,121,326,.371,190,384,.495,.523,80,100,.800,28,172,200,417,83,6,74,32,823,Tyus Jones
2023-24,WAS,PG,66,66,1933,326,666,.489,106,256,.414,220,410,.537,.569,32,40,.800,20,159,179,485,71,18,66,48,790,Tyus Jones
2024-25,PHO,PG,30,30,941,143,285,.502,69,157,.439,74,128,.578,.623,19,22,.864,17,58,75,193,29,5,35,31,374,Tyus Jones
2008-09,LAC,C,53,13,771,93,147,.633,0,0,,93,147,.633,.633,42,109,.385,72,165,237,11,11,59,41,96,228,DeAndre Jordan
2009-10,LAC,C,70,12,1137,144,238,.605,0,2,.000,144,236,.610,.605,48,128,.375,122,230,352,21,16,62,75,152,336,DeAndre Jordan
2010-11,LAC,C,80,66,2047,234,341,.686,0,1,.000,234,340,.688,.686,98,217,.452,207,368,575,42,41,142,101,255,566,DeAndre Jordan
2011-12,LAC,C,66,66,1798,206,326,.632,0,1,.000,206,325,.634,.632,74,141,.525,202,344,546,17,30,134,74,189,486,DeAndre Jordan
2012-13,LAC,C,82,82,2010,314,488,.643,0,0,,314,488,.643,.643,96,249,.386,210,384,594,28,48,112,100,192,724,DeAndre Jordan
2013-14,LAC,C,82,82,2870,348,515,.676,0,0,,348,515,.676,.676,160,374,.428,331,783,1114,74,80,203,123,264,856,DeAndre Jordan
2014-15,LAC,C,82,82,2820,379,534,.710,1,4,.250,378,530,.713,.711,187,471,.397,397,829,1226,61,81,183,109,245,946,DeAndre Jordan
2015-16,LAC,C,77,77,2598,357,508,.703,0,1,.000,357,507,.704,.703,266,619,.430,267,792,1059,90,51,177,107,207,980,DeAndre Jordan
2016-17,LAC,C,81,81,2570,412,577,.714,0,2,.000,412,575,.717,.714,205,425,.482,298,816,1114,96,51,134,115,212,1029,DeAndre Jordan
2017-18,LAC,C,77,77,2424,373,578,.645,0,0,,373,578,.645,.645,181,312,.580,329,842,1171,117,39,71,137,203,927,DeAndre Jordan
2018-19,2TM,C,69,69,2047,286,446,.641,0,0,,286,446,.641,.641,186,264,.705,225,677,902,156,42,73,153,167,758,DeAndre Jordan
2018-19,DAL,C,50,50,1554,208,323,.644,0,0,,208,323,.644,.644,135,198,.682,161,525,686,99,33,53,111,125,551,DeAndre Jordan
2018-19,NYK,C,19,19,493,78,123,.634,0,0,,78,123,.634,.634,51,66,.773,64,152,216,57,9,20,42,42,207,DeAndre Jordan
2019-20,BRK,C,56,6,1234,191,287,.666,0,0,,191,287,.666,.666,83,122,.680,141,420,561,105,18,52,74,114,465,DeAndre Jordan
2020-21,BRK,C,57,43,1246,190,249,.763,0,1,.000,190,248,.766,.763,46,92,.500,117,310,427,93,17,65,85,116,426,DeAndre Jordan
2021-22,2TM,C,48,20,622,92,143,.643,0,0,,92,143,.643,.643,22,40,.550,83,181,264,21,12,35,37,71,206,DeAndre Jordan
2021-22,LAL,C,32,19,408,60,89,.674,0,0,,60,89,.674,.674,12,26,.462,51,121,172,13,10,26,21,50,132,DeAndre Jordan
2021-22,PHI,C,16,1,214,32,54,.593,0,0,,32,54,.593,.593,10,14,.714,32,60,92,8,2,9,16,21,74,DeAndre Jordan
2022-23,DEN,C,39,8,586,88,115,.765,1,1,1.000,87,114,.763,.770,22,48,.458,52,150,202,34,12,23,48,71,199,DeAndre Jordan
2023-24,DEN,C,36,2,396,58,93,.624,0,0,,58,93,.624,.624,26,53,.491,54,103,157,26,6,16,23,56,142,DeAndre Jordan
2024-25,DEN,C,17,0,179,23,37,.622,0,0,,23,37,.622,.622,2,9,.222,18,51,69,15,5,8,12,22,48,DeAndre Jordan
2011-12,SAS,PG,29,1,266,22,70,.314,3,15,.200,19,55,.345,.336,11,17,.647,5,20,25,34,7,3,12,16,58,Cory Joseph
2012-13,SAS,PG,28,9,388,51,110,.464,6,21,.286,45,89,.506,.491,18,21,.857,12,40,52,53,15,4,21,25,126,Cory Joseph
2013-14,SAS,SG,68,19,936,126,265,.475,12,38,.316,114,227,.502,.498,79,96,.823,32,75,107,114,35,14,43,84,343,Cory Joseph
2014-15,SAS,PG,79,14,1444,207,411,.504,16,44,.364,191,367,.520,.523,105,143,.734,44,148,192,188,46,17,67,105,535,Cory Joseph
2015-16,TOR,SG,80,4,2046,257,585,.439,30,110,.273,227,475,.478,.465,133,174,.764,39,171,210,250,63,20,102,131,677,Cory Joseph
2016-17,TOR,PG,80,22,2003,299,661,.452,48,135,.356,251,526,.477,.489,94,122,.770,51,184,235,265,66,13,108,140,740,Cory Joseph
2017-18,IND,PG,82,17,2210,256,604,.424,67,190,.353,189,414,.457,.479,70,94,.745,39,224,263,260,80,18,87,141,649,Cory Joseph
2018-19,IND,PG,82,9,2063,226,548,.412,55,171,.322,171,377,.454,.463,30,43,.698,39,240,279,321,94,22,80,131,537,Cory Joseph
2019-20,SAC,PG,72,26,1759,171,412,.415,56,159,.352,115,253,.455,.483,60,70,.857,44,144,188,251,53,21,80,133,458,Cory Joseph
2020-21,2TM,PG,63,13,1446,200,426,.469,45,132,.341,155,294,.527,.522,72,88,.818,35,124,159,213,61,18,79,139,517,Cory Joseph
2020-21,SAC,PG,44,2,944,111,250,.444,31,94,.330,80,156,.513,.506,36,47,.766,25,74,99,108,39,9,44,98,289,Cory Joseph
2020-21,DET,PG,19,11,502,89,176,.506,14,38,.368,75,138,.543,.545,36,41,.878,10,50,60,105,22,9,35,41,228,Cory Joseph
2021-22,DET,PG,65,39,1600,178,400,.445,65,157,.414,113,243,.465,.526,100,113,.885,29,145,174,237,42,17,85,147,521,Cory Joseph
2022-23,DET,PG,62,2,1227,150,351,.427,70,180,.389,80,171,.468,.527,57,72,.792,21,85,106,217,34,9,56,88,427,Cory Joseph
2023-24,GSW,PG,26,0,296,23,64,.359,13,42,.310,10,22,.455,.461,4,7,.571,6,24,30,42,4,3,12,25,63,Cory Joseph
2024-25,ORL,PG,18,0,102,10,30,.333,7,20,.350,3,10,.300,.450,0,0,,4,13,17,12,6,2,4,7,27,Cory Joseph
2022-23,MIA,PF,15,8,204,28,69,.406,8,35,.229,20,34,.588,.464,18,19,.947,9,22,31,10,7,2,10,19,82,Nikola Jović
2023-24,MIA,PF,46,38,896,127,281,.452,65,163,.399,62,118,.525,.568,33,47,.702,25,167,192,90,25,14,42,82,352,Nikola Jović
2024-25,MIA,PF,19,9,373,53,118,.449,23,61,.377,30,57,.526,.547,30,38,.789,8,58,66,28,18,2,13,28,159,Nikola Jović
2022-23,UTA,SG,18,0,232,35,104,.337,15,63,.238,20,41,.488,.409,2,4,.500,8,31,39,8,4,3,3,13,87,Johnny Juzang
2023-24,UTA,SG,20,5,372,51,110,.464,32,77,.416,19,33,.576,.609,10,14,.714,7,29,36,23,4,2,13,29,144,Johnny Juzang
2024-25,UTA,SG,25,0,418,57,139,.410,40,101,.396,17,38,.447,.554,14,17,.824,13,43,56,24,10,4,13,45,168,Johnny Juzang
2019-20,LAC,C,12,0,64,14,32,.438,9,20,.450,5,12,.417,.578,5,5,1.000,1,10,11,2,2,2,2,9,42,Mfiondu Kabengele
2020-21,2TM,PF,39,0,280,33,89,.371,13,50,.260,20,39,.513,.444,16,20,.800,12,48,60,17,8,13,15,36,95,Mfiondu Kabengele
2020-21,LAC,PF,23,0,94,9,32,.281,4,18,.222,5,14,.357,.344,5,6,.833,1,13,14,5,2,3,6,18,27,Mfiondu Kabengele
2020-21,CLE,PF,16,0,186,24,57,.421,9,32,.281,15,25,.600,.500,11,14,.786,11,35,46,12,6,10,9,18,68,Mfiondu Kabengele
2022-23,BOS,PF,4,0,36,2,7,.286,0,3,.000,2,4,.500,.286,2,2,1.000,5,5,10,0,2,0,1,3,6,Mfiondu Kabengele
2015-16,CHO,C,81,3,1708,215,525,.410,68,202,.337,147,323,.455,.474,108,148,.730,69,266,335,98,38,43,58,126,606,Frank Kaminsky
2016-17,CHO,C,75,16,1954,320,802,.399,116,354,.328,204,448,.455,.471,118,156,.756,57,279,336,162,46,34,76,139,874,Frank Kaminsky
2017-18,CHO,PF,79,4,1835,307,716,.429,104,274,.380,203,442,.459,.501,155,194,.799,46,242,288,129,36,19,66,95,873,Frank Kaminsky
2018-19,CHO,C,47,0,755,138,298,.463,50,139,.360,88,159,.553,.547,79,107,.738,39,124,163,63,12,12,41,68,405,Frank Kaminsky
2019-20,PHO,C,39,13,777,138,307,.450,41,124,.331,97,183,.530,.516,61,90,.678,35,141,176,75,14,10,37,75,378,Frank Kaminsky
2020-21,PHO,C,47,13,715,121,257,.471,31,85,.365,90,172,.523,.531,37,60,.617,36,152,188,79,14,17,22,70,310,Frank Kaminsky
2021-22,PHO,C,9,0,181,36,66,.545,5,15,.333,31,51,.608,.583,18,20,.900,11,30,41,13,8,7,5,14,95,Frank Kaminsky
2022-23,2TM,C,36,0,235,31,63,.492,13,33,.394,18,30,.600,.595,14,16,.875,7,45,52,32,6,4,9,22,89,Frank Kaminsky
2022-23,ATL,C,26,0,176,25,44,.568,11,23,.478,14,21,.667,.693,10,12,.833,3,33,36,21,5,1,9,21,71,Frank Kaminsky
2022-23,HOU,C,10,0,59,6,19,.316,2,10,.200,4,9,.444,.368,4,4,1.000,4,12,16,11,1,3,0,1,18,Frank Kaminsky
2024-25,MEM,PG,14,0,41,4,15,.267,2,11,.182,2,4,.500,.333,4,6,.667,0,2,2,8,1,0,4,4,14,Yuki Kawamura
2022-23,NYK,SG,3,0,8,1,4,.250,1,4,.250,0,0,.375,0,0,0,2,2,0,0,0,0,0,3,0,,Trevor Keels
2017-18,DET,SG,73,9,1463,206,465,.443,81,195,.415,125,270,.463,.530,65,76,.855,21,155,176,124,44,13,69,86,558,Luke Kennard
2018-19,DET,SG,63,10,1437,228,520,.438,106,269,.394,122,251,.486,.540,51,61,.836,12,171,183,114,26,10,57,92,613,Luke Kennard
2019-20,DET,SG,28,25,922,151,342,.442,73,183,.399,78,159,.491,.548,67,75,.893,9,89,98,115,12,6,43,65,442,Luke Kennard
2020-21,LAC,SG,63,17,1232,197,414,.476,100,224,.446,97,190,.511,.597,26,31,.839,15,146,161,104,23,9,48,91,520,Luke Kennard
2021-22,LAC,SG,70,13,1919,287,639,.449,190,423,.449,97,216,.449,.598,69,77,.896,20,209,229,146,42,6,60,101,833,Luke Kennard
2022-23,2TM,SG,59,14,1315,188,382,.492,133,269,.494,55,113,.487,.666,37,39,.949,15,143,158,91,32,5,46,82,546,Luke Kennard
2022-23,LAC,SG,35,11,725,98,211,.464,59,132,.447,39,79,.494,.604,19,20,.950,6,77,83,37,19,4,30,47,274,Luke Kennard
2022-23,MEM,SG,24,3,590,90,171,.526,74,137,.540,16,34,.471,.743,18,19,.947,9,66,75,54,13,1,16,35,272,Luke Kennard
2023-24,MEM,SG,39,22,999,141,315,.448,107,238,.450,34,77,.442,.617,40,45,.889,11,102,113,136,20,2,54,39,429,Luke Kennard
2024-25,MEM,SG,20,0,397,47,111,.423,36,81,.444,11,30,.367,.586,19,23,.826,8,38,46,58,12,2,16,15,149,Luke Kennard
2022-23,UTA,C,74,40,1703,298,414,.720,1,3,.333,297,411,.723,.721,82,159,.516,231,389,620,69,26,173,58,169,679,Walker Kessler
2023-24,UTA,C,64,22,1493,229,350,.654,4,19,.211,225,331,.680,.660,56,93,.602,165,316,481,60,30,154,66,132,518,Walker Kessler
2024-25,UTA,C,23,23,677,101,144,.701,2,3,.667,99,141,.702,.708,33,62,.532,92,159,251,37,12,66,31,48,237,Walker Kessler
2021-22,2TM,SF,11,0,197,33,72,.458,6,21,.286,27,51,.529,.500,7,13,.538,13,37,50,11,10,11,11,26,79,Braxton Key
2021-22,PHI,SF,2,0,6,1,2,.500,0,1,.000,1,1,1.000,.500,0,0,,1,1,2,1,1,0,2,1,2,Braxton Key
2021-22,DET,SF,9,0,191,32,70,.457,6,20,.300,26,50,.520,.500,7,13,.538,12,36,48,10,9,11,9,25,77,Braxton Key
2022-23,DET,SF,3,0,9,1,1,1.000,0,0,,1,1,1.000,1.000,2,2,1.000,0,1,1,0,0,0,0,0,4,Braxton Key
2023-24,DEN,SF,20,0,60,7,17,.412,2,5,.400,5,12,.417,.471,6,8,.750,3,15,18,9,2,1,1,5,22,Braxton Key
2018-19,PHO,SF,1,0,6,0,0,,0,0,,0,0,,,0,0,,0,1,1,0,0,0,0,0,0,George King
2021-22,DAL,SF,4,0,19,0,5,.000,0,4,.000,0,1,.000,.000,1,2,.500,0,5,5,0,0,0,1,4,1,George King
2019-20,DET,SF,10,0,62,8,21,.381,4,11,.364,4,10,.400,.476,0,3,.000,1,9,10,5,2,0,2,10,20,Louis King
2020-21,SAC,SF,6,1,85,17,34,.500,4,11,.364,13,23,.565,.559,6,6,1.000,5,13,18,9,7,3,4,9,44,Louis King
2021-22,SAC,SF,10,0,104,15,47,.319,8,27,.296,7,20,.350,.404,7,10,.700,0,12,12,9,2,1,0,14,45,Louis King
2022-23,PHI,PF,1,0,29,8,13,.615,4,8,.500,4,5,.800,.769,0,1,.000,2,2,4,2,1,0,2,4,20,Louis King
2021-22,WAS,SF,77,36,1801,234,514,.455,112,320,.350,122,194,.629,.564,54,62,.871,53,156,209,85,35,22,50,93,634,Corey Kispert
2022-23,WAS,SF,74,45,2093,291,585,.497,163,384,.424,128,201,.637,.637,75,88,.852,33,174,207,87,32,9,55,97,820,Corey Kispert
2023-24,WAS,SF,80,22,2067,386,794,.486,184,480,.383,202,314,.643,.602,114,157,.726,30,195,225,156,41,16,98,141,1070,Corey Kispert
2024-25,WAS,SF,23,0,626,94,218,.431,45,134,.336,49,84,.583,.534,24,28,.857,8,68,76,36,12,5,26,40,257,Corey Kispert
2017-18,DAL,PF,72,35,1206,151,309,.489,40,128,.313,111,181,.613,.553,44,59,.746,71,163,234,51,26,47,30,114,386,Maxi Kleber
2018-19,DAL,PF,71,18,1502,175,386,.453,77,218,.353,98,168,.583,.553,58,74,.784,90,239,329,70,36,78,54,143,485,Maxi Kleber
2019-20,DAL,PF,74,21,1890,237,514,.461,119,319,.373,118,195,.605,.577,79,93,.849,112,276,388,88,25,83,58,176,672,Maxi Kleber
2020-21,DAL,PF,50,40,1341,116,275,.422,87,212,.410,29,63,.460,.580,34,37,.919,47,213,260,68,24,35,30,105,353,Maxi Kleber
2021-22,DAL,PF,59,21,1450,141,354,.398,83,255,.325,58,99,.586,.516,46,65,.708,70,280,350,68,30,58,47,137,411,Maxi Kleber
2022-23,DAL,PF,37,5,930,77,169,.456,39,112,.348,38,57,.667,.571,27,38,.711,30,105,135,52,12,30,27,85,220,Maxi Kleber
2023-24,DAL,C,43,7,871,63,146,.432,32,92,.348,31,54,.574,.541,33,47,.702,30,113,143,68,17,30,28,79,191,Maxi Kleber
2024-25,DAL,PF,19,2,332,17,42,.405,5,16,.313,12,26,.462,.464,9,12,.750,10,46,56,12,5,7,13,37,48,Maxi Kleber
2024-25,LAL,SF,30,12,670,111,237,.468,52,142,.366,59,95,.621,.578,24,32,.750,20,87,107,33,13,2,17,41,298,Dalton Knecht
2020-21,ATL,PF,33,0,279,37,100,.370,6,33,.182,31,67,.463,.400,44,55,.800,27,45,72,8,9,10,15,22,124,Nathan Knight
2021-22,MIN,PF,37,2,267,45,88,.511,4,13,.308,41,75,.547,.534,44,60,.733,32,53,85,22,7,8,18,42,138,Nathan Knight
2022-23,MIN,C,38,0,291,46,81,.568,8,22,.364,38,59,.644,.617,39,57,.684,22,34,56,13,10,6,21,41,139,Nathan Knight
2018-19,NYK,PF,75,57,2158,338,914,.370,125,364,.343,213,550,.387,.438,162,226,.717,61,274,335,82,43,24,114,175,963,Kevin Knox
2019-20,NYK,SF,65,4,1166,144,401,.359,65,199,.327,79,202,.391,.440,66,101,.653,28,156,184,61,23,28,45,106,419,Kevin Knox
2020-21,NYK,SF,42,0,464,56,143,.392,35,89,.393,21,54,.389,.514,16,20,.800,10,51,61,19,12,6,17,37,163,Kevin Knox
2021-22,2TM,SF,30,0,222,31,85,.365,15,54,.278,16,31,.516,.453,16,22,.727,14,30,44,10,4,2,7,19,93,Kevin Knox
2021-22,NYK,SF,13,0,111,15,40,.375,10,28,.357,5,12,.417,.500,7,10,.700,8,14,22,3,2,1,5,5,47,Kevin Knox
2021-22,ATL,SF,17,0,111,16,45,.356,5,26,.192,11,19,.579,.411,9,12,.750,6,16,22,7,2,1,2,14,46,Kevin Knox
2022-23,2TM,SF,63,5,952,152,332,.458,65,186,.349,87,146,.596,.556,46,60,.767,34,143,177,33,24,12,50,95,415,Kevin Knox
2022-23,DET,SF,42,1,593,84,179,.469,43,116,.371,41,63,.651,.589,26,33,.788,20,88,108,15,14,12,32,74,237,Kevin Knox
2022-23,POR,PF,21,4,359,68,153,.444,22,70,.314,46,83,.554,.516,20,27,.741,14,55,69,18,10,0,18,21,178,Kevin Knox
2023-24,DET,SF,31,11,560,86,186,.462,31,94,.330,55,92,.598,.546,20,22,.909,18,57,75,23,13,7,22,50,223,Kevin Knox
2024-25,NYK,PG,18,0,113,16,39,.410,10,23,.435,6,16,.375,.538,4,4,1.000,2,10,12,11,6,1,7,10,46,Tyler Kolek
2022-23,TOR,C,58,19,802,72,150,.480,1,12,.083,71,138,.514,.483,37,59,.627,84,87,171,31,21,57,20,128,182,Christian Koloko
2024-25,LAL,C,19,0,178,15,25,.600,0,2,.000,15,23,.652,.600,3,4,.750,17,27,44,4,5,8,6,23,33,Christian Koloko
2019-20,MEM,SG,19,0,181,24,37,.649,5,10,.500,19,27,.704,.716,1,2,.500,18,29,47,22,7,3,7,7,54,John Konchar
2020-21,MEM,SG,43,0,575,69,138,.500,21,56,.375,48,82,.585,.576,25,30,.833,35,93,128,47,30,9,18,40,184,John Konchar
2021-22,MEM,SG,72,7,1292,135,262,.515,52,126,.413,83,136,.610,.615,27,49,.551,87,242,329,109,45,22,29,90,349,John Konchar
2022-23,MEM,SF,72,23,1494,138,320,.431,60,177,.339,78,143,.545,.525,28,36,.778,64,246,310,100,77,25,37,112,364,John Konchar
2023-24,MEM,SF,55,23,1173,88,208,.423,38,120,.317,50,88,.568,.514,21,25,.840,72,185,257,110,51,51,46,76,235,John Konchar
2024-25,MEM,SG,17,0,203,16,33,.485,12,28,.429,4,5,.800,.667,3,4,.750,14,34,48,19,9,7,8,14,47,John Konchar
2017-18,PHI,SG,14,0,80,8,28,.286,5,17,.294,3,11,.273,.375,2,4,.500,2,9,11,4,2,1,2,12,23,Furkan Korkmaz
2018-19,PHI,SG,48,7,679,98,245,.400,47,144,.326,51,101,.505,.496,36,44,.818,16,91,107,52,29,2,25,62,279,Furkan Korkmaz
2019-20,PHI,SG,72,12,1559,242,563,.430,143,356,.402,99,207,.478,.557,77,102,.755,18,150,168,79,41,16,59,98,704,Furkan Korkmaz
2020-21,PHI,SG,55,11,1062,170,424,.401,101,269,.375,69,155,.445,.520,60,82,.732,17,96,113,82,49,9,46,64,501,Furkan Korkmaz
2021-22,PHI,SG,67,19,1414,182,470,.387,77,266,.289,105,204,.515,.469,68,84,.810,22,153,175,127,33,9,48,58,509,Furkan Korkmaz
2022-23,PHI,SG,37,0,353,48,111,.432,18,46,.391,30,65,.462,.514,26,36,.722,6,36,42,22,10,3,24,18,140,Furkan Korkmaz
2023-24,PHI,SG,35,0,300,30,76,.395,14,40,.350,16,36,.444,.487,14,20,.700,4,26,30,25,14,3,10,17,88,Furkan Korkmaz
2017-18,NYK,C,20,1,326,49,125,.392,28,79,.354,21,46,.457,.504,8,11,.727,11,53,64,26,6,16,12,28,134,Luke Kornet
2018-19,NYK,C,46,18,784,107,283,.378,70,193,.363,37,90,.411,.502,38,46,.826,28,107,135,54,27,42,25,41,322,Luke Kornet
2019-20,CHI,C,36,14,559,82,187,.439,31,108,.287,51,79,.646,.521,20,28,.714,22,62,84,32,11,26,14,54,215,Luke Kornet
2020-21,2TM,C,31,2,348,44,101,.436,15,59,.254,29,42,.690,.510,3,6,.500,14,53,67,24,4,32,7,20,106,Luke Kornet
2020-21,CHI,C,13,0,94,9,27,.333,6,23,.261,3,4,.750,.444,2,4,.500,1,14,15,4,2,7,1,1,26,Luke Kornet
2020-21,BOS,C,18,2,254,35,74,.473,9,36,.250,26,38,.684,.534,1,2,.500,13,39,52,20,2,25,6,19,80,Luke Kornet
2021-22,3TM,C,15,0,103,13,27,.481,0,5,.000,13,22,.591,.481,4,6,.667,13,16,29,9,3,3,0,9,30,Luke Kornet
2021-22,CLE,C,2,0,15,1,5,.200,0,1,.000,1,4,.250,.200,2,3,.667,2,1,3,1,0,1,0,1,4,Luke Kornet
2021-22,MIL,C,1,0,3,0,1,.000,0,0,,0,1,.000,.000,0,0,,1,0,1,0,0,0,0,1,0,Luke Kornet
2021-22,BOS,C,12,0,85,12,21,.571,0,4,.000,12,17,.706,.571,2,3,.667,10,15,25,8,3,2,0,7,26,Luke Kornet
2022-23,BOS,C,69,0,804,113,170,.665,3,13,.231,110,157,.701,.674,32,39,.821,86,111,197,53,11,46,25,81,261,Luke Kornet
2023-24,BOS,C,63,7,983,142,203,.700,1,1,1.000,141,202,.698,.702,49,54,.907,118,143,261,67,23,61,21,77,334,Luke Kornet
2024-25,BOS,C,25,3,425,44,72,.611,0,0,,44,72,.611,.611,28,37,.757,55,68,123,38,12,25,10,29,116,Luke Kornet
2021-22,OKC,SG,30,8,690,68,167,.407,32,98,.327,36,69,.522,.503,19,22,.864,18,83,101,57,19,8,29,65,187,Vit Krejci
2022-23,ATL,PG,29,0,165,15,37,.405,5,21,.238,10,16,.625,.473,1,2,.500,6,20,26,17,5,1,5,17,36,Vit Krejci
2023-24,ATL,PG,22,14,541,51,104,.490,28,68,.412,23,36,.639,.625,5,6,.833,11,41,52,50,13,6,20,48,135,Vit Krejci
2024-25,ATL,PG,17,1,212,16,47,.340,6,27,.222,10,20,.500,.404,7,11,.636,7,22,29,28,8,5,14,27,45,Vit Krejci
2021-22,GSW,SF,70,12,1185,236,460,.513,50,149,.336,186,311,.598,.567,130,190,.684,54,180,234,64,31,22,74,146,652,Jonathan Kuminga
2022-23,GSW,PF,67,16,1394,261,497,.525,54,146,.370,207,351,.590,.579,90,138,.652,70,161,231,125,41,31,95,157,666,Jonathan Kuminga
2023-24,GSW,PF,74,46,1949,456,862,.529,53,165,.321,403,697,.578,.560,223,299,.746,92,263,355,163,55,36,122,169,1188,Jonathan Kuminga
2024-25,GSW,PF,28,10,725,166,371,.447,33,103,.320,133,268,.496,.492,86,136,.632,37,96,133,58,26,17,44,52,451,Jonathan Kuminga
2017-18,LAL,PF,77,37,2401,468,1039,.450,159,434,.366,309,605,.511,.527,147,208,.707,88,395,483,141,49,34,140,160,1242,Kyle Kuzma
2018-19,LAL,PF,70,68,2314,496,1087,.456,128,422,.303,368,665,.553,.515,188,250,.752,60,322,382,178,41,26,133,170,1308,Kyle Kuzma
2019-20,LAL,PF,61,9,1526,291,668,.436,86,272,.316,205,396,.518,.500,114,155,.735,52,221,273,80,28,26,91,126,782,Kyle Kuzma
2020-21,LAL,SF,68,32,1954,335,757,.443,137,380,.361,198,377,.525,.533,67,97,.691,108,309,417,127,35,41,113,121,874,Kyle Kuzma
2021-22,WAS,PF,66,66,2204,423,936,.452,128,375,.341,295,561,.526,.520,156,219,.712,70,491,561,233,42,57,169,128,1130,Kyle Kuzma
2022-23,WAS,PF,64,64,2239,512,1142,.448,160,481,.333,352,661,.533,.518,173,237,.730,55,408,463,239,36,29,190,145,1357,Kyle Kuzma
2023-24,WAS,PF,70,70,2281,608,1313,.463,151,450,.336,457,863,.530,.521,186,240,.775,62,402,464,296,37,49,192,153,1553,Kyle Kuzma
2024-25,WAS,PF,12,12,330,76,181,.420,16,58,.276,60,123,.488,.464,22,32,.688,8,59,67,23,5,3,29,23,190,Kyle Kuzma
2022-23,MEM,PF,35,0,414,37,95,.389,24,71,.338,13,24,.542,.516,7,9,.778,19,44,63,21,12,4,18,49,105,Jake LaRavia
2023-24,MEM,PF,35,6,806,118,303,.389,53,156,.340,65,147,.442,.477,90,109,.826,51,77,128,58,29,12,45,69,379,Jake LaRavia
2024-25,MEM,PF,32,0,715,95,193,.492,32,72,.444,63,121,.521,.575,48,68,.706,48,99,147,104,29,18,53,71,270,Jake LaRavia
2014-15,MIN,PG,77,40,1902,286,677,.422,57,167,.341,229,510,.449,.465,149,177,.842,27,187,214,276,54,10,193,158,778,Zach LaVine
2015-16,MIN,SG,82,33,2294,433,959,.452,123,316,.389,310,643,.482,.516,161,203,.793,27,201,228,251,69,17,155,193,1150,Zach LaVine
2016-17,MIN,SG,47,47,1749,326,710,.459,120,310,.387,206,400,.515,.544,117,140,.836,19,141,160,139,41,10,85,104,889,Zach LaVine
2017-18,CHI,SG,24,24,656,136,355,.383,42,123,.341,94,232,.405,.442,87,107,.813,9,85,94,72,24,4,43,55,401,Zach LaVine
2018-19,CHI,SG,63,62,2171,530,1135,.467,120,321,.374,410,814,.504,.520,312,375,.832,40,254,294,283,60,26,215,140,1492,Zach LaVine
2019-20,CHI,SF,60,60,2085,539,1199,.450,184,484,.380,355,715,.497,.526,268,334,.802,41,248,289,254,88,28,206,131,1530,Zach LaVine
2020-21,CHI,SG,58,58,2034,569,1123,.507,200,477,.419,369,646,.571,.596,253,298,.849,36,253,289,282,46,27,203,138,1591,Zach LaVine
2021-22,CHI,SG,67,67,2328,565,1186,.476,185,475,.389,380,711,.534,.554,320,375,.853,22,286,308,303,41,23,171,120,1635,Zach LaVine
2022-23,CHI,SG,77,77,2768,673,1388,.485,204,544,.375,469,844,.556,.558,363,428,.848,42,303,345,327,69,18,194,159,1913,Zach LaVine
2023-24,CHI,SG,25,23,872,170,376,.452,59,169,.349,111,207,.536,.531,88,103,.854,8,121,129,98,21,8,52,57,487,Zach LaVine
2024-25,CHI,SF,27,27,899,215,429,.501,92,204,.451,123,225,.547,.608,79,96,.823,6,116,122,114,23,7,80,47,601,Zach LaVine
2020-21,HOU,SF,24,3,415,46,118,.390,23,71,.324,23,47,.489,.487,18,21,.857,27,43,70,23,6,5,19,34,133,Anthony Lamb
2021-22,SAS,SF,2,0,8,0,2,.000,0,2,.000,0,0,,.000,0,0,,0,1,1,2,0,0,0,0,0,Anthony Lamb
2022-23,GSW,SF,62,4,1195,148,314,.471,73,199,.367,75,115,.652,.588,46,60,.767,56,159,215,96,28,20,54,134,415,Anthony Lamb
2021-22,SAS,C,54,1,589,101,204,.495,29,89,.326,72,115,.626,.566,34,41,.829,63,75,138,45,10,14,31,53,265,Jock Landale
2022-23,PHO,C,69,4,979,178,337,.528,21,84,.250,157,253,.621,.559,79,105,.752,119,161,280,68,16,30,59,126,456,Jock Landale
2023-24,HOU,C,56,3,763,106,206,.515,10,40,.250,96,166,.578,.539,52,65,.800,88,84,172,65,20,33,31,74,274,Jock Landale
2024-25,HOU,C,18,0,175,21,50,.420,3,7,.429,18,43,.419,.450,10,19,.526,21,27,48,14,3,7,10,15,55,Jock Landale
2019-20,BOS,SG,32,2,370,28,80,.350,5,27,.185,23,53,.434,.381,18,25,.720,15,26,41,13,8,8,11,33,79,Romeo Langford
2020-21,BOS,SG,18,4,283,21,59,.356,5,18,.278,16,41,.390,.398,9,12,.750,12,23,35,13,6,5,10,24,56,Romeo Langford
2021-22,2TM,SG,48,5,771,83,191,.435,29,85,.341,54,106,.509,.510,23,42,.548,30,78,108,21,22,16,16,47,218,Romeo Langford
2021-22,BOS,SG,44,5,728,79,184,.429,29,83,.349,50,101,.495,.508,20,34,.588,30,74,104,19,21,16,16,46,207,Romeo Langford
2021-22,SAS,SG,4,0,43,4,7,.571,0,2,.000,4,5,.800,.571,3,8,.375,0,4,4,2,1,0,0,1,11,Romeo Langford
2022-23,SAS,SG,43,21,844,121,259,.467,16,61,.262,105,198,.530,.498,39,56,.696,57,57,114,50,24,13,30,67,297,Romeo Langford
2024-25,MIA,SG,17,0,286,35,70,.500,11,32,.344,24,38,.632,.579,16,25,.640,10,23,33,25,10,0,10,39,97,Pelle Larsson
2022-23,2TM,SG,15,0,108,22,44,.500,10,25,.400,12,19,.632,.614,2,8,.250,6,15,21,2,2,0,3,11,56,A.J. Lawson
2022-23,MIN,SG,1,0,2,1,1,1.000,0,0,,1,1,1.000,1.000,0,0,,0,1,1,0,0,0,0,1,2,A.J. Lawson
2022-23,DAL,SG,14,0,106,21,43,.488,10,25,.400,11,18,.611,.605,2,8,.250,6,14,20,2,2,0,3,10,54,A.J. Lawson
2023-24,DAL,SG,42,0,311,54,121,.446,13,50,.260,41,71,.577,.500,15,23,.652,14,36,50,20,10,3,14,22,136,A.J. Lawson
2024-25,TOR,SG,2,0,10,3,4,.750,2,2,1.000,1,2,.500,1.000,1,2,.500,0,2,2,0,0,0,0,0,9,A.J. Lawson
2016-17,POR,SF,35,1,249,26,89,.292,13,51,.255,13,38,.342,.365,13,17,.765,6,18,24,11,9,3,11,22,78,Jake Layman
2017-18,POR,SF,35,1,160,14,47,.298,4,20,.200,10,27,.370,.340,2,3,.667,4,12,16,11,6,4,5,13,34,Jake Layman
2018-19,POR,SF,71,33,1327,216,424,.509,59,181,.326,157,243,.646,.579,50,71,.704,56,161,217,53,31,30,46,116,541,Jake Layman
2019-20,MIN,SF,23,2,505,81,179,.453,24,72,.333,57,107,.533,.520,24,32,.750,17,40,57,15,17,10,24,47,210,Jake Layman
2020-21,MIN,SF,45,11,627,91,184,.495,23,78,.295,68,106,.642,.557,26,37,.703,13,54,67,28,29,19,26,44,231,Jake Layman
2021-22,MIN,SF,34,1,231,30,73,.411,8,35,.229,22,38,.579,.466,13,18,.722,6,30,36,9,7,5,10,12,81,Jake Layman
2016-17,BRK,SF,57,26,1237,171,380,.450,59,184,.321,112,196,.571,.528,67,93,.720,23,165,188,110,49,8,59,91,468,Caris LeVert
2017-18,BRK,SF,71,10,1864,320,735,.435,85,245,.347,235,490,.480,.493,133,187,.711,53,207,260,299,82,22,153,159,858,Caris LeVert
2018-19,BRK,SF,40,25,1063,207,483,.429,48,154,.312,159,329,.483,.478,85,123,.691,35,116,151,156,42,14,69,77,547,Caris LeVert
2019-20,BRK,SG,45,31,1330,311,732,.425,80,220,.364,231,512,.451,.480,140,197,.711,49,140,189,199,53,10,118,81,842,Caris LeVert
2020-21,2TM,SG,47,39,1486,359,814,.441,84,258,.326,275,556,.495,.493,146,180,.811,33,181,214,245,66,30,102,105,948,Caris LeVert
2020-21,BRK,SG,12,4,334,87,200,.435,22,63,.349,65,137,.474,.490,26,34,.765,10,42,52,72,13,6,26,20,222,Caris LeVert
2020-21,IND,SG,35,35,1152,272,614,.443,62,195,.318,210,419,.501,.493,120,146,.822,23,139,162,173,53,24,76,85,726,Caris LeVert
2021-22,2TM,SG,58,49,1781,379,854,.444,82,256,.320,297,598,.497,.492,146,193,.756,43,171,214,248,51,23,108,131,986,Caris LeVert
2021-22,IND,SG,39,39,1214,278,622,.447,61,189,.323,217,433,.501,.496,111,146,.760,30,120,150,173,35,18,75,91,728,Caris LeVert
2021-22,CLE,SG,19,10,567,101,232,.435,21,67,.313,80,165,.485,.481,35,47,.745,13,51,64,75,16,5,33,40,258,Caris LeVert
2022-23,CLE,SG,74,30,2237,320,742,.431,127,324,.392,193,418,.462,.517,130,180,.722,53,229,282,287,72,24,116,170,897,Caris LeVert
2023-24,CLE,SG,68,10,1958,345,820,.421,108,332,.325,237,488,.486,.487,154,201,.766,39,241,280,346,76,34,117,121,952,Caris LeVert
2024-25,CLE,SF,25,0,599,105,202,.520,46,97,.474,59,105,.562,.634,45,65,.692,13,57,70,99,23,12,33,34,301,Caris LeVert
2019-20,PHO,SG,5,0,32,4,10,.400,0,4,.000,4,6,.667,.400,2,2,1.000,0,2,2,2,0,0,2,3,10,Jalen Lecque
2020-21,IND,PG,4,0,12,1,9,.111,0,1,.000,1,8,.125,.111,3,3,1.000,2,3,5,2,0,0,0,0,5,Jalen Lecque
2017-18,ATL,SG,15,11,404,62,152,.408,15,60,.250,47,92,.511,.457,22,29,.759,11,60,71,29,19,1,14,25,161,Damion Lee
2018-19,GSW,SG,32,0,375,56,127,.441,27,68,.397,29,59,.492,.547,19,22,.864,8,56,64,13,13,0,11,28,158,Damion Lee
2019-20,GSW,SG,49,36,1423,213,511,.417,85,239,.356,128,272,.471,.500,110,126,.873,32,207,239,133,50,6,67,116,621,Damion Lee
2020-21,GSW,SG,57,1,1079,128,274,.467,77,194,.397,51,80,.638,.608,40,44,.909,22,158,180,73,38,8,30,89,373,Damion Lee
2021-22,GSW,SG,63,5,1256,169,383,.441,63,187,.337,106,196,.541,.523,66,75,.880,27,176,203,63,39,6,38,95,467,Damion Lee
2022-23,PHO,SG,74,5,1506,200,452,.442,110,247,.445,90,205,.439,.564,94,104,.904,39,186,225,99,30,7,78,118,604,Damion Lee
2024-25,PHO,SG,6,0,45,5,20,.250,1,11,.091,4,9,.444,.275,6,6,1.000,0,5,5,5,2,0,3,2,17,Damion Lee
2020-21,DET,PG,48,7,781,99,210,.471,8,23,.348,91,187,.487,.490,61,89,.685,20,77,97,174,32,13,55,76,267,Saben Lee
2021-22,DET,PG,37,0,604,69,177,.390,14,60,.233,55,117,.470,.429,56,71,.789,18,69,87,107,36,12,36,44,208,Saben Lee
2022-23,2TM,PG,25,1,373,49,121,.405,11,30,.367,38,91,.418,.450,42,57,.737,13,32,45,67,19,1,24,32,151,Saben Lee
2022-23,PHI,PG,2,0,10,3,4,.750,0,1,.000,3,3,1.000,.750,0,0,,0,0,0,2,1,0,3,1,6,Saben Lee
2022-23,PHO,PG,23,1,363,46,117,.393,11,29,.379,35,88,.398,.440,42,57,.737,13,32,45,65,18,1,21,31,145,Saben Lee
2023-24,PHO,PG,24,0,185,20,55,.364,2,16,.125,18,39,.462,.382,29,39,.744,9,22,31,30,7,3,8,13,71,Saben Lee
2013-14,PHO,C,42,3,362,33,78,.423,0,0,,33,78,.423,.423,20,31,.645,39,60,99,4,4,18,26,68,86,Alex Len
2014-15,PHO,C,69,44,1518,179,353,.507,1,3,.333,178,350,.509,.508,73,104,.702,142,312,454,32,34,105,74,213,432,Alex Len
2015-16,PHO,C,78,46,1821,264,624,.423,1,7,.143,263,617,.426,.424,174,239,.728,178,416,594,97,38,62,145,230,703,Alex Len
2016-17,PHO,C,77,34,1560,230,463,.497,3,12,.250,227,451,.503,.500,150,208,.721,156,354,510,44,38,98,102,242,613,Alex Len
2017-18,PHO,C,69,13,1395,214,378,.566,1,3,.333,213,375,.568,.567,158,231,.684,175,343,518,82,27,61,78,158,587,Alex Len
2018-19,ATL,C,77,31,1544,320,648,.494,74,204,.363,246,444,.554,.551,140,216,.648,158,266,424,86,27,69,97,200,854,Alex Len
2019-20,2TM,C,55,12,970,177,319,.555,16,59,.271,161,260,.619,.580,68,105,.648,100,221,321,50,23,48,55,127,438,Alex Len
2019-20,ATL,C,40,9,745,142,260,.546,14,56,.250,128,204,.627,.573,51,81,.630,69,161,230,42,20,33,39,93,349,Alex Len
2019-20,SAC,C,15,3,225,35,59,.593,2,3,.667,33,56,.589,.610,17,24,.708,31,60,91,8,3,15,16,34,89,Alex Len
2020-21,2TM,C,64,42,979,171,278,.615,8,25,.320,163,253,.644,.629,73,116,.629,78,182,260,49,20,64,55,127,423,Alex Len
2020-21,TOR,C,7,2,76,5,10,.500,3,6,.500,2,4,.500,.650,3,6,.500,0,11,11,3,1,6,8,10,16,Alex Len
2020-21,WAS,C,57,40,903,166,268,.619,5,19,.263,161,249,.647,.629,70,110,.636,78,171,249,46,19,58,47,117,407,Alex Len
2021-22,SAC,C,39,10,620,94,176,.534,6,21,.286,88,155,.568,.551,41,63,.651,52,109,161,45,13,25,43,100,235,Alex Len
2022-23,SAC,C,26,2,161,16,30,.533,0,2,.000,16,28,.571,.533,11,16,.688,24,36,60,12,4,11,16,28,43,Alex Len
2023-24,SAC,C,48,0,444,50,81,.617,0,3,.000,50,78,.641,.617,20,34,.588,46,82,128,50,11,33,27,66,120,Alex Len
2024-25,SAC,C,23,3,165,14,25,.560,0,4,.000,14,21,.667,.560,5,9,.556,11,30,41,21,3,14,7,20,33,Alex Len
2011-12,SAS,SF,64,39,1534,199,404,.493,41,109,.376,158,295,.536,.543,68,88,.773,104,223,327,70,85,24,44,88,507,Kawhi Leonard
2012-13,SAS,SF,58,57,1810,260,526,.494,65,174,.374,195,352,.554,.556,104,126,.825,63,283,346,93,97,32,62,99,689,Kawhi Leonard
2013-14,SAS,SF,66,65,1923,337,645,.522,69,182,.379,268,463,.579,.576,101,126,.802,76,336,412,133,114,50,80,127,844,Kawhi Leonard
2014-15,SAS,SF,64,64,2033,394,822,.479,67,192,.349,327,630,.519,.520,202,252,.802,85,376,461,161,148,48,97,128,1057,Kawhi Leonard
2015-16,SAS,SF,72,72,2380,551,1090,.506,129,291,.443,422,799,.528,.565,292,334,.874,95,398,493,186,128,71,105,133,1523,Kawhi Leonard
2016-17,SAS,SF,74,74,2474,636,1312,.485,147,387,.380,489,925,.529,.541,469,533,.880,80,350,430,260,133,55,154,122,1888,Kawhi Leonard
2017-18,SAS,SF,9,9,210,52,111,.468,11,35,.314,41,76,.539,.518,31,38,.816,6,36,42,21,18,9,16,9,146,Kawhi Leonard
2018-19,TOR,SF,60,60,2040,560,1129,.496,112,302,.371,448,827,.542,.546,364,426,.854,78,361,439,199,106,24,121,87,1596,Kawhi Leonard
2019-20,LAC,SF,57,57,1848,532,1133,.470,123,325,.378,409,808,.506,.524,356,402,.886,54,348,402,280,103,33,149,113,1543,Kawhi Leonard
2020-21,LAC,SF,52,52,1773,465,908,.512,101,254,.398,364,654,.557,.568,261,295,.885,55,282,337,269,81,21,105,82,1292,Kawhi Leonard
2022-23,LAC,SF,52,50,1748,446,871,.512,104,250,.416,342,621,.551,.572,243,279,.871,57,281,338,204,72,28,88,84,1239,Kawhi Leonard
2023-24,LAC,SF,68,68,2330,610,1162,.525,140,336,.417,470,826,.569,.585,253,286,.885,84,332,416,244,111,59,119,97,1613,Kawhi Leonard
2012-13,POR,C,69,9,1206,151,277,.545,3,7,.429,148,270,.548,.551,72,89,.809,80,175,255,33,11,38,49,168,377,Meyers Leonard
2013-14,POR,C,40,0,355,41,91,.451,0,6,.000,41,85,.482,.451,16,21,.762,26,85,111,18,7,5,15,76,98,Meyers Leonard
2014-15,POR,C,55,7,847,125,245,.510,47,112,.420,78,133,.586,.606,30,32,.938,46,204,250,32,10,14,39,113,327,Meyers Leonard
2015-16,POR,PF,61,10,1333,195,435,.448,86,228,.377,109,207,.527,.547,35,46,.761,51,263,314,92,8,18,77,183,511,Meyers Leonard
2016-17,POR,PF,74,12,1222,146,378,.386,74,213,.347,72,165,.436,.484,35,40,.875,27,210,237,71,13,28,35,172,401,Meyers Leonard
2017-18,POR,C,33,2,254,46,78,.590,11,26,.423,35,52,.673,.660,9,11,.818,12,58,70,17,7,0,10,36,112,Meyers Leonard
2018-19,POR,C,61,2,878,132,242,.545,50,111,.450,82,131,.626,.649,43,51,.843,49,184,233,75,13,9,43,105,357,Meyers Leonard
2019-20,MIA,C,51,49,1034,119,234,.509,53,128,.414,66,106,.623,.622,18,28,.643,30,230,260,55,14,15,39,107,309,Meyers Leonard
2020-21,MIA,C,3,2,29,3,7,.429,3,7,.429,0,0,,.643,1,2,.500,0,7,7,2,0,0,2,5,10,Meyers Leonard
2022-23,MIL,C,9,2,114,14,29,.483,7,18,.389,7,11,.636,.603,8,9,.889,12,22,34,1,2,0,6,16,43,Meyers Leonard
2024-25,OKC,SF,6,0,21,0,2,.000,0,1,.000,0,1,.000,.000,2,4,.500,1,2,3,1,0,0,1,4,2,Malevy Leons
2020-21,NOP,PG,54,0,904,130,337,.386,40,120,.333,90,217,.415,.445,43,51,.843,12,59,71,124,38,10,34,88,343,Kira Lewis Jr.
2021-22,NOP,PG,24,0,341,59,146,.404,13,58,.224,46,88,.523,.449,10,12,.833,9,30,39,49,11,1,26,17,141,Kira Lewis Jr.
2022-23,NOP,PG,25,0,235,40,88,.455,15,34,.441,25,54,.463,.540,19,22,.864,5,28,33,23,10,2,10,24,114,Kira Lewis Jr.
2023-24,3TM,PG,28,0,265,34,92,.370,4,33,.121,30,59,.508,.391,17,20,.850,9,17,26,37,9,2,14,13,89,Kira Lewis Jr.
2023-24,NOP,PG,15,0,144,16,52,.308,2,20,.100,14,32,.438,.327,10,11,.909,4,10,14,18,5,1,8,8,44,Kira Lewis Jr.
2023-24,TOR,PG,1,0,2,0,0,,0,0,,0,0,,,0,0,,0,0,0,0,0,0,0,1,0,Kira Lewis Jr.
2023-24,UTA,PG,12,0,119,18,40,.450,2,13,.154,16,27,.593,.475,7,9,.778,5,7,12,19,4,1,6,4,45,Kira Lewis Jr.
2023-24,LAL,SF,34,0,103,4,21,.190,1,9,.111,3,12,.250,.214,2,3,.667,2,2,4,6,2,1,10,5,11,Maxwell Lewis
2024-25,LAL,SF,7,0,29,2,6,.333,0,0,,2,6,.333,.333,0,0,,2,0,2,2,1,0,2,1,4,Maxwell Lewis
2023-24,NOP,PF,8,0,23,1,6,.167,0,5,.000,1,1,1.000,.167,2,2,1.000,0,5,5,1,2,2,2,2,4,E.J. Liddell
2024-25,CHI,PF,6,0,31,5,8,.625,3,6,.500,2,2,1.000,.813,2,2,1.000,1,4,5,3,1,1,2,8,15,E.J. Liddell
2012-13,POR,PG,82,82,3167,553,1288,.429,185,503,.368,368,785,.469,.501,271,321,.844,42,215,257,531,74,19,243,172,1562,Damian Lillard
2013-14,POR,PG,82,82,2937,553,1304,.424,218,554,.394,335,750,.447,.508,371,426,.871,35,253,288,457,64,22,193,197,1695,Damian Lillard
2014-15,POR,PG,82,82,2925,590,1360,.434,196,572,.343,394,788,.500,.506,344,398,.864,49,329,378,507,97,21,222,164,1720,Damian Lillard
2015-16,POR,PG,75,75,2676,618,1474,.419,229,610,.375,389,864,.450,.497,414,464,.892,45,257,302,512,65,28,242,165,1879,Damian Lillard
2016-17,POR,PG,75,75,2694,661,1488,.444,214,579,.370,447,909,.492,.516,488,545,.895,46,322,368,440,68,20,197,152,2024,Damian Lillard
2017-18,POR,PG,73,73,2670,621,1415,.439,227,629,.361,394,786,.501,.519,493,538,.916,62,263,325,481,77,27,206,117,1962,Damian Lillard
2018-19,POR,PG,80,80,2838,681,1533,.444,237,643,.369,444,890,.499,.522,468,513,.912,68,303,371,551,88,34,212,148,2067,Damian Lillard
2019-20,POR,PG,66,66,2474,624,1349,.463,270,674,.401,354,675,.524,.563,460,518,.888,33,251,284,530,70,22,194,114,1978,Damian Lillard
2020-21,POR,PG,67,67,2398,602,1334,.451,275,704,.391,327,630,.519,.554,449,484,.928,32,251,283,505,62,17,203,102,1928,Damian Lillard
2021-22,POR,PG,29,29,1056,222,552,.402,92,284,.324,130,268,.485,.486,159,181,.878,13,107,120,212,17,11,83,37,695,Damian Lillard
2022-23,POR,PG,58,58,2107,556,1202,.463,244,658,.371,312,544,.574,.564,510,558,.914,44,233,277,425,50,18,191,109,1866,Damian Lillard
2023-24,MIL,PG,73,73,2579,541,1277,.424,220,622,.354,321,655,.490,.510,473,514,.920,36,284,320,508,72,18,193,134,1775,Damian Lillard
2024-25,MIL,PG,22,22,800,174,387,.450,76,205,.371,98,182,.538,.548,142,155,.916,12,87,99,166,23,4,66,42,566,Damian Lillard
2019-20,POR,PF,48,5,573,65,151,.430,14,59,.237,51,92,.554,.477,28,44,.636,31,77,108,22,13,14,15,72,172,Nassir Little
2020-21,POR,PF,48,2,640,78,167,.467,28,80,.350,50,87,.575,.551,36,45,.800,32,96,128,23,5,13,18,51,220,Nassir Little
2021-22,POR,SF,42,23,1088,145,315,.460,51,154,.331,94,161,.584,.541,69,94,.734,58,178,236,54,25,36,40,82,410,Nassir Little
2022-23,POR,SF,54,4,976,134,303,.442,58,158,.367,76,145,.524,.538,33,46,.717,27,114,141,50,20,20,36,66,359,Nassir Little
2023-24,PHO,SF,45,2,458,57,124,.460,21,70,.300,36,54,.667,.544,17,20,.850,14,61,75,21,10,10,14,39,152,Nassir Little
2023-24,DAL,C,55,42,1294,221,296,.747,0,2,.000,221,294,.752,.747,41,81,.506,135,243,378,60,36,77,50,144,483,Dereck Lively II
2024-25,DAL,C,25,18,603,90,129,.698,0,0,,90,129,.698,.698,37,60,.617,77,117,194,62,16,40,32,72,217,Dereck Lively II
2021-22,DET,SF,19,5,383,41,90,.456,27,64,.422,14,26,.538,.606,12,14,.857,15,42,57,21,13,7,15,37,121,Isaiah Livers
2022-23,DET,PF,52,22,1199,120,288,.417,74,203,.365,46,85,.541,.545,32,39,.821,28,115,143,41,28,28,30,103,346,Isaiah Livers
2023-24,DET,PF,23,6,469,40,116,.345,22,77,.286,18,39,.462,.440,12,18,.667,15,33,48,25,13,5,16,43,114,Isaiah Livers
2023-24,MIL,SF,21,0,90,11,22,.500,1,5,.200,10,17,.588,.523,3,4,.750,3,18,21,5,2,0,5,15,26,Chris Livingston
2024-25,MIL,SF,3,0,6,1,2,.500,0,0,,1,2,.500,.500,0,0,,1,1,2,1,1,0,1,0,2,Chris Livingston
2022-23,MEM,PF,24,1,176,49,93,.527,6,17,.353,43,76,.566,.559,16,27,.593,19,32,51,20,5,2,12,28,120,Kenneth Lofton Jr.
2023-24,3TM,PF,21,0,199,36,78,.462,7,24,.292,29,54,.537,.506,17,26,.654,12,26,38,33,6,5,14,24,96,Kenneth Lofton Jr.
2023-24,MEM,PF,15,0,99,14,37,.378,3,10,.300,11,27,.407,.419,8,15,.533,2,13,15,14,3,3,6,15,39,Kenneth Lofton Jr.
2023-24,PHI,PF,2,0,9,1,6,.167,0,2,.000,1,4,.250,.167,0,0,,0,3,3,0,0,0,2,0,2,Kenneth Lofton Jr.
2023-24,UTA,PF,4,0,91,21,35,.600,4,12,.333,17,23,.739,.657,9,11,.818,10,10,20,19,3,2,6,9,55,Kenneth Lofton Jr.
2015-16,GSW,PF,5,0,21,4,7,.571,1,2,.500,3,5,.600,.643,0,0,,4,6,10,0,0,0,1,2,9,Kevon Looney
2016-17,GSW,C,53,4,447,56,107,.523,2,9,.222,54,98,.551,.533,21,34,.618,44,80,124,29,15,17,17,64,135,Kevon Looney
2017-18,GSW,C,66,4,910,112,193,.580,1,5,.200,111,188,.590,.583,42,77,.545,83,132,215,42,34,56,31,106,267,Kevon Looney
2018-19,GSW,C,80,24,1481,217,347,.625,1,10,.100,216,337,.641,.627,65,105,.619,194,223,417,123,46,53,51,211,500,Kevon Looney
2019-20,GSW,C,20,4,262,29,79,.367,1,14,.071,28,65,.431,.373,9,12,.750,28,38,66,20,12,6,12,34,68,Kevon Looney
2020-21,GSW,C,61,34,1161,108,197,.548,4,17,.235,104,180,.578,.558,31,48,.646,117,205,322,119,21,22,37,136,251,Kevon Looney
2021-22,GSW,C,82,80,1732,208,364,.571,0,1,.000,208,363,.573,.571,75,125,.600,208,388,596,165,50,52,67,215,491,Kevon Looney
2022-23,GSW,C,82,70,1958,242,384,.630,0,1,.000,242,383,.632,.630,94,155,.606,274,486,760,207,52,50,45,225,578,Kevon Looney
2023-24,GSW,C,74,36,1195,139,233,.597,0,1,.000,139,232,.599,.597,56,83,.675,143,276,419,133,28,29,50,155,334,Kevon Looney
2024-25,GSW,C,28,5,442,59,112,.527,0,0,,59,112,.527,.527,18,41,.439,87,107,194,47,20,6,17,64,136,Kevon Looney
2008-09,NJN,C,82,75,2501,448,844,.531,0,2,.000,448,842,.532,.531,172,217,.793,225,440,665,86,44,151,147,257,1068,Brook Lopez
2009-10,NJN,C,82,82,3027,563,1129,.499,0,2,.000,563,1127,.500,.499,416,509,.817,270,439,709,187,55,139,204,251,1542,Brook Lopez
2010-11,NJN,C,82,82,2889,644,1309,.492,0,1,.000,644,1308,.492,.492,385,489,.787,197,291,488,129,47,120,176,240,1673,Brook Lopez
2011-12,NJN,C,5,5,136,38,77,.494,0,0,,38,77,.494,.494,20,32,.625,8,10,18,6,1,4,6,8,96,Brook Lopez
2012-13,BRK,C,74,74,2253,570,1094,.521,0,1,.000,570,1093,.522,.521,297,392,.758,208,304,512,70,33,154,131,152,1437,Brook Lopez
2013-14,BRK,C,17,17,533,129,229,.563,0,1,.000,129,228,.566,.563,94,115,.817,39,63,102,16,9,30,28,52,352,Brook Lopez
2014-15,BRK,C,72,44,2100,506,987,.513,1,10,.100,505,977,.517,.513,223,274,.814,214,321,535,50,43,126,104,206,1236,Brook Lopez
2015-16,BRK,C,73,73,2457,591,1157,.511,2,14,.143,589,1143,.515,.512,317,403,.787,204,369,573,147,58,124,175,215,1501,Brook Lopez
2016-17,BRK,C,75,75,2222,555,1172,.474,134,387,.346,421,785,.536,.531,295,364,.810,121,282,403,176,38,124,184,192,1539,Brook Lopez
2017-18,LAL,C,74,72,1735,369,793,.465,112,325,.345,257,468,.549,.536,111,158,.703,74,220,294,126,30,98,98,195,961,Brook Lopez
2018-19,MIL,C,81,81,2322,355,786,.452,187,512,.365,168,274,.613,.571,112,133,.842,33,363,396,98,51,179,82,189,1009,Brook Lopez
2019-20,MIL,C,68,67,1817,292,671,.435,102,325,.314,190,346,.549,.511,127,152,.836,58,254,312,99,46,163,70,163,813,Brook Lopez
2020-21,MIL,C,70,70,1902,322,640,.503,95,281,.338,227,359,.632,.577,120,142,.845,104,243,347,50,40,103,64,149,859,Brook Lopez
2021-22,MIL,C,13,11,298,61,131,.466,19,53,.358,42,78,.538,.538,20,23,.870,19,34,53,6,8,15,12,34,161,Brook Lopez
2022-23,MIL,C,78,78,2373,477,899,.531,136,364,.374,341,535,.637,.606,149,190,.784,157,363,520,99,37,193,107,203,1239,Brook Lopez
2023-24,MIL,C,79,79,2411,366,755,.485,148,404,.366,218,351,.621,.583,110,134,.821,117,292,409,127,43,189,79,191,990,Brook Lopez
2024-25,MIL,C,29,29,942,131,267,.491,56,145,.386,75,122,.615,.596,28,38,.737,35,104,139,44,28,57,32,66,346,Brook Lopez
2008-09,PHO,C,60,7,614,71,137,.518,0,1,.000,71,136,.522,.518,47,68,.691,52,66,118,8,11,41,28,97,189,Robin Lopez
2009-10,PHO,C,51,31,986,171,291,.588,0,0,,171,291,.588,.588,88,125,.704,104,144,248,7,10,53,41,117,430,Robin Lopez
2010-11,PHO,C,67,56,991,179,357,.501,0,0,,179,357,.501,.501,74,100,.740,82,134,216,8,18,45,48,143,432,Robin Lopez
2011-12,PHO,C,64,0,895,124,269,.461,0,0,,124,269,.461,.461,100,140,.714,90,119,209,20,18,60,43,128,348,Robin Lopez
2012-13,NOH,C,82,82,2136,384,719,.534,0,0,,384,719,.534,.534,161,207,.778,226,236,462,64,32,128,110,167,929,Robin Lopez
2013-14,POR,C,82,82,2603,355,644,.551,0,1,.000,355,643,.552,.551,198,242,.818,326,374,700,73,25,139,84,196,908,Robin Lopez
2014-15,POR,C,59,59,1638,234,437,.535,0,1,.000,234,436,.537,.535,98,127,.772,190,204,394,55,16,84,73,122,566,Robin Lopez
2015-16,NYK,C,82,82,2219,357,662,.539,0,1,.000,357,661,.540,.539,128,161,.795,268,334,602,114,16,129,133,182,842,Robin Lopez
2016-17,CHI,C,81,81,2271,382,775,.493,0,2,.000,382,773,.494,.493,75,104,.721,244,276,520,80,18,117,91,151,839,Robin Lopez
2017-18,CHI,C,64,64,1690,342,645,.530,4,14,.286,338,631,.536,.533,68,90,.756,134,156,290,124,14,53,107,109,756,Robin Lopez
2018-19,CHI,C,74,36,1606,304,535,.568,7,31,.226,297,504,.589,.575,89,123,.724,140,146,286,89,11,78,96,124,704,Robin Lopez
2019-20,MIL,C,66,5,958,147,299,.492,35,105,.333,112,194,.577,.550,28,53,.528,56,105,161,45,10,45,63,96,357,Robin Lopez
2020-21,WAS,C,71,9,1354,269,425,.633,5,18,.278,264,407,.649,.639,99,137,.723,141,131,272,55,15,44,75,109,642,Robin Lopez
2021-22,ORL,C,36,9,612,110,199,.553,2,6,.333,108,193,.560,.558,32,54,.593,68,58,126,54,2,18,44,67,254,Robin Lopez
2022-23,CLE,C,37,2,299,48,75,.640,2,4,.500,46,71,.648,.653,14,18,.778,23,28,51,19,2,8,25,43,112,Robin Lopez
2023-24,MIL,C,16,2,65,7,19,.368,2,8,.250,5,11,.455,.421,2,2,1.000,3,2,5,4,1,3,2,7,18,Robin Lopez
2020-21,NOP,SF,3,0,56,3,13,.231,2,8,.250,1,5,.200,.308,0,0,,1,2,3,3,2,0,3,5,8,Didi Louzada
2021-22,2TM,SF,9,1,129,12,33,.364,9,23,.391,3,10,.300,.500,2,2,1.000,5,12,17,5,2,2,5,13,35,Didi Louzada
2021-22,NOP,SF,2,0,7,0,3,.000,0,3,.000,0,0,,.000,0,0,,2,0,2,1,0,0,0,0,0,Didi Louzada
2021-22,POR,SG,7,1,122,12,30,.400,9,20,.450,3,10,.300,.550,2,2,1.000,3,12,15,4,2,2,5,13,35,Didi Louzada
2008-09,MIN,C,81,37,2048,316,688,.459,2,19,.105,314,669,.469,.461,265,336,.789,274,460,734,84,35,50,118,205,899,Kevin Love
2009-10,MIN,PF,60,22,1714,291,646,.450,35,106,.330,256,540,.474,.478,225,276,.815,227,431,658,136,43,23,117,136,842,Kevin Love
2010-11,MIN,PF,73,73,2611,482,1026,.470,88,211,.417,394,815,.483,.513,424,499,.850,330,782,1112,184,45,28,155,148,1476,Kevin Love
2011-12,MIN,PF,55,55,2145,474,1059,.448,105,282,.372,369,777,.475,.497,379,460,.824,226,508,734,111,47,28,128,152,1432,Kevin Love
2012-13,MIN,PF,18,18,618,105,298,.352,20,92,.217,85,206,.413,.386,100,142,.704,64,188,252,42,13,9,39,34,330,Kevin Love
2013-14,MIN,PF,77,77,2797,650,1421,.457,190,505,.376,460,916,.502,.524,520,633,.821,224,739,963,341,59,35,196,136,2010,Kevin Love
2014-15,CLE,PF,75,75,2532,413,952,.434,144,392,.367,269,560,.480,.509,258,321,.804,142,589,731,168,51,39,122,140,1228,Kevin Love
2015-16,CLE,PF,77,77,2424,409,977,.419,158,439,.360,251,538,.467,.499,258,314,.822,149,613,762,186,58,41,142,159,1234,Kevin Love
2016-17,CLE,PF,60,60,1885,370,867,.427,145,389,.373,225,478,.471,.510,257,295,.871,148,518,666,116,53,21,122,125,1142,Kevin Love
2017-18,CLE,C,59,59,1651,334,729,.458,137,330,.415,197,399,.494,.552,234,266,.880,101,445,546,103,43,24,90,120,1039,Kevin Love
2018-19,CLE,PF,22,21,598,109,283,.385,53,147,.361,56,136,.412,.479,103,114,.904,33,206,239,48,6,5,42,54,374,Kevin Love
2019-20,CLE,PF,56,56,1780,327,727,.450,146,390,.374,181,337,.537,.550,187,219,.854,54,493,547,178,33,19,140,90,987,Kevin Love
2020-21,CLE,PF,25,25,622,103,252,.409,57,156,.365,46,96,.479,.522,42,51,.824,17,169,186,63,16,2,38,26,305,Kevin Love
2021-22,CLE,C,74,4,1665,327,761,.430,187,477,.392,140,284,.493,.553,166,198,.838,87,449,536,160,26,18,98,101,1007,Kevin Love
2022-23,2TM,PF,62,20,1240,165,424,.389,99,296,.334,66,128,.516,.506,80,91,.879,59,340,399,116,16,12,70,97,509,Kevin Love
2022-23,CLE,PF,41,3,821,111,285,.389,69,195,.354,42,90,.467,.511,56,63,.889,42,238,280,76,7,7,47,65,347,Kevin Love
2022-23,MIA,PF,21,17,419,54,139,.388,30,101,.297,24,38,.632,.496,24,28,.857,17,102,119,40,9,5,23,32,162,Kevin Love
2023-24,MIA,PF,55,5,924,158,359,.440,84,244,.344,74,115,.643,.557,85,108,.787,59,279,338,115,18,10,48,97,485,Kevin Love
2024-25,MIA,PF,15,4,169,31,84,.369,18,49,.367,13,35,.371,.476,10,15,.667,14,52,66,18,13,2,12,13,90,Kevin Love
2006-07,MEM,PG,10,0,175,14,38,.368,3,8,.375,11,30,.367,.408,25,28,.893,12,19,31,32,14,1,12,20,56,Kyle Lowry
2007-08,MEM,PG,82,9,2089,256,592,.432,36,140,.257,220,452,.487,.463,243,348,.698,41,209,250,296,92,22,127,185,791,Kyle Lowry
2008-09,2TM,PG,77,21,1679,189,434,.435,25,98,.255,164,336,.488,.464,181,226,.801,26,163,189,275,69,17,117,146,584,Kyle Lowry
2008-09,MEM,PG,49,21,1071,112,272,.412,17,69,.246,95,203,.468,.443,129,161,.801,13,98,111,178,48,8,79,89,370,Kyle Lowry
2008-09,HOU,PG,28,0,608,77,162,.475,8,29,.276,69,133,.519,.500,52,65,.800,13,65,78,97,21,9,38,57,214,Kyle Lowry
2009-10,HOU,PG,68,0,1651,184,464,.397,37,136,.272,147,328,.448,.436,215,260,.827,91,156,247,305,60,9,116,173,620,Kyle Lowry
2010-11,HOU,PG,75,71,2563,345,809,.426,129,343,.376,216,466,.464,.506,192,251,.765,89,220,309,500,102,23,158,207,1011,Kyle Lowry
2011-12,HOU,PG,47,38,1510,210,513,.409,79,211,.374,131,302,.434,.486,171,198,.864,37,176,213,310,73,14,130,133,670,Kyle Lowry
2012-13,TOR,PG,68,52,2020,250,623,.401,101,279,.362,149,344,.433,.482,190,239,.795,56,265,321,435,94,24,157,218,791,Kyle Lowry
2013-14,TOR,PG,79,79,2862,457,1080,.423,190,500,.380,267,580,.460,.511,313,385,.813,88,281,369,586,121,15,194,267,1417,Kyle Lowry
2014-15,TOR,PG,70,70,2414,430,1043,.412,132,391,.338,298,652,.457,.476,252,312,.808,54,274,328,473,109,13,173,212,1244,Kyle Lowry
2015-16,TOR,PG,77,77,2851,512,1198,.427,212,547,.388,300,651,.461,.516,398,491,.811,55,310,365,494,158,34,225,211,1634,Kyle Lowry
2016-17,TOR,PG,60,60,2244,426,918,.464,193,468,.412,233,450,.518,.569,299,365,.819,48,238,286,417,88,19,173,170,1344,Kyle Lowry
2017-18,TOR,PG,78,78,2510,403,944,.427,238,596,.399,165,348,.474,.553,223,261,.854,66,368,434,537,85,19,183,192,1267,Kyle Lowry
2018-19,TOR,PG,65,65,2213,304,739,.411,157,453,.347,147,286,.514,.518,161,194,.830,41,271,312,564,91,31,182,166,926,Kyle Lowry
2019-20,TOR,PG,58,58,2098,334,803,.416,164,466,.352,170,337,.504,.518,294,343,.857,32,260,292,433,82,26,178,190,1126,Kyle Lowry
2020-21,TOR,PG,46,46,1601,260,596,.436,131,331,.396,129,265,.487,.546,140,160,.875,35,212,247,338,45,14,126,143,791,Kyle Lowry
2021-22,MIA,PG,63,63,2133,276,627,.440,144,382,.377,132,245,.539,.555,148,174,.851,33,249,282,474,67,17,168,177,844,Kyle Lowry
2022-23,MIA,PG,55,44,1718,196,485,.404,107,310,.345,89,175,.509,.514,116,135,.859,43,182,225,281,57,21,103,143,615,Kyle Lowry
2023-24,2TM,PG,60,55,1690,163,377,.432,98,250,.392,65,127,.512,.562,63,75,.840,34,160,194,253,59,21,85,146,487,Kyle Lowry
2023-24,MIA,PG,37,35,1037,103,242,.426,62,161,.385,41,81,.506,.554,35,42,.833,25,104,129,147,39,15,53,94,303,Kyle Lowry
2023-24,PHI,PG,23,20,653,60,135,.444,36,89,.404,24,46,.522,.578,28,33,.848,9,56,65,106,20,6,32,52,184,Kyle Lowry
2024-25,PHI,PG,21,10,427,29,79,.367,21,59,.356,8,20,.400,.500,18,23,.783,7,33,40,58,19,7,14,42,97,Kyle Lowry
2023-24,ATL,SF,9,0,52,4,17,.235,3,13,.231,1,4,.250,.324,3,4,.750,1,6,7,0,0,0,1,6,14,Seth Lundy
2016-17,PHI,SF,69,19,1190,145,361,.402,50,161,.311,95,200,.475,.471,105,123,.854,25,124,149,75,32,10,73,154,445,Timothé Luwawu-Cabarrot
2017-18,PHI,SF,52,7,807,100,267,.375,53,158,.335,47,109,.431,.474,46,58,.793,14,58,72,54,12,5,38,97,299,Timothé Luwawu-Cabarrot
2018-19,2TM,SF,50,7,669,82,218,.376,36,116,.310,46,102,.451,.459,31,41,.756,11,86,97,26,19,8,21,73,231,Timothé Luwawu-Cabarrot
2018-19,OKC,SF,21,1,123,13,43,.302,5,22,.227,8,21,.381,.360,4,6,.667,4,14,18,4,4,1,5,14,35,Timothé Luwawu-Cabarrot
2018-19,CHI,SF,29,6,546,69,175,.394,31,94,.330,38,81,.469,.483,27,35,.771,7,72,79,22,15,7,16,59,196,Timothé Luwawu-Cabarrot
2019-20,BRK,SF,47,2,853,117,269,.435,62,160,.388,55,109,.505,.550,69,81,.852,29,98,127,29,18,7,37,106,365,Timothé Luwawu-Cabarrot
2020-21,BRK,SF,58,7,1050,130,356,.365,75,239,.314,55,117,.470,.471,35,43,.814,28,101,129,69,33,6,43,99,370,Timothé Luwawu-Cabarrot
2021-22,ATL,SF,52,18,685,74,186,.398,44,122,.361,30,64,.469,.516,35,41,.854,17,65,82,40,18,6,20,76,227,Timothé Luwawu-Cabarrot
2015-16,UTA,PF,80,33,1382,191,436,.438,49,128,.383,142,308,.461,.494,57,82,.695,59,240,299,59,26,18,65,114,488,Trey Lyles
2016-17,UTA,PF,71,4,1158,159,439,.362,65,204,.319,94,235,.400,.436,57,79,.722,48,187,235,69,26,20,64,97,440,Trey Lyles
2017-18,DEN,PF,73,2,1391,270,550,.491,83,218,.381,187,332,.563,.566,101,143,.706,55,292,347,91,30,34,61,111,724,Trey Lyles
2018-19,DEN,PF,64,2,1120,207,495,.418,51,200,.255,156,295,.529,.470,81,116,.698,44,202,246,87,30,23,68,93,546,Trey Lyles
2019-20,SAS,PF,63,53,1271,153,343,.446,65,168,.387,88,175,.503,.541,33,45,.733,71,290,361,69,28,28,39,98,404,Trey Lyles
2020-21,SAS,PF,23,9,358,43,90,.478,14,40,.350,29,50,.580,.556,15,23,.652,9,77,86,14,6,1,6,13,115,Trey Lyles
2021-22,2TM,PF,75,23,1537,262,562,.466,67,209,.321,195,353,.552,.526,195,243,.802,89,290,379,88,29,32,73,123,786,Trey Lyles
2021-22,DET,PF,51,3,990,175,384,.456,44,146,.301,131,238,.550,.513,138,176,.784,60,184,244,58,22,26,54,91,532,Trey Lyles
2021-22,SAC,PF,24,20,547,87,178,.489,23,63,.365,64,115,.557,.553,57,67,.851,29,106,135,30,7,6,19,32,254,Trey Lyles
2022-23,SAC,PF,74,0,1247,187,408,.458,87,240,.363,100,168,.595,.565,101,124,.815,68,232,300,66,27,31,64,97,562,Trey Lyles
2023-24,SAC,PF,58,0,1158,143,321,.445,84,219,.384,59,102,.578,.576,49,70,.700,61,196,257,72,17,19,38,86,419,Trey Lyles
2024-25,SAC,PF,21,2,415,42,110,.382,29,79,.367,13,31,.419,.514,16,22,.727,18,67,85,18,11,11,11,28,129,Trey Lyles
2020-21,OKC,PG,65,49,1778,226,614,.368,105,313,.335,121,301,.402,.454,101,135,.748,25,186,211,227,56,11,141,126,658,Théo Maledon
2021-22,OKC,PG,51,7,908,119,317,.375,44,150,.293,75,167,.449,.445,79,100,.790,20,111,131,111,31,11,65,67,361,Théo Maledon
2022-23,CHO,PG,44,7,854,102,254,.402,28,95,.295,74,159,.465,.457,63,74,.851,14,109,123,152,37,12,59,61,295,Théo Maledon
2023-24,2TM,PG,17,1,213,20,70,.286,5,30,.167,15,40,.375,.321,14,15,.933,4,20,24,28,7,0,18,21,59,Théo Maledon
2023-24,CHO,PG,13,1,200,19,66,.288,5,30,.167,14,36,.389,.326,11,12,.917,4,19,23,28,7,0,15,18,54,Théo Maledon
2023-24,PHO,PG,4,0,13,1,4,.250,0,0,,1,4,.250,.250,3,3,1.000,0,1,1,0,0,0,3,3,5,Théo Maledon
2021-22,MIL,PF,41,3,407,57,115,.496,22,52,.423,35,63,.556,.591,18,22,.818,35,47,82,22,9,9,15,28,154,Sandro Mamukelashvili
2022-23,2TM,C,43,7,660,97,230,.422,30,99,.303,67,131,.511,.487,39,57,.684,70,115,185,62,14,12,35,52,263,Sandro Mamukelashvili
2022-23,MIL,C,24,0,217,19,58,.328,7,32,.219,12,26,.462,.388,12,18,.667,18,38,56,16,4,5,9,19,57,Sandro Mamukelashvili
2022-23,SAS,C,19,7,443,78,172,.453,23,67,.343,55,105,.524,.520,27,39,.692,52,77,129,46,10,7,26,33,206,Sandro Mamukelashvili
2023-24,SAS,C,46,5,451,73,155,.471,19,64,.297,54,91,.593,.532,25,34,.735,45,102,147,49,7,12,19,35,190,Sandro Mamukelashvili
2024-25,SAS,PF,20,0,185,30,56,.536,17,39,.436,13,17,.765,.688,11,15,.733,12,43,55,7,3,5,9,12,88,Sandro Mamukelashvili
2020-21,ORL,PG,10,0,88,3,13,.231,1,2,.500,2,11,.182,.269,4,5,.800,1,13,14,4,0,2,3,10,11,Karim Mané
2019-20,LAC,SF,41,6,362,37,79,.468,7,20,.350,30,59,.508,.513,18,27,.667,10,45,55,53,11,5,18,46,99,Terance Mann
2020-21,LAC,SG,67,10,1263,178,350,.509,38,91,.418,140,259,.541,.563,78,94,.830,56,186,242,104,29,13,40,126,472,Terance Mann
2021-22,LAC,SF,81,33,2317,334,690,.484,76,208,.365,258,482,.535,.539,128,164,.780,104,321,425,209,55,21,84,178,872,Terance Mann
2022-23,LAC,SG,81,36,1872,272,524,.519,77,198,.389,195,326,.598,.593,92,118,.780,77,199,276,184,42,22,80,149,713,Terance Mann
2023-24,LAC,SG,75,71,1873,254,493,.515,71,204,.348,183,289,.633,.587,79,95,.832,87,167,254,119,43,15,48,145,658,Terance Mann
2024-25,LAC,SG,23,11,484,56,128,.438,16,47,.340,40,81,.494,.500,16,24,.667,24,47,71,40,22,5,13,47,144,Terance Mann
2021-22,OKC,PG,60,26,1367,231,588,.393,98,272,.360,133,316,.421,.476,65,82,.793,25,146,171,91,47,12,71,102,625,Tre Mann
2022-23,OKC,PG,67,5,1183,197,501,.393,81,257,.315,116,244,.475,.474,42,55,.764,27,128,155,120,40,11,62,99,517,Tre Mann
2023-24,2TM,PG,41,28,987,145,316,.459,47,126,.373,98,190,.516,.533,45,59,.763,20,129,149,165,51,3,65,48,382,Tre Mann
2023-24,OKC,PG,13,0,119,20,40,.500,8,19,.421,12,21,.571,.600,1,1,1.000,4,20,24,20,3,0,9,3,49,Tre Mann
2023-24,CHO,PG,28,28,868,125,276,.453,39,107,.364,86,169,.509,.524,44,58,.759,16,109,125,145,48,3,56,45,333,Tre Mann
2024-25,CHO,PG,13,0,319,70,161,.435,24,60,.400,46,101,.455,.509,19,21,.905,12,26,38,39,7,4,25,24,183,Tre Mann
2020-21,GSW,PG,30,1,364,39,114,.342,22,60,.367,17,54,.315,.439,23,28,.821,6,40,46,70,16,1,31,29,123,Nico Mannion
2015-16,SAS,C,54,4,508,105,174,.603,0,0,,105,174,.603,.603,87,114,.763,73,121,194,21,12,23,29,54,297,Boban Marjanović
2016-17,DET,C,35,0,293,72,132,.545,0,0,,72,132,.545,.545,47,58,.810,46,84,130,9,6,12,10,25,191,Boban Marjanović
2017-18,2TM,C,39,1,337,79,148,.534,0,0,,79,148,.534,.534,77,97,.794,48,96,144,22,10,11,36,51,235,Boban Marjanović
2017-18,DET,C,19,1,171,41,79,.519,0,0,,41,79,.519,.519,36,45,.800,15,42,57,14,4,6,22,28,118,Boban Marjanović
2017-18,LAC,C,20,0,166,38,69,.551,0,0,,38,69,.551,.551,41,52,.788,33,54,87,8,6,5,14,23,117,Boban Marjanović
2018-19,2TM,C,58,12,681,160,260,.615,4,10,.400,156,250,.624,.623,98,131,.748,87,178,265,54,16,27,59,90,422,Boban Marjanović
2018-19,LAC,C,36,9,376,85,140,.607,0,2,.000,85,138,.616,.607,72,95,.758,55,97,152,22,11,17,37,57,242,Boban Marjanović
2018-19,PHI,C,22,3,305,75,120,.625,4,8,.500,71,112,.634,.642,26,36,.722,32,81,113,32,5,10,22,33,180,Boban Marjanović
2019-20,DAL,C,44,5,422,121,211,.573,4,17,.235,117,194,.603,.583,43,57,.754,66,131,197,20,8,10,30,56,289,Boban Marjanović
2020-21,DAL,C,33,3,271,62,122,.508,1,8,.125,61,114,.535,.512,31,38,.816,47,81,128,10,2,6,12,29,156,Boban Marjanović
2021-22,DAL,C,23,0,128,42,70,.600,1,4,.250,41,66,.621,.607,13,22,.591,8,31,39,3,0,3,15,24,98,Boban Marjanović
2022-23,HOU,C,31,0,171,41,60,.683,0,1,.000,41,59,.695,.683,20,27,.741,20,40,60,9,5,2,14,10,102,Boban Marjanović
2023-24,HOU,C,14,0,71,18,34,.529,0,2,.000,18,32,.563,.529,9,14,.643,7,25,32,6,1,2,5,5,45,Boban Marjanović
2017-18,CHI,PF,68,68,2020,374,862,.434,145,401,.362,229,461,.497,.518,140,166,.843,79,429,508,79,39,40,83,103,1033,Lauri Markkanen
2018-19,CHI,PF,52,51,1682,342,795,.430,120,332,.361,222,463,.479,.506,170,195,.872,74,396,470,75,37,33,85,122,974,Lauri Markkanen
2019-20,CHI,PF,50,50,1492,251,591,.425,109,317,.344,142,274,.518,.517,126,153,.824,60,253,313,74,42,23,81,96,737,Lauri Markkanen
2020-21,CHI,PF,51,26,1317,250,521,.480,119,296,.402,131,225,.582,.594,76,92,.826,35,233,268,45,26,15,52,75,695,Lauri Markkanen
2021-22,CLE,SF,61,61,1878,313,703,.445,136,380,.358,177,323,.548,.542,138,159,.868,59,286,345,81,45,30,54,130,900,Lauri Markkanen
2022-23,UTA,PF,66,66,2273,571,1145,.499,200,511,.391,371,634,.585,.586,349,399,.875,130,440,570,123,42,38,127,137,1691,Lauri Markkanen
2023-24,UTA,PF,55,55,1820,427,890,.480,175,439,.399,252,451,.559,.578,249,277,.899,122,327,449,110,50,26,77,100,1278,Lauri Markkanen
2024-25,UTA,PF,24,24,765,145,326,.445,68,178,.382,77,148,.520,.549,112,127,.882,44,114,158,48,18,5,34,40,470,Lauri Markkanen
2020-21,NOP,SF,32,10,700,82,209,.392,29,83,.349,53,126,.421,.462,53,75,.707,15,133,148,88,26,10,38,58,246,Naji Marshall
2021-22,NOP,SF,55,4,735,109,269,.405,21,105,.200,88,164,.537,.444,74,93,.796,38,104,142,62,33,8,46,69,313,Naji Marshall
2022-23,NOP,SF,77,21,1792,247,571,.433,66,218,.303,181,353,.513,.490,138,175,.789,48,231,279,189,54,14,97,113,698,Naji Marshall
2023-24,NOP,SF,66,1,1257,170,367,.463,58,150,.387,112,217,.516,.542,68,86,.791,53,187,240,128,49,12,65,91,466,Naji Marshall
2024-25,DAL,SF,26,8,604,113,214,.528,20,63,.317,93,151,.616,.575,37,42,.881,24,61,85,57,22,2,35,36,283,Naji Marshall
2019-20,CHO,SF,18,1,317,37,84,.440,20,37,.541,17,47,.362,.560,17,21,.810,10,28,38,23,12,7,15,32,111,Caleb Martin
2020-21,CHO,SF,53,3,818,96,256,.375,31,125,.248,65,131,.496,.436,41,64,.641,31,110,141,67,37,12,33,62,264,Caleb Martin
2021-22,MIA,SF,60,12,1372,208,410,.507,64,155,.413,144,255,.565,.585,71,93,.763,70,160,230,64,58,30,52,104,551,Caleb Martin
2022-23,MIA,SF,71,49,2077,254,548,.464,84,236,.356,170,312,.545,.540,91,113,.805,88,256,344,117,71,31,78,145,683,Caleb Martin
2023-24,MIA,SF,64,23,1756,241,559,.431,81,232,.349,160,327,.489,.504,77,99,.778,74,207,281,143,47,29,77,126,640,Caleb Martin
2024-25,PHI,SF,23,16,676,75,177,.424,25,68,.368,50,109,.459,.494,42,64,.656,34,69,103,50,22,10,38,43,217,Caleb Martin
2019-20,CHO,SF,48,3,903,89,207,.430,18,77,.234,71,130,.546,.473,42,65,.646,38,120,158,95,39,9,44,78,238,Cody Martin
2020-21,CHO,SF,52,10,849,83,188,.441,16,58,.276,67,130,.515,.484,25,43,.581,52,109,161,86,37,12,40,52,207,Cody Martin
2021-22,CHO,SF,71,11,1866,204,423,.482,61,159,.384,143,264,.542,.554,75,107,.701,82,203,285,179,88,32,61,116,544,Cody Martin
2022-23,CHO,SF,7,0,134,14,36,.389,3,14,.214,11,22,.500,.431,4,7,.571,8,16,24,11,4,1,2,13,35,Cody Martin
2023-24,CHO,SF,28,22,753,82,215,.381,27,86,.314,55,129,.426,.444,20,33,.606,19,90,109,104,32,18,44,48,211,Cody Martin
2024-25,CHO,SF,30,7,779,97,221,.439,34,109,.312,63,112,.563,.516,26,37,.703,33,107,140,68,35,21,34,60,254,Cody Martin
2024-25,BRK,SF,3,0,5,1,2,.500,1,1,1.000,0,1,.000,.750,0,0,0,0,0,0,0,0,0,1,3,0,Jaylen Martin
2019-20,MIN,SF,31,4,495,71,181,.392,25,96,.260,46,85,.541,.461,30,31,.968,12,84,96,23,7,9,20,51,197,Kelan Martin
2020-21,IND,SF,35,0,322,62,138,.449,24,60,.400,38,78,.487,.536,9,10,.900,18,60,78,17,10,10,16,35,157,Kelan Martin
2021-22,2TM,SF,30,1,450,70,171,.409,22,75,.293,48,96,.500,.474,9,13,.692,17,38,55,21,13,9,14,36,171,Kelan Martin
2021-22,IND,SF,27,1,444,70,168,.417,22,74,.297,48,94,.511,.482,9,13,.692,16,37,53,21,13,9,14,36,171,Kelan Martin
2021-22,BOS,SF,3,0,6,0,3,.000,0,1,.000,0,2,.000,.000,0,0,,1,1,2,0,0,0,0,0,0,Kelan Martin
2020-21,HOU,SF,45,8,1068,162,318,.509,35,96,.365,127,222,.572,.564,60,84,.714,73,169,242,48,30,41,38,89,419,KJ Martin
2021-22,HOU,SF,79,2,1656,279,523,.533,60,168,.357,219,355,.617,.591,78,123,.634,80,217,297,101,34,40,60,113,696,KJ Martin
2022-23,HOU,SF,82,49,2292,410,720,.569,68,216,.315,342,504,.679,.617,151,222,.680,126,326,452,123,41,30,91,147,1039,KJ Martin
2023-24,2TM,SF,60,2,746,97,181,.536,8,28,.286,89,153,.582,.558,22,41,.537,41,90,131,51,22,12,32,100,224,KJ Martin
2023-24,LAC,SF,2,0,31,4,10,.400,1,5,.200,3,5,.600,.450,1,2,.500,1,2,3,1,2,1,2,3,10,KJ Martin
2023-24,PHI,SF,58,2,715,93,171,.544,7,23,.304,86,148,.581,.564,21,39,.538,40,88,128,50,20,11,30,97,214,KJ Martin
2024-25,PHI,PF,24,7,480,61,99,.616,8,21,.381,53,78,.679,.657,24,29,.828,21,51,72,19,11,16,12,62,154,KJ Martin
2022-23,ATL,SG,16,0,66,9,23,.391,1,7,.143,8,16,.500,.413,2,2,1.000,5,7,12,2,1,0,2,2,21,Tyrese Martin
2024-25,BRK,SG,15,2,246,41,89,.461,25,62,.403,16,27,.593,.601,7,9,.778,13,34,47,19,7,2,12,17,114,Tyrese Martin
2019-20,WAS,SG,18,0,227,24,56,.429,19,46,.413,5,10,.500,.598,31,34,.912,6,18,24,10,8,1,8,32,98,Garrison Mathews
2020-21,WAS,SG,64,24,1038,97,237,.409,76,198,.384,21,39,.538,.570,84,95,.884,16,71,87,26,29,7,10,106,354,Garrison Mathews
2021-22,HOU,SG,65,33,1712,184,461,.399,139,386,.360,45,75,.600,.550,143,180,.794,32,158,190,64,57,24,41,168,650,Garrison Mathews
2022-23,2TM,SG,54,0,686,73,201,.363,63,180,.350,10,21,.476,.520,48,53,.906,11,62,73,26,24,5,19,62,257,Garrison Mathews
2022-23,HOU,SG,45,0,602,60,170,.353,53,155,.342,7,15,.467,.509,41,45,.911,10,52,62,23,23,4,18,56,214,Garrison Mathews
2022-23,ATL,SG,9,0,84,13,31,.419,10,25,.400,3,6,.500,.581,7,8,.875,1,10,11,3,1,1,1,6,43,Garrison Mathews
2023-24,ATL,SG,66,5,992,103,226,.456,85,193,.440,18,33,.545,.644,34,42,.810,17,75,92,37,20,8,19,115,325,Garrison Mathews
2024-25,ATL,SG,22,1,394,53,117,.453,47,101,.465,6,16,.375,.654,32,38,.842,5,22,27,28,16,5,13,37,185,Garrison Mathews
2020-21,PHI,SG,8,2,123,19,48,.396,8,26,.308,11,22,.500,.479,2,6,.333,1,6,7,13,1,3,1,7,48,Dakota Mathias
2021-22,MEM,SG,6,0,16,2,6,.333,2,6,.333,0,0,,.500,0,0,,0,2,2,1,1,0,0,1,6,Dakota Mathias
2022-23,IND,SG,78,17,2222,413,951,.434,100,310,.323,313,641,.488,.487,376,454,.828,87,231,318,116,48,13,152,162,1302,Bennedict Mathurin
2023-24,IND,SF,59,19,1538,296,663,.446,80,214,.374,216,449,.481,.507,184,224,.821,60,174,234,119,35,14,97,117,856,Bennedict Mathurin
2024-25,IND,SG,32,27,1057,179,395,.453,46,128,.359,133,267,.498,.511,129,153,.843,41,157,198,60,22,12,64,86,533,Bennedict Mathurin
2024-25,NOP,PF,5,0,39,2,5,.400,0,0,2,5,.400,.400,0,0,6,4,10,0,3,3,4,4,4,0,,Karlo Matković
2009-10,UTA,SG,82,48,2025,273,565,.483,63,165,.382,210,400,.525,.539,160,193,.829,50,141,191,124,64,15,93,152,769,Wesley Matthews
2010-11,POR,SG,82,69,2758,440,979,.449,154,378,.407,286,601,.476,.528,266,315,.844,48,210,258,164,102,9,138,195,1300,Wesley Matthews
2011-12,POR,SG,66,53,2228,314,763,.412,129,337,.383,185,426,.434,.496,147,171,.860,56,168,224,113,96,15,73,148,904,Wesley Matthews
2012-13,POR,SG,69,69,2403,352,808,.436,169,425,.398,183,383,.478,.540,149,187,.797,35,156,191,174,90,18,109,172,1022,Wesley Matthews
2013-14,POR,SG,82,82,2780,445,1009,.441,201,511,.393,244,498,.490,.541,252,301,.837,51,238,289,197,76,14,110,176,1343,Wesley Matthews
2014-15,POR,SG,60,60,2024,337,752,.448,173,445,.389,164,307,.534,.563,109,145,.752,38,184,222,139,77,10,81,132,956,Wesley Matthews
2015-16,DAL,SF,78,78,2644,331,854,.388,189,525,.360,142,329,.432,.498,126,146,.863,27,211,238,151,78,17,78,179,977,Wesley Matthews
2016-17,DAL,SG,73,73,2495,333,847,.393,174,479,.363,159,368,.432,.496,146,179,.816,18,241,259,210,77,15,102,161,986,Wesley Matthews
2017-18,DAL,SF,63,63,2131,283,697,.406,153,402,.381,130,295,.441,.516,83,101,.822,28,170,198,172,76,16,83,140,802,Wesley Matthews
2018-19,3TM,SF,69,68,2091,279,698,.400,150,403,.372,129,295,.437,.507,132,163,.810,32,138,170,160,54,17,91,160,840,Wesley Matthews
2018-19,DAL,SF,44,44,1312,194,469,.414,100,263,.380,94,206,.456,.520,87,110,.791,20,82,102,100,33,12,58,102,575,Wesley Matthews
2018-19,NYK,SG,2,1,54,4,19,.211,2,10,.200,2,9,.222,.263,4,5,.800,1,2,3,5,1,1,2,2,14,Wesley Matthews
2018-19,IND,SG,23,23,725,81,210,.386,48,130,.369,33,80,.413,.500,41,48,.854,11,54,65,55,20,4,31,56,251,Wesley Matthews
2019-20,MIL,SG,67,67,1635,167,422,.396,108,297,.364,59,125,.472,.524,52,68,.765,22,144,166,92,38,9,43,103,494,Wesley Matthews
2020-21,LAL,SG,58,10,1130,89,252,.353,66,197,.335,23,55,.418,.484,35,41,.854,20,73,93,54,38,17,26,80,279,Wesley Matthews
2021-22,MIL,SG,49,14,1002,87,220,.395,53,157,.338,34,63,.540,.516,22,28,.786,30,62,92,36,23,8,18,87,249,Wesley Matthews
2022-23,MIL,SF,52,0,820,58,160,.363,39,124,.315,19,36,.528,.484,24,28,.857,34,79,113,34,20,13,18,71,179,Wesley Matthews
2023-24,ATL,SG,36,3,413,34,97,.351,24,69,.348,10,28,.357,.474,18,24,.750,9,44,53,23,16,11,8,43,110,Wesley Matthews
2020-21,PHI,SG,61,8,935,198,429,.462,31,103,.301,167,326,.512,.498,61,70,.871,11,93,104,120,26,13,41,79,488,Tyrese Maxey
2021-22,PHI,PG,75,74,2650,483,995,.485,132,309,.427,351,686,.512,.552,213,246,.866,26,214,240,321,55,32,88,156,1311,Tyrese Maxey
2022-23,PHI,SG,60,41,2016,439,913,.481,160,369,.434,279,544,.513,.568,180,213,.845,23,153,176,212,49,8,80,132,1218,Tyrese Maxey
2023-24,PHI,PG,70,70,2626,638,1419,.450,212,569,.373,426,850,.501,.524,328,378,.868,36,222,258,433,69,33,116,151,1816,Tyrese Maxey
2024-25,PHI,PG,22,22,816,198,470,.421,70,208,.337,128,262,.489,.496,100,122,.820,5,80,85,119,45,8,48,51,566,Tyrese Maxey
2020-21,ATL,SG,33,0,269,44,98,.449,14,40,.350,30,58,.517,.520,22,25,.880,10,25,35,30,14,2,9,15,124,Skylar Mays
2021-22,ATL,SG,28,5,220,32,64,.500,8,25,.320,24,39,.615,.563,8,9,.889,5,20,25,17,7,0,10,9,80,Skylar Mays
2022-23,POR,PG,6,6,189,34,68,.500,12,26,.462,22,42,.524,.588,12,13,.923,2,17,19,50,6,1,10,11,92,Skylar Mays
2023-24,2TM,SG,38,5,433,63,159,.396,16,54,.296,47,105,.448,.447,13,17,.765,10,33,43,85,21,4,20,26,155,Skylar Mays
2023-24,POR,PG,21,5,356,53,138,.384,14,49,.286,39,89,.438,.435,13,17,.765,9,28,37,75,14,3,18,20,133,Skylar Mays
2023-24,LAL,SG,17,0,77,10,21,.476,2,5,.400,8,16,.500,.524,0,0,,1,5,6,10,7,1,2,6,22,Skylar Mays
2021-22,NYK,PG,40,2,372,32,108,.296,17,68,.250,15,40,.375,.375,8,12,.667,4,38,42,41,14,1,5,45,89,Miles McBride
2022-23,NYK,PG,64,2,760,77,215,.358,40,134,.299,37,81,.457,.451,28,42,.667,13,37,50,72,37,8,25,60,222,Miles McBride
2023-24,NYK,PG,68,14,1328,205,454,.452,109,266,.410,96,188,.511,.572,43,50,.860,31,69,100,114,50,7,30,108,562,Miles McBride
2024-25,NYK,PG,26,0,650,92,213,.432,51,125,.408,41,88,.466,.552,27,33,.818,19,53,72,77,22,5,25,41,262,Miles McBride
2024-25,PHI,SG,23,8,592,126,274,.460,51,133,.383,75,141,.532,.553,49,56,.875,13,43,56,60,15,0,37,37,352,Jared McCain
2016-17,GSW,SG,71,20,1074,106,245,.433,41,123,.333,65,122,.533,.516,29,37,.784,21,79,100,77,32,15,36,62,282,Patrick McCaw
2017-18,GSW,SG,57,10,961,92,225,.409,19,80,.238,73,145,.503,.451,26,34,.765,16,66,82,81,43,10,41,67,229,Patrick McCaw
2018-19,2TM,SG,29,1,397,26,63,.413,9,28,.321,17,35,.486,.484,13,15,.867,7,41,48,29,23,2,17,38,74,Patrick McCaw
2018-19,CLE,SG,3,0,53,2,9,.222,1,4,.250,1,5,.200,.278,0,0,,0,3,3,2,2,0,3,1,5,Patrick McCaw
2018-19,TOR,SG,26,1,344,24,54,.444,8,24,.333,16,30,.533,.519,13,15,.867,7,38,45,27,21,2,14,37,69,Patrick McCaw
2019-20,TOR,SF,37,12,908,67,162,.414,23,71,.324,44,91,.484,.485,13,18,.722,19,67,86,79,39,4,29,60,170,Patrick McCaw
2020-21,TOR,SF,5,0,33,1,1,1.000,0,0,,1,1,1.000,1.000,3,3,1.000,1,2,3,4,2,0,0,6,5,Patrick McCaw
2021-22,2TM,PG,2,0,25,3,6,.500,1,3,.333,2,3,.667,.583,1,1,1.000,0,3,3,1,1,1,3,5,8,Mac McClung
2021-22,CHI,PG,1,0,3,1,1,1.000,0,0,,1,1,1.000,1.000,0,0,,0,0,0,0,0,0,1,0,2,Mac McClung
2021-22,LAL,SG,1,0,22,2,5,.400,1,3,.333,1,2,.500,.500,1,1,1.000,0,3,3,1,1,1,2,5,6,Mac McClung
2022-23,PHI,SG,2,0,41,9,20,.450,4,11,.364,5,9,.556,.550,3,5,.600,3,7,10,9,0,0,3,3,25,Mac McClung
2024-25,ORL,SG,1,0,5,0,0,,0,0,,0,0,,,0,0,,0,1,1,2,0,0,0,0,0,Mac McClung
2013-14,POR,SG,38,0,476,74,178,.416,30,80,.375,44,98,.449,.500,23,34,.676,7,41,48,27,14,2,35,53,201,CJ McCollum
2014-15,POR,SG,62,3,973,159,365,.436,55,139,.396,104,226,.460,.511,51,73,.699,14,77,91,64,43,8,48,81,424,CJ McCollum
2015-16,POR,SG,80,80,2780,641,1431,.448,197,472,.417,444,959,.463,.517,187,226,.827,47,212,259,341,97,23,196,187,1666,CJ McCollum
2016-17,POR,SG,80,80,2796,692,1441,.480,185,439,.421,507,1002,.506,.544,268,294,.912,60,229,289,285,72,42,172,202,1837,CJ McCollum
2017-18,POR,SG,81,81,2923,667,1505,.443,189,476,.397,478,1029,.465,.506,209,250,.836,53,268,321,272,77,35,151,168,1732,CJ McCollum
2018-19,POR,SG,70,70,2375,571,1243,.459,167,445,.375,404,798,.506,.527,159,192,.828,62,220,282,207,55,28,106,172,1468,CJ McCollum
2019-20,POR,SG,70,70,2556,611,1356,.451,194,512,.379,417,844,.494,.522,140,185,.757,46,251,297,310,54,42,127,183,1556,CJ McCollum
2020-21,POR,SG,47,47,1600,405,884,.458,169,420,.402,236,464,.509,.554,108,133,.812,30,155,185,223,44,21,65,87,1087,CJ McCollum
2021-22,2TM,SG,62,62,2145,536,1164,.460,182,469,.388,354,695,.509,.539,116,170,.682,53,216,269,315,70,22,127,121,1370,CJ McCollum
2021-22,POR,SG,36,36,1267,290,665,.436,111,289,.384,179,376,.476,.520,48,68,.706,34,119,153,163,36,21,70,77,739,CJ McCollum
2021-22,NOP,PG,26,26,878,246,499,.493,71,180,.394,175,319,.549,.564,68,102,.667,19,97,116,152,34,1,57,44,631,CJ McCollum
2022-23,NOP,PG,75,75,2649,587,1344,.437,211,543,.389,376,801,.469,.515,183,238,.769,55,273,328,429,70,38,183,153,1568,CJ McCollum
2023-24,NOP,PG,66,66,2159,484,1055,.459,239,557,.429,245,498,.492,.572,115,139,.827,39,247,286,305,62,41,110,126,1322,CJ McCollum
2024-25,NOP,PG,19,19,636,152,348,.437,49,150,.327,103,198,.520,.507,42,59,.712,15,60,75,78,21,9,32,48,395,CJ McCollum
2015-16,PHI,PG,81,17,1606,218,464,.470,31,89,.348,187,375,.499,.503,26,41,.634,43,207,250,367,95,10,140,114,493,T.J. McConnell
2016-17,PHI,PG,81,51,2133,236,512,.461,11,55,.200,225,457,.492,.472,73,90,.811,39,212,251,534,134,10,159,139,556,T.J. McConnell
2017-18,PHI,PG,76,1,1706,210,421,.499,27,62,.435,183,359,.510,.531,31,39,.795,37,189,226,303,92,13,112,122,478,T.J. McConnell
2018-19,PHI,PG,76,3,1470,220,419,.525,14,42,.333,206,377,.546,.542,29,37,.784,28,146,174,258,79,17,91,105,483,T.J. McConnell
2019-20,IND,PG,71,3,1326,212,411,.516,5,17,.294,207,394,.525,.522,35,42,.833,38,151,189,355,56,11,100,73,464,T.J. McConnell
2020-21,IND,PG,69,3,1796,274,490,.559,15,48,.313,259,442,.586,.574,33,48,.688,55,201,256,456,128,23,135,113,596,T.J. McConnell
2021-22,IND,PG,27,8,652,100,208,.481,10,33,.303,90,175,.514,.505,19,23,.826,20,70,90,131,29,10,29,53,229,T.J. McConnell
2022-23,IND,PG,75,6,1526,283,521,.543,26,59,.441,257,462,.556,.568,58,68,.853,45,189,234,397,81,10,143,105,650,T.J. McConnell
2023-24,IND,PG,71,4,1291,330,593,.556,18,44,.409,312,549,.568,.572,49,62,.790,36,155,191,390,72,8,108,79,727,T.J. McConnell
2024-25,IND,PG,31,0,616,159,285,.558,7,22,.318,152,263,.578,.570,25,33,.758,18,60,78,136,36,9,49,31,350,T.J. McConnell
2020-21,MIN,PF,63,27,1511,164,367,.447,72,198,.364,92,169,.544,.545,27,45,.600,52,180,232,71,35,60,47,172,427,Jaden McDaniels
2021-22,MIN,PF,70,31,1803,255,554,.460,80,252,.317,175,302,.579,.532,57,71,.803,76,217,293,79,52,54,75,224,647,Jaden McDaniels
2022-23,MIN,SF,79,79,2416,370,716,.517,107,269,.398,263,447,.588,.591,106,144,.736,92,215,307,148,74,76,112,272,953,Jaden McDaniels
2023-24,MIN,SF,72,71,2105,307,628,.489,86,255,.337,221,373,.592,.557,57,79,.722,56,168,224,101,63,42,87,219,757,Jaden McDaniels
2024-25,MIN,PF,30,30,889,115,267,.431,35,110,.318,80,157,.510,.496,23,33,.697,42,89,131,51,42,23,30,90,288,Jaden McDaniels
2019-20,CHO,SF,16,0,293,33,70,.471,9,24,.375,24,46,.522,.536,14,17,.824,15,50,65,13,8,3,11,36,89,Jalen McDaniels
2020-21,CHO,SF,47,18,904,133,284,.468,35,105,.333,98,179,.547,.530,45,64,.703,45,124,169,53,28,19,45,95,346,Jalen McDaniels
2021-22,CHO,SF,55,2,895,123,254,.484,41,108,.380,82,146,.562,.565,53,72,.736,37,133,170,58,26,22,36,93,340,Jalen McDaniels
2022-23,2TM,SF,80,24,1913,281,617,.455,77,232,.332,204,385,.530,.518,116,138,.841,63,283,346,130,83,34,93,209,755,Jalen McDaniels
2022-23,CHO,SF,56,21,1494,221,494,.447,65,202,.322,156,292,.534,.513,88,104,.846,44,226,270,111,66,29,80,158,595,Jalen McDaniels
2022-23,PHI,SF,24,3,419,60,123,.488,12,30,.400,48,93,.516,.537,28,34,.824,19,57,76,19,17,5,13,51,160,Jalen McDaniels
2023-24,TOR,SF,50,1,538,65,189,.344,12,71,.169,53,118,.449,.376,27,37,.730,18,61,79,37,19,6,30,52,169,Jalen McDaniels
2014-15,CHI,SF,36,0,321,43,107,.402,13,41,.317,30,66,.455,.463,10,15,.667,6,37,43,6,4,1,17,29,109,Doug McDermott
2015-16,CHI,SF,81,4,1861,291,644,.452,110,259,.425,181,385,.470,.537,72,84,.857,37,158,195,59,14,6,53,127,764,Doug McDermott
2016-17,2TM,SF,66,5,1508,222,497,.447,77,208,.370,145,289,.502,.524,71,84,.845,20,159,179,58,13,5,38,79,592,Doug McDermott
2016-17,CHI,SF,44,4,1078,166,373,.445,56,150,.373,110,223,.493,.520,59,67,.881,14,116,130,45,11,4,32,57,447,Doug McDermott
2016-17,OKC,SF,22,1,430,56,124,.452,21,58,.362,35,66,.530,.536,12,17,.706,6,43,49,13,2,1,6,22,145,Doug McDermott
2017-18,2TM,SF,81,4,1768,237,508,.467,92,216,.426,145,292,.497,.557,64,81,.790,40,160,200,79,19,16,56,122,630,Doug McDermott
2017-18,NYK,SF,55,1,1172,151,328,.460,53,137,.387,98,191,.513,.541,40,53,.755,33,101,134,50,10,12,34,73,395,Doug McDermott
2017-18,DAL,SF,26,3,596,86,180,.478,39,79,.494,47,101,.465,.586,24,28,.857,7,59,66,29,9,4,22,49,235,Doug McDermott
2018-19,IND,SF,77,1,1340,207,422,.491,84,206,.408,123,216,.569,.590,66,79,.835,17,92,109,67,18,8,42,104,564,Doug McDermott
2019-20,IND,PF,69,0,1372,267,547,.488,128,294,.435,139,253,.549,.605,48,58,.828,26,148,174,78,12,5,42,117,710,Doug McDermott
2020-21,IND,PF,66,29,1619,354,665,.532,111,286,.388,243,379,.641,.616,80,98,.816,60,161,221,85,20,6,53,117,899,Doug McDermott
2021-22,SAS,PF,51,51,1223,215,465,.462,108,256,.422,107,209,.512,.578,40,51,.784,18,97,115,64,13,6,43,79,578,Doug McDermott
2022-23,SAS,SF,64,0,1314,239,523,.457,123,298,.413,116,225,.516,.575,53,70,.757,23,116,139,91,13,6,58,118,654,Doug McDermott
2023-24,2TM,SF,64,0,904,123,284,.433,94,229,.410,29,55,.527,.599,11,19,.579,10,49,59,70,16,2,28,64,351,Doug McDermott
2023-24,SAS,SF,46,0,700,95,215,.442,76,173,.439,19,42,.452,.619,10,17,.588,8,40,48,57,11,2,24,48,276,Doug McDermott
2023-24,IND,SF,18,0,204,28,69,.406,18,56,.321,10,13,.769,.536,1,2,.500,2,9,11,13,5,0,4,16,75,Doug McDermott
2024-25,SAC,SF,22,3,200,29,69,.420,24,59,.407,5,10,.500,.594,3,5,.600,2,14,16,3,3,1,2,20,85,Doug McDermott
2020-21,MEM,SF,18,0,158,13,33,.394,5,22,.227,8,11,.727,.470,8,8,1.000,6,13,19,4,2,3,4,8,39,Sean McDermott
2008-09,WAS,C,75,14,1143,191,387,.494,0,0,,191,387,.494,.494,107,162,.660,120,174,294,23,33,75,61,155,489,JaVale McGee
2009-10,WAS,C,60,19,968,156,307,.508,0,1,.000,156,306,.510,.508,74,116,.638,88,155,243,14,16,101,51,122,386,JaVale McGee
2010-11,WAS,C,79,75,2193,332,604,.550,0,3,.000,332,601,.552,.550,134,230,.583,223,411,634,38,41,193,102,232,798,JaVale McGee
2011-12,2TM,C,61,45,1535,307,552,.556,0,0,,307,552,.556,.556,77,167,.461,163,314,477,31,35,132,87,166,691,JaVale McGee
2011-12,WAS,C,41,40,1124,214,400,.535,0,0,,214,400,.535,.535,58,116,.500,127,235,362,25,25,101,68,118,486,JaVale McGee
2011-12,DEN,C,20,5,411,93,152,.612,0,0,,93,152,.612,.612,19,51,.373,36,79,115,6,10,31,19,48,205,JaVale McGee
2012-13,DEN,C,79,0,1433,303,527,.575,1,1,1.000,302,526,.574,.576,110,186,.591,158,223,381,24,30,157,90,184,717,JaVale McGee
2013-14,DEN,C,5,5,79,17,38,.447,0,0,,17,38,.447,.447,1,1,1.000,10,7,17,2,1,7,8,16,35,JaVale McGee
2014-15,2TM,C,23,0,256,42,79,.532,0,0,,42,79,.532,.532,22,33,.667,18,43,61,3,2,20,18,30,106,JaVale McGee
2014-15,DEN,C,17,0,195,34,61,.557,0,0,,34,61,.557,.557,20,29,.690,14,34,48,1,2,19,13,28,88,JaVale McGee
2014-15,PHI,C,6,0,61,8,18,.444,0,0,,8,18,.444,.444,2,4,.500,4,9,13,2,0,1,5,2,18,JaVale McGee
2015-16,DAL,C,34,2,370,77,134,.575,0,1,.000,77,133,.579,.575,18,36,.500,53,80,133,3,5,26,21,49,172,JaVale McGee
2016-17,GSW,C,77,10,739,208,319,.652,0,3,.000,208,316,.658,.652,56,111,.505,100,144,244,17,19,67,40,109,472,JaVale McGee
2017-18,GSW,C,65,17,615,136,219,.621,0,6,.000,136,213,.638,.621,38,52,.731,59,110,169,33,21,57,27,91,310,JaVale McGee
2018-19,LAL,C,75,62,1671,400,641,.624,1,12,.083,399,629,.634,.625,96,152,.632,195,371,566,52,47,148,108,208,897,JaVale McGee
2019-20,LAL,C,68,68,1130,195,306,.637,3,6,.500,192,300,.640,.642,53,82,.646,125,265,390,37,36,94,55,159,446,JaVale McGee
2020-21,2TM,C,46,2,678,144,282,.511,5,24,.208,139,258,.539,.520,44,67,.657,77,162,239,39,19,54,60,121,337,JaVale McGee
2020-21,CLE,C,33,1,503,112,215,.521,5,20,.250,107,195,.549,.533,36,55,.655,54,116,170,33,16,40,45,80,265,JaVale McGee
2020-21,DEN,C,13,1,175,32,67,.478,0,4,.000,32,63,.508,.478,8,12,.667,23,46,69,6,3,14,15,41,72,JaVale McGee
2021-22,PHO,C,74,17,1172,288,458,.629,2,9,.222,286,449,.637,.631,102,146,.699,163,333,496,42,22,81,98,181,680,JaVale McGee
2022-23,DAL,C,42,7,355,80,125,.640,2,5,.400,78,120,.650,.648,24,41,.585,30,77,107,11,4,26,36,54,186,JaVale McGee
2023-24,SAC,C,46,0,339,79,132,.598,1,7,.143,78,125,.624,.602,26,45,.578,42,84,126,17,14,20,34,46,185,JaVale McGee
2022-23,CHO,SG,46,7,787,80,202,.396,26,80,.325,54,122,.443,.460,60,80,.750,20,73,93,54,15,6,43,48,246,Bryce McGowens
2023-24,CHO,SG,59,14,882,101,230,.439,34,102,.333,67,128,.523,.513,66,85,.776,17,85,102,51,21,10,30,74,302,Bryce McGowens
2024-25,POR,SG,1,0,3,1,2,.500,0,1,.000,1,1,1.000,.500,0,0,,0,0,0,1,0,0,0,0,2,Bryce McGowens
2016-17,MIA,SG,78,65,1966,190,460,.413,73,220,.332,117,240,.488,.492,44,71,.620,94,162,256,124,46,18,56,140,497,Rodney McGruder
2017-18,MIA,SG,18,2,299,36,73,.493,15,35,.429,21,38,.553,.596,4,8,.500,11,22,33,17,8,3,4,21,91,Rodney McGruder
2018-19,MIA,SG,66,45,1550,186,461,.403,79,225,.351,107,236,.453,.489,52,72,.722,60,178,238,112,36,12,64,115,503,Rodney McGruder
2019-20,LAC,SG,56,4,871,72,181,.398,24,89,.270,48,92,.522,.464,19,34,.559,29,122,151,36,26,8,24,74,187,Rodney McGruder
2020-21,DET,SG,16,2,194,37,70,.529,11,24,.458,26,46,.565,.607,6,8,.750,8,14,22,16,8,1,7,12,91,Rodney McGruder
2021-22,DET,SG,51,2,754,98,225,.436,58,146,.397,40,79,.506,.564,19,26,.731,31,80,111,48,21,7,24,58,273,Rodney McGruder
2022-23,DET,SG,32,12,524,62,152,.408,41,97,.423,21,55,.382,.543,18,22,.818,20,54,74,28,16,1,11,39,183,Rodney McGruder
2017-18,TOR,SF,14,0,53,8,15,.533,3,9,.333,5,6,.833,.633,2,3,.667,1,6,7,1,1,1,3,8,21,Alfonzo McKinnie
2018-19,GSW,SF,72,5,1003,134,275,.487,42,118,.356,92,157,.586,.564,27,48,.563,81,166,247,31,18,15,30,134,337,Alfonzo McKinnie
2019-20,CLE,SF,40,1,593,73,171,.427,14,65,.215,59,106,.557,.468,22,31,.710,37,76,113,14,23,8,26,72,182,Alfonzo McKinnie
2020-21,LAL,SF,39,0,258,48,93,.516,16,39,.410,32,54,.593,.602,10,18,.556,22,32,54,6,7,0,5,26,122,Alfonzo McKinnie
2021-22,CHI,SF,17,3,206,24,61,.393,9,27,.333,15,34,.441,.467,2,8,.250,13,20,33,5,2,3,7,26,59,Alfonzo McKinnie
2021-22,DAL,PG,4,0,11,0,2,.000,0,1,.000,0,1,.000,.000,0,0,0,0,0,2,0,0,0,1,0,0,JaQuori McLaughlin
2019-20,MIN,PG,30,2,590,87,178,.489,29,76,.382,58,102,.569,.570,26,39,.667,7,42,49,125,34,4,31,31,229,Jordan McLaughlin
2020-21,MIN,PG,51,2,938,100,242,.413,33,92,.359,67,150,.447,.481,23,30,.767,21,87,108,193,51,6,51,44,256,Jordan McLaughlin
2021-22,MIN,PG,62,3,902,88,200,.440,27,85,.318,61,115,.530,.508,30,40,.750,22,72,94,180,57,10,38,54,233,Jordan McLaughlin
2022-23,MIN,PG,43,0,678,61,145,.421,24,78,.308,37,67,.552,.503,15,18,.833,15,47,62,148,32,4,33,28,161,Jordan McLaughlin
2023-24,MIN,PG,56,0,626,70,145,.483,42,89,.472,28,56,.500,.628,13,18,.722,18,54,72,110,35,7,19,31,195,Jordan McLaughlin
2024-25,SAC,PG,22,0,164,15,39,.385,9,23,.391,6,16,.375,.500,10,14,.714,3,16,19,19,9,0,9,11,49,Jordan McLaughlin
2024-25,HOU,PF,6,0,21,3,11,.273,2,8,.250,1,3,.333,.364,0,0,1,3,4,1,0,1,1,1,8,0,Jack McVeigh
2018-19,PHO,PG,50,31,984,100,256,.391,29,95,.305,71,161,.441,.447,21,28,.750,25,109,134,159,68,23,75,113,250,De'Anthony Melton
2019-20,MEM,PG,60,8,1167,161,401,.401,40,140,.286,121,261,.464,.451,93,121,.769,43,177,220,175,77,20,84,109,455,De'Anthony Melton
2020-21,MEM,PG,52,1,1045,172,393,.438,87,211,.412,85,182,.467,.548,41,51,.804,30,131,161,132,60,31,66,85,472,De'Anthony Melton
2021-22,MEM,SG,73,15,1657,281,695,.404,139,372,.374,142,323,.440,.504,90,120,.750,64,264,328,194,104,39,112,128,791,De'Anthony Melton
2022-23,PHI,SG,77,58,2150,277,651,.425,157,403,.390,120,248,.484,.546,69,87,.793,69,243,312,197,126,41,102,191,780,De'Anthony Melton
2023-24,PHI,SG,38,33,1023,139,360,.386,77,214,.360,62,146,.425,.493,66,79,.835,28,113,141,114,60,16,39,84,421,De'Anthony Melton
2024-25,GSW,SG,6,2,121,22,54,.407,13,35,.371,9,19,.474,.528,5,8,.625,6,14,20,17,7,2,10,18,62,De'Anthony Melton
2023-24,CHO,C,25,0,307,12,28,.429,0,0,12,28,.429,.429,9,12,.750,29,36,65,9,6,14,14,64,33,0,Nathan Mensah
2020-21,MIL,SG,30,2,233,32,72,.444,21,47,.447,11,25,.440,.590,4,4,1.000,6,24,30,21,8,1,10,17,89,Sam Merrill
2021-22,MEM,SG,6,0,58,8,24,.333,7,23,.304,1,1,1.000,.479,2,4,.500,1,6,7,4,0,0,2,3,25,Sam Merrill
2022-23,CLE,SG,5,0,59,9,22,.409,5,18,.278,4,4,1.000,.523,2,2,1.000,0,9,9,5,4,0,0,3,25,Sam Merrill
2023-24,CLE,SG,61,1,1069,158,393,.402,143,354,.404,15,39,.385,.584,26,28,.929,22,98,120,108,19,4,19,72,485,Sam Merrill
2024-25,CLE,SG,27,2,535,65,168,.387,52,148,.351,13,20,.650,.542,17,18,.944,10,41,51,46,17,7,13,51,199,Sam Merrill
2018-19,SAS,PF,29,0,145,19,58,.328,0,2,.000,19,56,.339,.328,13,17,.765,9,27,36,13,6,2,15,14,51,Chimezie Metu
2019-20,SAS,C,18,0,105,24,42,.571,0,2,.000,24,40,.600,.571,10,13,.769,12,21,33,10,3,6,10,7,58,Chimezie Metu
2020-21,SAC,C,36,6,488,91,179,.508,13,37,.351,78,142,.549,.545,31,43,.721,31,81,112,28,14,18,29,59,226,Chimezie Metu
2021-22,SAC,C,60,20,1279,203,449,.452,57,186,.306,146,263,.555,.516,71,91,.780,34,301,335,60,51,32,61,93,534,Chimezie Metu
2022-23,SAC,PF,66,0,689,129,219,.589,9,38,.237,120,181,.663,.610,54,73,.740,47,151,198,40,22,21,32,81,321,Chimezie Metu
2023-24,2TM,C,51,12,859,123,244,.504,28,94,.298,95,150,.633,.561,58,64,.906,41,153,194,46,43,16,52,71,332,Chimezie Metu
2023-24,PHO,C,37,5,448,66,130,.508,15,51,.294,51,79,.646,.565,38,43,.884,24,86,110,19,19,9,27,39,185,Chimezie Metu
2023-24,DET,C,14,7,411,57,114,.500,13,43,.302,44,71,.620,.557,20,21,.952,17,67,84,27,24,7,25,32,147,Chimezie Metu
2023-24,2TM,PG,60,21,1176,159,370,.430,43,154,.279,116,216,.537,.488,61,75,.813,14,74,88,262,31,7,99,68,422,Vasilije Micić
2023-24,OKC,PG,30,0,361,37,91,.407,11,45,.244,26,46,.565,.467,14,19,.737,1,23,24,76,9,3,29,22,99,Vasilije Micić
2023-24,CHO,PG,30,21,815,122,279,.437,32,109,.294,90,170,.529,.495,47,56,.839,13,51,64,186,22,4,70,46,323,Vasilije Micić
2024-25,CHO,PG,19,8,398,52,146,.356,24,66,.364,28,80,.350,.438,12,15,.800,15,33,48,68,10,0,37,22,140,Vasilije Micić
2012-13,DET,SG,27,0,475,62,141,.440,14,45,.311,48,96,.500,.489,27,32,.844,4,46,50,28,15,4,11,53,165,Khris Middleton
2013-14,MIL,SF,82,64,2460,376,854,.440,120,290,.414,256,564,.454,.511,118,137,.861,60,250,310,169,83,20,123,243,990,Khris Middleton
2014-15,MIL,SF,79,58,2378,406,869,.467,109,268,.407,297,601,.494,.530,134,156,.859,48,299,347,182,122,11,113,183,1055,Khris Middleton
2015-16,MIL,SG,79,79,2852,507,1142,.444,143,361,.396,364,781,.466,.507,277,312,.888,44,258,302,331,131,19,180,204,1434,Khris Middleton
2016-17,MIL,SF,29,23,889,150,333,.450,45,104,.433,105,229,.459,.518,81,92,.880,11,112,123,99,41,7,65,79,426,Khris Middleton
2017-18,MIL,SF,82,82,2982,593,1272,.466,146,407,.359,447,865,.517,.524,320,362,.884,45,384,429,328,119,21,191,270,1652,Khris Middleton
2018-19,MIL,SF,77,77,2393,506,1148,.441,179,474,.378,327,674,.485,.519,216,258,.837,50,411,461,331,80,7,174,172,1407,Khris Middleton
2019-20,MIL,SF,62,59,1853,471,947,.497,147,354,.415,324,593,.546,.575,208,227,.916,44,338,382,265,53,7,137,142,1297,Khris Middleton
2020-21,MIL,SF,68,68,2269,511,1074,.476,151,365,.414,360,709,.508,.546,212,236,.898,54,352,406,370,74,9,178,160,1385,Khris Middleton
2021-22,MIL,SF,66,66,2141,452,1021,.443,162,434,.373,290,587,.494,.522,259,291,.890,41,315,356,358,76,18,190,160,1325,Khris Middleton
2022-23,MIL,SF,33,19,801,177,406,.436,51,162,.315,126,244,.516,.499,92,102,.902,28,112,140,163,23,5,71,68,497,Khris Middleton
2023-24,MIL,SF,55,55,1487,317,643,.493,94,247,.381,223,396,.563,.566,100,120,.833,40,217,257,292,51,15,127,141,828,Khris Middleton
2024-25,MIL,SF,8,3,177,36,81,.444,14,31,.452,22,50,.440,.531,16,20,.800,2,29,31,44,9,2,20,21,102,Khris Middleton
2019-20,SAC,C,1,0,19,2,3,.667,0,0,2,3,.667,.667,2,2,1.000,2,5,7,0,0,0,0,5,6,0,Eric Mika
2023-24,CHO,SF,74,68,2383,476,1083,.440,184,493,.373,292,590,.495,.524,143,173,.827,60,255,315,175,66,42,132,184,1279,Brandon Miller
2024-25,CHO,SF,23,23,793,171,427,.400,89,253,.352,82,174,.471,.505,61,68,.897,21,96,117,85,25,17,65,63,492,Brandon Miller
2023-24,LAC,SF,8,0,28,5,9,.556,1,2,.500,4,7,.571,.611,2,2,1.000,3,2,5,0,0,0,1,2,13,Jordan Miller
2024-25,LAC,SF,19,0,271,44,102,.431,7,30,.233,37,72,.514,.466,17,22,.773,17,18,35,20,6,3,16,19,112,Jordan Miller
2023-24,MIN,SF,17,0,52,13,20,.650,2,5,.400,11,15,.733,.700,1,2,.500,5,15,20,8,2,1,1,5,29,Leonard Miller
2024-25,MIN,SF,1,0,2,0,0,,0,0,,0,0,,,2,2,1.000,0,0,0,0,1,0,0,0,2,Leonard Miller
2017-18,TOR,SF,15,4,126,13,28,.464,8,21,.381,5,7,.714,.607,4,4,1.000,4,11,15,3,1,2,5,10,38,Malcolm Miller
2018-19,TOR,SF,10,0,67,11,26,.423,10,21,.476,1,5,.200,.615,3,4,.750,1,4,5,1,1,1,1,5,35,Malcolm Miller
2019-20,TOR,SF,28,1,162,12,29,.414,8,22,.364,4,7,.571,.552,3,8,.375,2,14,16,11,5,2,4,18,35,Malcolm Miller
2023-24,BRK,SF,2,0,24,1,5,.200,0,3,.000,1,2,.500,.200,1,2,.500,0,4,4,3,0,1,0,0,3,Dariq Whitehead
2024-25,BRK,SF,4,0,28,6,11,.545,6,10,.600,0,1,.000,.818,0,0,,0,3,3,1,3,1,3,1,18,Dariq Whitehead
2009-10,POR,PG,10,0,38,10,24,.417,2,4,.500,8,20,.400,.458,4,7,.571,1,1,2,5,0,0,4,6,26,Patty Mills
2010-11,POR,PG,64,0,783,135,328,.412,47,133,.353,88,195,.451,.483,36,47,.766,19,32,51,109,27,1,62,63,353,Patty Mills
2011-12,SAS,PG,16,3,261,63,130,.485,24,56,.429,39,74,.527,.577,15,15,1.000,4,24,28,39,10,1,26,14,165,Patty Mills
2012-13,SAS,PG,58,2,656,113,241,.469,52,130,.400,61,111,.550,.577,16,19,.842,9,41,50,62,26,4,39,55,294,Patty Mills
2013-14,SAS,PG,81,2,1527,309,666,.464,135,318,.425,174,348,.500,.565,73,82,.890,34,135,169,149,68,9,63,114,826,Patty Mills
2014-15,SAS,PG,51,0,801,128,336,.381,62,182,.341,66,154,.429,.473,33,40,.825,21,54,75,87,28,2,35,58,351,Patty Mills
2015-16,SAS,PG,81,3,1662,260,612,.425,123,320,.384,137,292,.469,.525,47,58,.810,27,131,158,226,59,6,76,102,690,Patty Mills
2016-17,SAS,PG,80,8,1754,273,621,.440,147,355,.414,126,266,.474,.558,66,80,.825,24,117,141,280,65,3,101,109,759,Patty Mills
2017-18,SAS,PG,82,36,2107,280,682,.411,154,414,.372,126,268,.470,.523,105,118,.890,26,128,154,229,55,11,106,128,819,Patty Mills
2018-19,SAS,PG,82,1,1908,282,663,.425,159,404,.394,123,259,.475,.545,88,103,.854,24,158,182,245,49,10,93,129,811,Patty Mills
2019-20,SAS,PG,66,1,1485,258,598,.431,154,403,.382,104,195,.533,.560,97,112,.866,22,86,108,118,53,6,54,105,767,Patty Mills
2020-21,SAS,PG,68,1,1685,252,611,.412,161,429,.375,91,182,.500,.544,71,78,.910,18,98,116,162,42,3,66,81,736,Patty Mills
2021-22,BRK,SG,81,48,2346,324,794,.408,227,568,.400,97,226,.429,.551,48,59,.814,18,138,156,183,51,17,73,112,923,Patty Mills
2022-23,BRK,PG,40,2,567,86,209,.411,49,134,.366,37,75,.493,.529,25,30,.833,8,36,44,56,15,3,30,32,246,Patty Mills
2023-24,2TM,PG,32,5,415,46,131,.351,24,87,.276,22,44,.500,.443,11,11,1.000,9,26,35,34,20,1,16,32,127,Patty Mills
2023-24,ATL,PG,19,0,202,19,51,.373,13,34,.382,6,17,.353,.500,0,0,,5,15,20,14,9,1,8,17,51,Patty Mills
2023-24,MIA,PG,13,5,213,27,80,.338,11,53,.208,16,27,.593,.406,11,11,1.000,4,11,15,20,11,0,8,15,76,Patty Mills
2024-25,UTA,PG,9,0,138,11,31,.355,7,24,.292,4,7,.571,.468,3,3,1.000,1,7,8,13,6,2,8,8,32,Patty Mills
2018-19,PHI,SG,20,0,268,34,87,.391,14,44,.318,20,43,.465,.471,5,7,.714,9,26,35,18,8,8,6,29,87,Shake Milton
2019-20,PHI,SG,40,24,805,134,277,.484,58,135,.430,76,142,.535,.588,51,65,.785,15,73,88,104,20,7,47,92,377,Shake Milton
2020-21,PHI,SG,63,4,1461,300,667,.450,71,203,.350,229,464,.494,.503,146,176,.830,33,115,148,193,39,18,103,130,817,Shake Milton
2021-22,PHI,SG,55,6,1179,173,403,.429,43,133,.323,130,270,.481,.483,61,73,.836,30,112,142,139,28,17,44,99,450,Shake Milton
2022-23,PHI,SG,76,11,1567,241,503,.479,56,148,.378,185,355,.521,.535,99,116,.853,39,152,191,240,25,13,94,123,637,Shake Milton
2023-24,3TM,SG,48,0,581,79,195,.405,18,64,.281,61,131,.466,.451,40,49,.816,14,61,75,60,19,6,31,54,216,Shake Milton
2023-24,MIN,SG,38,0,491,64,160,.400,14,53,.264,50,107,.467,.444,36,44,.818,7,44,51,50,16,5,28,44,178,Shake Milton
2023-24,DET,SG,4,0,63,11,26,.423,3,9,.333,8,17,.471,.481,2,3,.667,7,11,18,6,2,1,3,3,27,Shake Milton
2023-24,NYK,SG,6,0,27,4,9,.444,1,2,.500,3,7,.429,.500,2,2,1.000,0,6,6,4,1,0,0,7,11,Shake Milton
2024-25,BRK,SG,27,1,492,73,157,.465,28,72,.389,45,85,.529,.554,25,33,.758,16,35,51,64,15,1,20,43,199,Shake Milton
2022-23,POR,SF,4,0,89,7,23,.304,3,12,.250,4,11,.364,.370,0,1,.000,3,12,15,4,2,5,4,9,17,Justin Minaya
2023-24,POR,SF,34,1,381,22,74,.297,12,49,.245,10,25,.400,.378,5,9,.556,30,26,56,21,9,10,9,35,61,Justin Minaya
2024-25,POR,SF,1,0,6,0,0,,0,0,,0,0,,,0,0,,0,1,1,0,0,0,0,1,0,Justin Minaya
2024-25,SAS,SF,1,0,7,0,1,.000,0,1,.000,0,0,.000,0,0,0,2,2,0,0,0,0,0,0,0,,Riley Minix
2022-23,MIN,SF,15,0,96,18,36,.500,2,6,.333,16,30,.533,.528,8,8,1.000,5,20,25,5,4,6,3,10,46,Josh Minott
2023-24,MIN,SF,32,0,91,17,36,.472,4,10,.400,13,26,.500,.528,12,14,.857,4,13,17,8,5,5,2,10,50,Josh Minott
2024-25,MIN,SF,17,0,122,20,37,.541,4,16,.250,16,21,.762,.595,5,7,.714,5,17,22,10,9,5,5,15,49,Josh Minott
2024-25,NOP,C,31,25,827,116,211,.550,0,1,.000,116,210,.552,.550,57,88,.648,121,143,264,41,21,40,37,70,289,Yves Missi
2024-25,OKC,SG,29,0,452,67,131,.511,17,38,.447,50,93,.538,.576,18,23,.783,14,41,55,47,23,3,25,50,169,Ajay Mitchell
2021-22,SAC,PG,75,19,2076,352,843,.418,101,320,.316,251,523,.480,.477,56,85,.659,33,133,166,313,55,24,114,141,861,Davion Mitchell
2022-23,SAC,PG,80,9,1447,181,399,.454,63,197,.320,118,202,.584,.533,25,31,.806,16,89,105,185,44,15,62,112,450,Davion Mitchell
2023-24,SAC,PG,72,4,1101,146,323,.452,57,158,.361,89,165,.539,.540,30,42,.714,19,76,95,134,17,3,43,85,379,Davion Mitchell
2024-25,TOR,PG,29,13,762,72,180,.400,27,88,.307,45,92,.489,.475,21,31,.677,14,47,61,144,24,7,54,80,192,Davion Mitchell
2017-18,UTA,SG,79,71,2638,595,1362,.437,187,550,.340,408,812,.502,.506,239,297,.805,52,244,296,291,118,27,215,213,1616,Donovan Mitchell
2018-19,UTA,SG,77,77,2598,661,1530,.432,188,519,.362,473,1011,.468,.493,319,396,.806,59,257,316,322,106,31,218,208,1829,Donovan Mitchell
2019-20,UTA,SG,69,69,2364,602,1342,.449,173,473,.366,429,869,.494,.513,278,322,.863,53,251,304,294,70,14,184,172,1655,Donovan Mitchell
2020-21,UTA,PG,53,53,1771,478,1091,.438,178,461,.386,300,630,.476,.520,267,316,.845,50,185,235,277,52,15,147,117,1401,Donovan Mitchell
2021-22,UTA,SG,67,67,2266,617,1376,.448,232,654,.355,385,722,.533,.533,267,313,.853,55,227,282,358,99,12,200,164,1733,Donovan Mitchell
2022-23,CLE,SG,68,68,2432,679,1402,.484,245,635,.386,434,767,.566,.572,319,368,.867,63,226,289,301,99,27,180,168,1922,Donovan Mitchell
2023-24,CLE,SG,55,55,1942,503,1089,.462,182,494,.368,321,595,.539,.545,275,318,.865,46,234,280,333,101,30,154,118,1463,Donovan Mitchell
2024-25,CLE,SG,30,30,949,250,547,.457,114,277,.412,136,270,.504,.561,94,116,.810,16,123,139,140,48,8,63,63,708,Donovan Mitchell
2021-22,CLE,PF,69,69,2331,422,830,.508,23,92,.250,399,738,.541,.522,167,252,.663,143,427,570,174,56,115,133,147,1034,Evan Mobley
2022-23,CLE,PF,79,79,2715,525,947,.554,22,102,.216,503,845,.595,.566,205,304,.674,187,524,711,224,60,119,146,218,1277,Evan Mobley
2023-24,CLE,PF,50,50,1532,320,552,.580,22,59,.373,298,493,.604,.600,123,171,.719,111,357,468,160,45,72,90,134,785,Evan Mobley
2024-25,CLE,PF,29,29,881,210,366,.574,31,71,.437,179,295,.607,.616,93,120,.775,63,195,258,87,30,42,60,62,544,Evan Mobley
2022-23,CLE,PF,12,0,84,12,28,.429,3,8,.375,9,20,.450,.482,4,4,1.000,4,16,20,3,4,3,1,8,31,Isaiah Mobley
2023-24,CLE,PF,10,0,72,10,24,.417,3,10,.300,7,14,.500,.479,0,1,.000,3,7,10,6,2,0,2,6,23,Isaiah Mobley
2024-25,TOR,PF,31,6,553,65,143,.455,7,24,.292,58,119,.487,.479,33,46,.717,60,83,143,55,26,16,28,61,170,Jonathan Mogbo
2019-20,CHI,SF,11,0,112,12,28,.429,6,15,.400,6,13,.462,.536,2,4,.500,7,3,10,4,4,0,2,17,32,Adam Mokoka
2020-21,CHI,SG,14,0,56,7,19,.368,1,10,.100,6,9,.667,.395,0,1,.000,1,4,5,5,2,1,5,5,15,Adam Mokoka
2022-23,SAC,SF,2,0,8,1,2,.500,0,0,1,2,.500,.500,0,2,.000,2,0,2,1,0,0,2,2,2,0,Chima Moneke
2017-18,CHO,SG,63,0,854,153,425,.360,83,243,.342,70,182,.385,.458,32,38,.842,8,58,66,91,20,9,49,60,421,Malik Monk
2018-19,CHO,SG,73,0,1258,227,586,.387,109,330,.330,118,256,.461,.480,90,102,.882,16,121,137,117,37,19,86,106,653,Malik Monk
2019-20,CHO,SG,55,1,1169,212,488,.434,58,204,.284,154,284,.542,.494,82,100,.820,27,130,157,114,25,16,77,74,564,Malik Monk
2020-21,CHO,SG,42,0,878,173,399,.434,85,212,.401,88,187,.471,.540,59,72,.819,14,87,101,87,19,4,55,47,490,Malik Monk
2021-22,LAL,SG,76,37,2139,391,826,.473,173,442,.391,218,384,.568,.578,93,117,.795,37,219,256,218,61,29,122,138,1048,Malik Monk
2022-23,SAC,SG,77,0,1719,357,796,.448,143,398,.359,214,398,.538,.538,184,207,.889,32,171,203,298,49,20,146,125,1041,Malik Monk
2023-24,SAC,SG,72,0,1872,396,893,.443,148,423,.350,248,470,.528,.526,170,205,.829,28,184,212,370,45,39,150,156,1110,Malik Monk
2024-25,SAC,SG,24,11,714,136,309,.440,57,161,.354,79,148,.534,.532,47,55,.855,4,80,84,113,19,15,43,56,376,Malik Monk
2021-22,GSW,SG,52,11,607,80,183,.437,40,110,.364,40,73,.548,.546,28,36,.778,17,63,80,23,7,10,13,43,228,Moses Moody
2022-23,GSW,SG,63,3,817,108,227,.476,49,135,.363,59,92,.641,.584,37,53,.698,28,77,105,51,18,7,34,54,302,Moses Moody
2023-24,GSW,SG,66,9,1156,194,420,.462,72,200,.360,122,220,.555,.548,73,93,.785,65,131,196,57,42,24,44,90,533,Moses Moody
2024-25,GSW,SG,25,4,392,63,153,.412,32,91,.352,31,62,.500,.516,27,37,.730,10,35,45,21,9,6,19,30,185,Moses Moody
2021-22,LAC,SG,10,0,137,25,51,.490,5,14,.357,20,37,.541,.539,3,5,.600,2,12,14,24,7,3,6,9,58,Xavier Moon
2022-23,LAC,SG,4,0,20,3,9,.333,1,3,.333,2,6,.333,.389,0,0,,0,3,3,5,0,0,1,2,7,Xavier Moon
2023-24,LAC,SG,14,1,119,15,46,.326,2,17,.118,13,29,.448,.348,1,2,.500,8,10,18,21,3,3,5,8,33,Xavier Moon
2023-24,POR,SG,4,0,40,8,19,.421,1,7,.143,7,12,.583,.447,1,2,.500,4,4,8,5,2,0,3,4,18,Taze Moore
2024-25,POR,SG,2,0,20,2,10,.200,1,4,.250,1,6,.167,.250,1,2,.500,4,4,8,1,2,0,2,0,6,Taze Moore
2022-23,MIN,SG,29,2,153,18,43,.419,2,17,.118,16,26,.615,.442,4,5,.800,4,14,18,18,8,5,8,13,42,Wendell Moore Jr.
2023-24,MIN,SG,25,0,75,9,18,.500,0,6,.000,9,12,.750,.500,0,0,,0,12,12,6,5,1,4,5,18,Wendell Moore Jr.
2024-25,DET,SG,12,0,171,19,36,.528,3,9,.333,16,27,.593,.569,11,12,.917,9,28,37,14,8,3,8,13,52,Wendell Moore Jr.
2019-20,MEM,PG,67,67,2074,447,937,.477,60,179,.335,387,758,.511,.509,239,308,.776,51,208,259,488,58,18,220,110,1193,Ja Morant
2020-21,MEM,PG,63,63,2053,430,957,.449,73,241,.303,357,716,.499,.487,271,372,.728,59,193,252,465,57,13,203,87,1204,Ja Morant
2021-22,MEM,PG,57,57,1889,580,1177,.493,88,256,.344,492,921,.534,.530,316,415,.761,77,248,325,384,66,22,196,86,1564,Ja Morant
2022-23,MEM,PG,61,59,1948,566,1214,.466,92,300,.307,474,914,.519,.504,372,497,.748,61,296,357,493,66,16,206,100,1596,Ja Morant
2023-24,MEM,PG,9,9,318,80,170,.471,14,51,.275,66,119,.555,.512,52,64,.813,6,44,50,73,7,5,27,19,226,Ja Morant
2024-25,MEM,PG,20,20,553,142,313,.454,31,96,.323,111,217,.512,.503,109,130,.838,13,75,88,158,22,8,76,32,424,Ja Morant
2019-20,UTA,PF,21,0,134,15,26,.577,3,8,.375,12,18,.667,.635,3,4,.750,10,19,29,6,1,2,6,19,36,Juwan Morgan
2020-21,UTA,PF,29,0,147,14,30,.467,4,13,.308,10,17,.588,.533,3,7,.429,9,19,28,9,4,1,4,21,35,Juwan Morgan
2021-22,2TM,PF,2,0,31,2,3,.667,1,2,.500,1,1,1.000,.833,0,0,,2,2,4,1,0,0,0,3,5,Juwan Morgan
2021-22,TOR,PF,1,0,27,2,3,.667,1,2,.500,1,1,1.000,.833,0,0,,2,2,4,1,0,0,0,3,5,Juwan Morgan
2021-22,BOS,PF,1,0,4,0,0,,0,0,,0,0,,,0,0,,0,0,0,0,0,0,0,0,0,Juwan Morgan
2011-12,HOU,PF,17,0,126,16,54,.296,2,17,.118,14,37,.378,.315,6,8,.750,5,11,16,3,2,2,4,12,40,Marcus Morris
2012-13,2TM,PF,77,23,1524,222,526,.422,86,233,.369,136,293,.464,.504,66,117,.564,80,197,277,62,45,20,77,160,596,Marcus Morris
2012-13,HOU,PF,54,17,1154,171,400,.428,74,194,.381,97,206,.471,.520,49,75,.653,63,156,219,47,27,16,53,120,465,Marcus Morris
2012-13,PHO,SF,23,6,370,51,126,.405,12,39,.308,39,87,.448,.452,17,42,.405,17,41,58,15,18,4,24,40,131,Marcus Morris
2013-14,PHO,SF,82,1,1800,288,651,.442,99,260,.381,189,391,.483,.518,121,159,.761,84,235,319,88,72,18,95,157,796,Marcus Morris
2014-15,PHO,PF,81,35,2045,331,763,.434,112,313,.358,219,450,.487,.507,71,113,.628,73,312,385,133,63,16,73,188,845,Marcus Morris
2015-16,DET,SF,80,80,2856,410,945,.434,108,298,.362,302,647,.467,.491,203,271,.749,91,313,404,201,67,23,140,170,1131,Marcus Morris
2016-17,DET,SF,79,79,2565,421,1007,.418,118,357,.331,303,650,.466,.477,145,185,.784,77,289,366,160,52,25,87,168,1105,Marcus Morris
2017-18,BOS,PF,54,21,1442,262,611,.429,86,234,.368,176,377,.467,.499,124,154,.805,43,246,289,72,35,12,65,100,734,Marcus Morris
2018-19,BOS,PF,75,53,2091,377,844,.447,146,389,.375,231,455,.508,.533,146,173,.844,76,382,458,109,43,25,92,181,1046,Marcus Morris
2019-20,2TM,SF,62,62,1936,355,810,.438,142,348,.408,213,462,.461,.526,181,220,.823,59,252,311,86,47,30,97,180,1033,Marcus Morris
2019-20,NYK,SF,43,43,1387,281,636,.442,116,264,.439,165,372,.444,.533,163,198,.823,48,185,233,59,34,17,73,128,841,Marcus Morris
2019-20,LAC,PF,19,19,549,74,174,.425,26,84,.310,48,90,.533,.500,18,22,.818,11,67,78,27,13,13,24,52,192,Marcus Morris
2020-21,LAC,PF,57,29,1502,276,584,.473,140,296,.473,136,288,.472,.592,73,89,.820,35,199,234,58,34,15,57,117,765,Marcus Morris
2021-22,LAC,PF,54,54,1564,300,691,.434,101,275,.367,199,416,.478,.507,129,148,.872,26,213,239,113,28,18,69,115,830,Marcus Morris
2022-23,LAC,PF,65,65,1825,274,643,.426,112,308,.364,162,335,.484,.513,68,87,.782,29,229,258,114,42,21,56,136,728,Marcus Morris
2023-24,2TM,PF,49,7,817,116,264,.439,48,119,.403,68,145,.469,.530,36,44,.818,23,111,134,36,15,13,30,74,316,Marcus Morris
2023-24,PHI,PF,37,7,637,90,205,.439,36,90,.400,54,115,.470,.527,31,36,.861,18,91,109,26,13,11,19,61,247,Marcus Morris
2023-24,CLE,PF,12,0,180,26,59,.441,12,29,.414,14,30,.467,.542,5,8,.625,5,20,25,10,2,2,11,13,69,Marcus Morris
2011-12,PHO,PF,63,7,1227,174,436,.399,43,124,.347,131,312,.420,.448,76,106,.717,69,210,279,65,41,42,70,179,467,Markieff Morris
2012-13,PHO,PF,82,32,1837,266,653,.407,45,134,.336,221,519,.426,.442,93,127,.732,131,265,396,108,77,64,104,209,670,Markieff Morris
2013-14,PHO,PF,81,0,2153,411,845,.486,34,108,.315,377,737,.512,.507,259,327,.792,139,346,485,144,68,51,147,232,1115,Markieff Morris
2014-15,PHO,PF,82,82,2581,512,1100,.465,57,179,.318,455,921,.494,.491,177,232,.763,110,396,506,192,101,39,170,245,1258,Markieff Morris
2015-16,2TM,PF,64,45,1629,305,718,.425,47,155,.303,258,563,.458,.458,108,147,.735,73,279,352,124,58,34,135,184,765,Markieff Morris
2015-16,PHO,PF,37,24,917,171,431,.397,22,76,.289,149,355,.420,.422,66,92,.717,43,151,194,87,33,17,90,104,430,Markieff Morris
2015-16,WAS,PF,27,21,712,134,287,.467,25,79,.316,109,208,.524,.510,42,55,.764,30,128,158,37,25,17,45,80,335,Markieff Morris
2016-17,WAS,PF,76,76,2374,406,889,.457,71,196,.362,335,693,.483,.497,180,215,.837,107,386,493,126,82,42,129,254,1063,Markieff Morris
2017-18,WAS,PF,73,73,1968,330,687,.480,76,207,.367,254,480,.529,.536,105,128,.820,75,334,409,142,56,38,127,216,841,Markieff Morris
2018-19,2TM,PF,58,16,1270,204,484,.421,68,203,.335,136,281,.484,.492,71,92,.772,61,204,265,79,36,22,54,175,547,Markieff Morris
2018-19,WAS,PF,34,15,883,143,328,.436,48,144,.333,95,184,.516,.509,57,73,.781,41,133,174,60,25,20,47,117,391,Markieff Morris
2018-19,OKC,PF,24,1,387,61,156,.391,20,59,.339,41,97,.423,.455,14,19,.737,20,71,91,19,11,2,7,58,156,Markieff Morris
2019-20,2TM,PF,58,17,1187,203,458,.443,88,228,.386,115,230,.500,.539,66,85,.776,40,178,218,77,31,17,76,133,560,Markieff Morris
2019-20,DET,PF,44,16,988,175,389,.450,75,189,.397,100,200,.500,.546,61,79,.772,24,149,173,69,26,11,70,104,486,Markieff Morris
2019-20,LAL,PF,14,1,199,28,69,.406,13,39,.333,15,30,.500,.500,5,6,.833,16,29,45,8,5,6,6,29,74,Markieff Morris
2020-21,LAL,PF,61,27,1200,153,378,.405,65,209,.311,88,169,.521,.491,36,50,.720,48,218,266,73,22,19,54,105,407,Markieff Morris
2021-22,MIA,PF,17,1,298,54,114,.474,13,39,.333,41,75,.547,.531,8,9,.889,17,28,45,23,6,1,20,33,129,Markieff Morris
2022-23,2TM,PF,35,2,355,47,115,.409,28,71,.394,19,44,.432,.530,10,10,1.000,13,58,71,31,9,5,18,48,132,Markieff Morris
2022-23,BRK,PF,27,1,285,33,82,.402,20,49,.408,13,33,.394,.524,10,10,1.000,13,46,59,25,8,5,14,33,96,Markieff Morris
2022-23,DAL,PF,8,1,70,14,33,.424,8,22,.364,6,11,.545,.545,0,0,,0,12,12,6,1,0,4,15,36,Markieff Morris
2023-24,DAL,PF,26,1,216,23,68,.338,15,42,.357,8,26,.308,.449,5,6,.833,4,35,39,16,5,3,12,12,66,Markieff Morris
2024-25,DAL,PF,4,0,21,2,9,.222,1,3,.333,1,6,.167,.278,0,0,,0,5,5,2,0,1,2,0,5,Markieff Morris
2017-18,DEN,PG,3,0,25,4,6,.667,0,1,.000,4,5,.800,.667,2,2,1.000,0,2,2,7,3,0,1,1,10,Monte Morris
2018-19,DEN,PG,82,6,1970,346,702,.493,94,227,.414,252,475,.531,.560,65,81,.802,35,159,194,297,73,4,52,102,851,Monte Morris
2019-20,DEN,PG,73,12,1636,260,566,.459,65,172,.378,195,394,.495,.517,75,89,.843,24,113,137,255,55,17,53,73,660,Monte Morris
2020-21,DEN,PG,47,13,1196,186,387,.481,51,134,.381,135,253,.534,.547,58,73,.795,11,85,96,150,34,13,34,48,481,Monte Morris
2021-22,DEN,PG,75,74,2239,374,773,.484,124,314,.395,250,459,.545,.564,73,84,.869,27,199,226,333,56,14,78,92,945,Monte Morris
2022-23,WAS,PG,62,61,1695,247,515,.480,78,204,.382,169,311,.543,.555,64,77,.831,26,184,210,326,43,13,60,75,636,Monte Morris
2023-24,2TM,PG,33,0,476,62,153,.405,27,70,.386,35,83,.422,.493,13,19,.684,7,50,57,69,19,9,7,14,164,Monte Morris
2023-24,DET,PG,6,0,68,12,33,.364,2,11,.182,10,22,.455,.394,1,2,.500,2,10,12,8,1,1,2,1,27,Monte Morris
2023-24,MIN,PG,27,0,408,50,120,.417,25,59,.424,25,61,.410,.521,12,17,.706,5,40,45,61,18,8,5,13,137,Monte Morris
2024-25,PHO,PG,25,0,329,44,110,.400,16,52,.308,28,58,.483,.473,24,29,.828,7,32,39,45,12,3,12,14,128,Monte Morris
2015-16,DEN,PG,68,66,2068,329,905,.364,74,232,.319,255,673,.379,.404,140,209,.670,32,200,232,372,65,35,217,141,872,Emmanuel Mudiay
2016-17,DEN,PG,55,41,1406,208,551,.377,56,178,.315,152,373,.408,.428,131,167,.784,29,149,178,217,41,13,123,95,603,Emmanuel Mudiay
2017-18,2TM,PG,64,14,1245,204,526,.388,47,148,.318,157,378,.415,.433,98,129,.760,26,126,152,206,41,11,113,80,553,Emmanuel Mudiay
2017-18,DEN,PG,42,0,752,129,322,.401,38,102,.373,91,220,.414,.460,63,78,.808,16,78,94,121,21,4,72,47,359,Emmanuel Mudiay
2017-18,NYK,PG,22,14,493,75,204,.368,9,46,.196,66,158,.418,.390,35,51,.686,10,48,58,85,20,7,41,33,194,Emmanuel Mudiay
2018-19,NYK,PG,59,42,1607,330,740,.446,69,210,.329,261,530,.492,.493,144,186,.774,33,163,196,228,43,19,140,103,873,Emmanuel Mudiay
2019-20,UTA,PG,54,2,850,151,327,.462,30,87,.345,121,240,.504,.508,63,83,.759,18,108,126,116,24,10,76,72,395,Emmanuel Mudiay
2021-22,SAC,PG,2,0,11,0,2,.000,0,0,,0,2,.000,.000,3,4,.750,0,0,0,4,1,0,1,1,3,Emmanuel Mudiay
2019-20,GSW,SF,7,3,204,26,67,.388,16,52,.308,10,15,.667,.507,9,12,.750,3,20,23,8,2,1,5,20,77,Mychal Mulder
2020-21,GSW,PG,60,6,766,119,265,.449,85,214,.397,34,51,.667,.609,14,22,.636,8,52,60,26,12,12,16,56,337,Mychal Mulder
2021-22,2TM,PG,17,3,239,24,77,.312,17,54,.315,7,23,.304,.422,4,4,1.000,2,22,24,5,4,2,8,13,69,Mychal Mulder
2021-22,ORL,PG,15,2,195,20,67,.299,13,46,.283,7,21,.333,.396,2,2,1.000,2,19,21,3,4,1,8,12,55,Mychal Mulder
2021-22,MIA,PG,2,1,44,4,10,.400,4,8,.500,0,2,.000,.600,2,2,1.000,0,3,3,2,0,1,0,1,14,Mychal Mulder
2021-22,NOP,SF,62,1,864,109,277,.394,71,186,.382,38,91,.418,.522,45,51,.882,47,100,147,38,23,7,16,60,334,Trey Murphy III
2022-23,NOP,SF,79,65,2448,387,800,.484,202,497,.406,185,303,.611,.610,172,190,.905,59,222,281,112,89,43,61,155,1148,Trey Murphy III
2023-24,NOP,SF,57,23,1690,275,621,.443,169,445,.380,106,176,.602,.579,123,151,.815,42,238,280,124,51,28,34,70,842,Trey Murphy III
2024-25,NOP,SF,19,17,644,132,292,.452,57,158,.361,75,134,.560,.550,63,71,.887,15,71,86,46,20,13,33,44,384,Trey Murphy III
2016-17,SAS,PG,38,8,322,50,116,.431,9,23,.391,41,93,.441,.470,21,30,.700,6,36,42,48,8,6,38,29,130,Dejounte Murray
2017-18,SAS,PG,81,48,1743,270,609,.443,9,34,.265,261,575,.454,.451,105,148,.709,110,349,459,231,97,31,134,151,654,Dejounte Murray
2019-20,SAS,PG,66,58,1687,294,637,.462,41,111,.369,253,526,.481,.494,91,114,.798,69,314,383,271,111,17,125,143,720,Dejounte Murray
2020-21,SAS,PG,67,67,2139,441,974,.453,63,199,.317,378,775,.488,.485,106,134,.791,58,415,473,363,101,7,117,135,1051,Dejounte Murray
2021-22,SAS,PG,68,68,2366,573,1241,.462,96,294,.327,477,947,.504,.500,196,247,.794,80,483,563,627,138,23,180,138,1438,Dejounte Murray
2022-23,ATL,SG,74,74,2693,612,1319,.464,133,387,.344,479,932,.514,.514,158,190,.832,53,336,389,448,112,19,160,106,1515,Dejounte Murray
2023-24,ATL,SG,78,78,2783,672,1463,.459,201,554,.363,471,909,.518,.528,208,262,.794,62,354,416,502,111,24,201,138,1753,Dejounte Murray
2024-25,NOP,PG,15,15,504,89,244,.365,22,80,.275,67,164,.409,.410,43,52,.827,7,91,98,112,35,8,61,35,243,Dejounte Murray
2016-17,DEN,SG,82,10,1764,295,730,.404,115,344,.334,180,386,.466,.483,106,120,.883,41,173,214,170,51,24,113,124,811,Jamal Murray
2017-18,DEN,PG,81,80,2565,479,1062,.451,165,436,.378,314,626,.502,.529,229,253,.905,82,215,297,274,79,28,172,173,1352,Jamal Murray
2018-19,DEN,PG,75,74,2447,513,1173,.437,152,414,.367,361,759,.476,.502,189,223,.848,65,252,317,363,67,27,158,153,1367,Jamal Murray
2019-20,DEN,PG,59,59,1904,408,894,.456,112,324,.346,296,570,.519,.519,163,185,.881,45,191,236,284,67,17,127,102,1091,Jamal Murray
2020-21,DEN,PG,48,48,1704,378,792,.477,129,316,.408,249,476,.523,.559,133,153,.869,37,157,194,231,64,13,108,95,1018,Jamal Murray
2022-23,DEN,PG,65,65,2133,473,1041,.454,172,432,.398,301,609,.494,.537,180,216,.833,48,209,257,400,66,16,145,103,1298,Jamal Murray
2023-24,DEN,PG,59,59,1861,474,986,.481,145,341,.425,329,645,.510,.554,157,184,.853,42,200,242,384,57,39,125,104,1250,Jamal Murray
2024-25,DEN,PG,23,23,841,159,367,.433,48,135,.356,111,232,.478,.499,75,90,.833,10,85,95,146,35,13,54,42,441,Jamal Murray
2022-23,SAC,SF,80,78,2382,354,782,.453,206,501,.411,148,281,.527,.584,62,81,.765,89,282,371,98,61,42,60,162,976,Keegan Murray
2023-24,SAC,SF,77,77,2588,443,975,.454,183,511,.358,260,464,.560,.548,103,124,.831,106,314,420,129,79,59,64,205,1172,Keegan Murray
2024-25,SAC,PF,30,30,1072,140,334,.419,49,166,.295,91,168,.542,.493,34,39,.872,67,160,227,44,21,25,29,88,363,Keegan Murray
2023-24,POR,SF,62,29,1348,145,366,.396,49,183,.268,96,183,.525,.463,37,56,.661,85,139,224,80,53,21,55,92,376,Kris Murray
2024-25,POR,SF,24,0,296,39,86,.453,11,35,.314,28,51,.549,.517,8,20,.400,23,28,51,18,10,3,13,25,97,Kris Murray
2013-14,ATL,PF,20,0,215,31,73,.425,0,3,.000,31,70,.443,.425,14,14,1.000,17,35,52,7,3,10,12,29,76,Mike Muscala
2014-15,ATL,PF,40,8,502,83,151,.550,9,22,.409,74,129,.574,.579,22,25,.880,52,67,119,25,16,19,21,52,197,Mike Muscala
2015-16,ATL,C,60,0,565,76,152,.500,12,39,.308,64,113,.566,.539,31,39,.795,38,79,117,34,13,27,27,72,195,Mike Muscala
2016-17,ATL,C,70,3,1237,170,337,.504,46,110,.418,124,227,.546,.573,49,64,.766,76,164,240,95,30,41,55,97,435,Mike Muscala
2017-18,ATL,C,53,7,1060,143,312,.458,62,167,.371,81,145,.559,.558,57,62,.919,56,174,230,51,31,27,42,80,405,Mike Muscala
2018-19,2TM,PF,64,10,1306,145,361,.402,89,256,.348,56,105,.533,.525,70,85,.824,57,187,244,76,22,38,48,130,449,Mike Muscala
2018-19,PHI,PF,47,6,1041,109,278,.392,68,199,.342,41,79,.519,.514,63,77,.818,51,149,200,62,18,27,43,112,349,Mike Muscala
2018-19,LAL,PF,17,4,265,36,83,.434,21,57,.368,15,26,.577,.560,7,8,.875,6,38,44,14,4,11,5,18,100,Mike Muscala
2019-20,OKC,C,47,2,572,77,189,.407,54,143,.378,23,46,.500,.550,18,22,.818,16,92,108,40,9,12,17,58,226,Mike Muscala
2020-21,OKC,C,35,0,645,119,267,.446,68,184,.370,51,83,.614,.573,33,36,.917,19,113,132,28,8,11,21,54,339,Mike Muscala
2021-22,OKC,C,43,0,592,113,248,.456,70,163,.429,43,85,.506,.597,48,57,.842,21,108,129,22,18,26,14,58,344,Mike Muscala
2022-23,2TM,C,63,9,945,131,292,.449,81,207,.391,50,85,.588,.587,40,52,.769,37,166,203,50,15,24,23,98,383,Mike Muscala
2022-23,OKC,C,43,5,622,89,203,.438,56,142,.394,33,61,.541,.576,31,39,.795,23,112,135,38,11,19,14,70,265,Mike Muscala
2022-23,BOS,C,20,4,323,42,89,.472,25,65,.385,17,24,.708,.612,9,13,.692,14,54,68,12,4,5,9,28,118,Mike Muscala
2023-24,3TM,C,53,6,600,56,156,.359,28,96,.292,28,60,.467,.449,17,25,.680,39,86,125,36,9,13,22,52,157,Mike Muscala
2023-24,WAS,C,24,2,338,33,90,.367,14,51,.275,19,39,.487,.444,15,20,.750,22,53,75,22,5,7,16,31,95,Mike Muscala
2023-24,DET,C,13,4,171,15,44,.341,13,34,.382,2,10,.200,.489,2,4,.500,10,19,29,10,3,5,2,13,45,Mike Muscala
2023-24,OKC,C,16,0,91,8,22,.364,1,11,.091,7,11,.636,.386,0,1,.000,7,14,21,4,1,1,4,8,17,Mike Muscala
2018-19,2TM,SF,42,0,440,46,140,.329,29,89,.326,17,51,.333,.432,12,20,.600,9,27,36,37,14,1,21,25,133,Svi Mykhailiuk
2018-19,LAL,SF,39,0,420,44,132,.333,27,85,.318,17,47,.362,.436,12,20,.600,8,26,34,33,13,1,20,25,127,Svi Mykhailiuk
2018-19,DET,SF,3,0,20,2,8,.250,2,4,.500,0,4,.000,.375,0,0,,1,1,2,4,1,0,1,0,6,Svi Mykhailiuk
2019-20,DET,SF,56,27,1265,166,405,.410,115,285,.404,51,120,.425,.552,57,70,.814,17,87,104,106,41,4,61,87,504,Svi Mykhailiuk
2020-21,2TM,SF,66,14,1324,208,506,.411,105,314,.334,103,192,.536,.515,38,50,.760,24,139,163,110,51,12,88,63,559,Svi Mykhailiuk
2020-21,DET,SF,36,5,634,84,223,.377,57,171,.333,27,52,.519,.504,24,30,.800,11,63,74,57,27,6,39,33,249,Svi Mykhailiuk
2020-21,OKC,SF,30,9,690,124,283,.438,48,143,.336,76,140,.543,.523,14,20,.700,13,76,89,53,24,6,49,30,310,Svi Mykhailiuk
2021-22,TOR,SF,56,5,716,91,234,.389,41,134,.306,50,100,.500,.476,32,37,.865,20,72,92,45,26,4,32,54,255,Svi Mykhailiuk
2022-23,2TM,SF,32,8,468,77,173,.445,42,99,.424,35,74,.473,.566,26,39,.667,15,38,53,53,15,4,24,23,222,Svi Mykhailiuk
2022-23,NYK,SF,13,0,40,6,12,.500,6,10,.600,0,2,.000,.750,3,5,.600,0,7,7,1,1,0,2,1,21,Svi Mykhailiuk
2022-23,CHO,SF,19,8,428,71,161,.441,36,89,.404,35,72,.486,.553,23,34,.676,15,31,46,52,14,4,22,22,201,Svi Mykhailiuk
2023-24,BOS,SF,41,2,413,57,137,.416,42,108,.389,15,29,.517,.569,6,9,.667,11,40,51,35,11,1,12,19,162,Svi Mykhailiuk
2024-25,UTA,SF,9,5,151,27,61,.443,19,47,.404,8,14,.571,.598,4,6,.667,1,13,14,13,8,2,14,9,77,Svi Mykhailiuk
2015-16,LAL,PF,63,22,1266,158,300,.527,1,10,.100,157,290,.541,.528,32,47,.681,101,211,312,44,54,23,41,124,349,Larry Nance Jr.
2016-17,LAL,PF,63,7,1442,190,361,.526,10,36,.278,180,325,.554,.540,59,80,.738,120,249,369,96,82,39,56,149,449,Larry Nance Jr.
2017-18,2TM,C,66,26,1421,240,413,.581,2,12,.167,238,401,.594,.584,91,137,.664,161,291,452,82,88,38,51,172,573,Larry Nance Jr.
2017-18,LAL,C,42,17,922,152,253,.601,1,4,.250,151,249,.606,.603,55,87,.632,108,176,284,57,59,20,41,113,360,Larry Nance Jr.
2017-18,CLE,C,24,9,499,88,160,.550,1,8,.125,87,152,.572,.553,36,50,.720,53,115,168,25,29,18,10,59,213,Larry Nance Jr.
2018-19,CLE,C,67,30,1795,249,479,.520,33,98,.337,216,381,.567,.554,96,134,.716,168,384,552,214,100,40,97,192,627,Larry Nance Jr.
2019-20,CLE,PF,56,10,1472,229,431,.531,56,159,.352,173,272,.636,.596,50,74,.676,106,303,409,123,56,22,60,91,564,Larry Nance Jr.
2020-21,CLE,PF,35,27,1091,128,272,.471,41,114,.360,87,158,.551,.546,30,49,.612,54,181,235,107,61,17,55,72,327,Larry Nance Jr.
2021-22,2TM,PF,46,11,1040,129,247,.522,23,70,.329,106,177,.599,.569,40,57,.702,72,176,248,81,43,20,37,84,321,Larry Nance Jr.
2021-22,POR,C,37,11,858,102,198,.515,19,62,.306,83,136,.610,.563,32,49,.653,58,151,209,73,38,13,27,67,255,Larry Nance Jr.
2021-22,NOP,PF,9,0,182,27,49,.551,4,8,.500,23,41,.561,.592,8,8,1.000,14,25,39,8,5,7,10,17,66,Larry Nance Jr.
2022-23,NOP,C,65,1,1381,186,305,.610,14,42,.333,172,263,.654,.633,55,79,.696,106,248,354,119,56,37,42,133,441,Larry Nance Jr.
2023-24,NOP,C,61,0,1216,138,241,.573,27,65,.415,111,176,.631,.629,47,61,.770,94,213,307,113,61,19,49,98,350,Larry Nance Jr.
2024-25,ATL,PF,14,2,264,51,88,.580,26,49,.531,25,39,.641,.727,5,6,.833,14,40,54,23,14,11,7,23,133,Larry Nance Jr.
2023-24,CLE,PF,8,0,27,1,6,.167,1,1,1.000,0,5,.000,.250,0,2,.000,0,3,3,0,1,0,1,2,3,Pete Nance
2014-15,MIA,PG,51,10,1012,87,228,.382,43,118,.364,44,110,.400,.476,44,56,.786,17,96,113,130,40,4,81,76,261,Shabazz Napier
2015-16,ORL,PG,55,0,600,68,201,.338,34,104,.327,34,97,.351,.423,33,45,.733,9,46,55,97,23,1,46,38,203,Shabazz Napier
2016-17,POR,PG,53,2,512,73,183,.399,34,92,.370,39,91,.429,.492,38,49,.776,8,53,61,67,32,2,41,38,218,Shabazz Napier
2017-18,POR,PG,74,9,1535,223,531,.420,82,218,.376,141,313,.450,.497,116,138,.841,26,144,170,150,81,14,90,84,644,Shabazz Napier
2018-19,BRK,PG,56,2,983,169,435,.389,76,228,.333,93,207,.449,.476,115,138,.833,18,82,100,143,41,16,66,67,529,Shabazz Napier
2019-20,2TM,PG,56,32,1344,188,456,.412,76,240,.317,112,216,.519,.496,126,153,.824,26,132,158,262,69,11,128,101,578,Shabazz Napier
2019-20,MIN,PG,36,22,856,114,283,.403,47,159,.296,67,124,.540,.486,72,88,.818,17,93,110,187,40,7,76,62,347,Shabazz Napier
2019-20,WAS,PG,20,10,488,74,173,.428,29,81,.358,45,92,.489,.512,54,65,.831,9,39,48,75,29,4,52,39,231,Shabazz Napier
2022-23,IND,SG,75,63,2073,284,644,.441,92,263,.350,192,381,.504,.512,49,62,.790,35,164,199,341,70,13,126,179,709,Andrew Nembhard
2023-24,IND,PG,68,47,1697,260,522,.498,61,171,.357,199,351,.567,.557,45,56,.804,36,105,141,280,63,6,101,143,626,Andrew Nembhard
2024-25,IND,SG,17,17,447,67,140,.479,13,40,.325,54,100,.540,.525,33,37,.892,6,41,47,80,14,2,31,29,180,Andrew Nembhard
2021-22,CLE,SG,14,0,63,6,18,.333,0,2,.000,6,16,.375,.333,3,4,.750,3,4,7,12,1,0,3,2,15,RJ Nembhard Jr.
2020-21,BOS,SF,46,1,669,78,178,.438,40,108,.370,38,70,.543,.551,22,28,.786,28,99,127,23,15,9,23,87,218,Aaron Nesmith
2021-22,BOS,SF,52,3,574,72,182,.396,31,115,.270,41,67,.612,.481,21,26,.808,15,74,89,22,20,5,31,70,196,Aaron Nesmith
2022-23,IND,SF,73,60,1816,252,590,.427,115,314,.366,137,276,.496,.525,119,142,.838,62,215,277,98,55,34,75,235,738,Aaron Nesmith
2023-24,IND,SF,72,47,1995,315,635,.496,140,334,.419,175,301,.581,.606,107,137,.781,63,212,275,108,65,49,64,241,877,Aaron Nesmith
2024-25,IND,SF,6,6,136,19,36,.528,6,11,.545,13,25,.520,.611,11,13,.846,4,20,24,6,4,2,5,24,55,Aaron Nesmith
2015-16,UTA,PG,81,53,1499,180,418,.431,64,162,.395,116,256,.453,.507,52,70,.743,17,103,120,174,62,2,109,122,476,Raul Neto
2016-17,UTA,PG,40,0,346,41,91,.451,10,31,.323,31,60,.517,.505,8,9,.889,4,26,30,34,21,5,15,48,100,Raul Neto
2017-18,UTA,PG,41,0,498,69,151,.457,19,47,.404,50,104,.481,.520,26,35,.743,7,42,49,75,13,4,36,38,183,Raul Neto
2018-19,UTA,PG,37,1,474,74,161,.460,20,60,.333,54,101,.535,.522,28,33,.848,6,56,62,93,14,4,35,49,196,Raul Neto
2019-20,PHI,PG,54,3,668,101,222,.455,34,88,.386,67,134,.500,.532,39,47,.830,11,50,61,95,24,6,47,50,275,Raul Neto
2020-21,WAS,PG,64,22,1403,209,447,.468,64,164,.390,145,283,.512,.539,75,85,.882,28,128,156,146,73,6,53,109,557,Raul Neto
2021-22,WAS,PG,70,19,1372,204,441,.463,35,120,.292,169,321,.526,.502,83,108,.769,13,121,134,217,55,3,79,104,526,Raul Neto
2022-23,CLE,PG,48,1,505,57,110,.518,12,42,.286,45,68,.662,.573,31,34,.912,10,36,46,79,17,4,24,49,157,Raul Neto
2024-25,IND,SG,5,0,8,1,6,.167,0,3,.000,1,3,.333,.167,1,1,1.000,0,0,0,1,0,0,1,2,3,Tristen Newton
2016-17,IND,PF,23,0,93,9,36,.250,1,12,.083,8,24,.333,.264,2,2,1.000,2,15,17,5,3,0,5,6,21,Georges Niang
2017-18,UTA,PF,9,0,32,4,11,.364,0,4,.000,4,7,.571,.364,1,2,.500,3,6,9,3,2,0,3,1,9,Georges Niang
2018-19,UTA,PF,59,0,516,86,181,.475,43,105,.410,43,76,.566,.594,20,24,.833,11,76,87,35,10,6,23,57,235,Georges Niang
2019-20,UTA,PF,66,1,923,141,322,.438,90,225,.400,51,97,.526,.578,20,24,.833,15,112,127,44,18,5,30,75,392,Georges Niang
2020-21,UTA,PF,72,10,1154,177,405,.437,124,292,.425,53,113,.469,.590,22,23,.957,28,148,176,59,25,8,51,116,500,Georges Niang
2021-22,PHI,PF,76,7,1736,246,563,.437,156,387,.403,90,176,.511,.575,52,59,.881,25,178,203,102,30,13,59,190,700,Georges Niang
2022-23,PHI,PF,78,1,1512,222,502,.442,154,384,.401,68,118,.576,.596,39,45,.867,19,166,185,77,30,14,54,145,637,Georges Niang
2023-24,CLE,PF,82,10,1831,284,632,.449,149,396,.376,135,236,.572,.567,51,60,.850,22,256,278,98,30,18,72,192,768,Georges Niang
2024-25,CLE,PF,31,1,643,102,217,.470,52,140,.371,50,77,.649,.590,11,14,.786,23,102,125,43,11,5,30,71,267,Georges Niang
2021-22,HOU,SG,24,0,261,27,67,.403,7,26,.269,20,41,.488,.455,16,30,.533,7,26,33,40,15,0,26,21,77,Daishen Nix
2022-23,HOU,PG,57,7,914,81,237,.342,40,140,.286,41,97,.423,.426,24,36,.667,18,80,98,132,31,7,86,59,226,Daishen Nix
2023-24,MIN,PG,15,0,50,9,24,.375,6,17,.353,3,7,.429,.500,3,6,.500,1,2,3,6,5,0,5,2,27,Daishen Nix
2024-25,MIN,PG,3,0,13,0,1,.000,0,1,.000,0,0,,.000,1,2,.500,0,4,4,3,0,0,4,1,1,Daishen Nix
2020-21,DEN,PF,42,1,397,50,104,.481,24,59,.407,26,45,.578,.596,12,15,.800,14,51,65,10,8,4,7,29,136,Zeke Nnaji
2021-22,DEN,PF,41,1,698,96,186,.516,37,80,.463,59,106,.557,.616,41,65,.631,56,91,147,17,16,13,23,79,270,Zeke Nnaji
2022-23,DEN,PF,53,5,728,110,196,.561,17,65,.262,93,131,.710,.605,40,62,.645,65,73,138,18,17,23,31,105,277,Zeke Nnaji
2023-24,DEN,PF,58,0,576,69,149,.463,6,23,.261,63,126,.500,.483,42,62,.677,61,65,126,32,15,38,27,81,186,Zeke Nnaji
2024-25,DEN,PF,18,0,84,10,24,.417,0,9,.000,10,15,.667,.417,1,5,.200,2,5,7,4,1,2,2,7,21,Zeke Nnaji
2014-15,PHI,C,75,71,2311,302,653,.462,0,0,,302,653,.462,.462,140,230,.609,185,426,611,128,133,142,146,208,744,Nerlens Noel
2015-16,PHI,C,67,62,1965,306,587,.521,1,2,.500,305,585,.521,.522,134,227,.590,154,388,542,122,118,100,158,192,747,Nerlens Noel
2016-17,2TM,C,51,19,1047,184,309,.595,0,1,.000,184,308,.597,.595,77,111,.694,93,201,294,50,65,50,51,126,445,Nerlens Noel
2016-17,PHI,C,29,7,564,107,175,.611,0,1,.000,107,174,.615,.611,43,63,.683,46,98,144,30,43,26,29,71,257,Nerlens Noel
2016-17,DAL,C,22,12,483,77,134,.575,0,0,,77,134,.575,.575,34,48,.708,47,103,150,20,22,24,22,55,188,Nerlens Noel
2017-18,DAL,C,30,6,472,55,105,.524,0,1,.000,55,104,.529,.524,21,28,.750,48,120,168,20,31,22,26,59,131,Nerlens Noel
2018-19,OKC,C,77,2,1055,162,276,.587,0,0,,162,276,.587,.587,54,79,.684,127,198,325,45,66,96,48,166,378,Nerlens Noel
2019-20,OKC,C,61,7,1127,184,269,.684,1,3,.333,183,266,.688,.686,80,106,.755,91,209,300,57,59,91,66,166,449,Nerlens Noel
2020-21,NYK,C,64,41,1547,137,223,.614,0,3,.000,137,220,.623,.614,50,70,.714,142,266,408,46,70,141,65,176,324,Nerlens Noel
2021-22,NYK,C,25,11,562,32,60,.533,0,3,.000,32,57,.561,.533,21,30,.700,48,93,141,23,30,31,20,67,85,Nerlens Noel
2022-23,2TM,C,17,4,195,13,36,.361,1,2,.500,12,34,.353,.375,8,12,.667,10,36,46,10,16,10,13,32,35,Nerlens Noel
2022-23,DET,C,14,3,152,12,30,.400,1,2,.500,11,28,.393,.417,7,10,.700,7,30,37,7,13,9,8,25,32,Nerlens Noel
2022-23,BRK,C,3,1,43,1,6,.167,0,0,,1,6,.167,.167,1,2,.500,3,6,9,3,3,1,5,7,3,Nerlens Noel
2019-20,MIN,SG,15,0,151,19,53,.358,3,26,.115,16,27,.593,.387,16,17,.941,3,10,13,19,3,1,3,11,57,Jaylen Nowell
2020-21,MIN,SG,42,0,759,142,335,.424,50,150,.333,92,185,.497,.499,45,55,.818,19,76,95,62,22,12,28,72,379,Jaylen Nowell
2021-22,MIN,SG,62,1,975,196,413,.475,63,160,.394,133,253,.526,.551,72,92,.783,22,101,123,130,27,10,36,73,527,Jaylen Nowell
2022-23,MIN,SG,65,2,1252,280,625,.448,67,232,.289,213,393,.542,.502,77,99,.778,36,134,170,132,42,5,65,101,704,Jaylen Nowell
2023-24,2TM,SG,13,1,214,34,78,.436,6,29,.207,28,49,.571,.474,7,9,.778,6,18,24,19,4,2,7,15,81,Jaylen Nowell
2023-24,MEM,SG,9,1,156,22,55,.400,4,23,.174,18,32,.563,.436,3,3,1.000,3,11,14,16,3,0,5,13,51,Jaylen Nowell
2023-24,DET,SG,4,0,58,12,23,.522,2,6,.333,10,17,.588,.565,4,6,.667,3,7,10,3,1,2,2,2,30,Jaylen Nowell
2024-25,NOP,SG,8,0,168,26,73,.356,8,27,.296,18,46,.391,.411,7,11,.636,6,14,20,18,1,4,8,9,67,Jaylen Nowell
2023-24,TOR,SG,1,0,4,0,1,.000,0,0,0,1,.000,.000,2,2,1.000,2,0,2,2,1,0,0,0,2,0,Markquis Nowell
2017-18,NYK,PG,78,9,1706,182,500,.364,50,157,.318,132,343,.385,.414,49,68,.721,37,140,177,250,65,18,131,181,463,Frank Ntilikina
2018-19,NYK,PG,43,16,904,95,282,.337,33,115,.287,62,167,.371,.395,23,30,.767,12,75,87,121,30,14,56,104,246,Frank Ntilikina
2019-20,NYK,PG,57,26,1187,131,333,.393,44,137,.321,87,196,.444,.459,51,59,.864,23,98,121,172,54,16,71,142,357,Frank Ntilikina
2020-21,NYK,PG,33,4,322,29,79,.367,23,48,.479,6,31,.194,.513,8,18,.444,6,25,31,19,18,4,11,45,89,Frank Ntilikina
2021-22,DAL,SG,58,5,685,89,223,.399,38,111,.342,51,112,.455,.484,24,25,.960,12,67,79,69,27,7,31,61,240,Frank Ntilikina
2022-23,DAL,SG,47,5,607,48,132,.364,17,67,.254,31,65,.477,.428,22,33,.667,7,55,62,58,16,7,29,65,135,Frank Ntilikina
2023-24,CHO,PG,5,0,43,1,9,.111,1,8,.125,0,1,.000,.167,2,2,1.000,1,5,6,4,0,0,1,4,5,Frank Ntilikina
2019-20,MIA,PG,67,67,1962,401,914,.439,137,391,.350,264,523,.505,.514,85,100,.850,21,159,180,220,56,15,114,152,1024,Kendrick Nunn
2020-21,MIA,PG,56,44,1650,319,658,.485,122,320,.381,197,338,.583,.578,56,60,.933,21,158,179,148,52,14,80,108,816,Kendrick Nunn
2022-23,2TM,SG,70,2,964,191,450,.424,79,223,.354,112,227,.493,.512,35,41,.854,15,94,109,90,28,7,66,66,496,Kendrick Nunn
2022-23,LAL,SG,39,2,528,102,251,.406,41,126,.325,61,125,.488,.488,17,21,.810,5,50,55,34,11,3,31,35,262,Kendrick Nunn
2022-23,WAS,SG,31,0,436,89,199,.447,38,97,.392,51,102,.500,.543,18,20,.900,10,44,54,56,17,4,35,31,234,Kendrick Nunn
2014-15,DEN,C,62,27,1103,171,383,.446,0,2,.000,171,381,.449,.446,84,132,.636,125,257,382,50,52,68,86,207,426,Jusuf Nurkić
2015-16,DEN,C,32,3,547,101,242,.417,0,3,.000,101,239,.423,.417,61,99,.616,65,110,175,40,24,44,55,91,263,Jusuf Nurkić
2016-17,2TM,C,65,48,1391,271,534,.507,0,1,.000,271,533,.508,.507,120,210,.571,154,313,467,123,50,74,143,161,662,Jusuf Nurkić
2016-17,DEN,C,45,29,807,151,298,.507,0,0,,151,298,.507,.507,56,113,.496,89,171,260,60,25,36,81,88,358,Jusuf Nurkić
2016-17,POR,C,20,19,584,120,236,.508,0,1,.000,120,235,.511,.508,64,97,.660,65,142,207,63,25,38,62,73,304,Jusuf Nurkić
2017-18,POR,C,79,79,2088,480,951,.505,0,7,.000,480,944,.508,.505,172,273,.630,189,519,708,143,64,111,183,247,1132,Jusuf Nurkić
2018-19,POR,C,72,72,1974,420,826,.508,3,29,.103,417,797,.523,.510,282,365,.773,243,505,748,233,71,103,168,250,1125,Jusuf Nurkić
2019-20,POR,C,8,8,253,54,109,.495,2,10,.200,52,99,.525,.505,31,35,.886,23,59,82,32,11,16,19,39,141,Jusuf Nurkić
2020-21,POR,C,37,37,880,171,333,.514,12,30,.400,159,303,.525,.532,70,113,.619,86,246,332,125,38,39,73,103,424,Jusuf Nurkić
2021-22,POR,C,56,56,1579,321,600,.535,15,56,.268,306,544,.563,.548,185,268,.690,167,452,619,157,62,34,143,189,842,Jusuf Nurkić
2022-23,POR,C,52,52,1391,262,505,.519,43,119,.361,219,386,.567,.561,127,192,.661,114,357,471,149,43,44,119,185,694,Jusuf Nurkić
2023-24,PHO,C,76,76,2078,320,627,.510,22,90,.244,298,537,.555,.528,167,261,.640,224,613,837,301,81,80,175,254,829,Jusuf Nurkić
2024-25,PHO,C,23,23,558,70,155,.452,17,56,.304,53,99,.535,.506,45,65,.692,44,175,219,43,22,15,53,70,202,Jusuf Nurkić
2016-17,LAL,SG,20,2,397,47,81,.580,1,5,.200,46,76,.605,.586,25,39,.641,17,46,63,14,13,7,11,36,120,David Nwaba
2017-18,CHI,SG,70,21,1646,202,423,.478,18,52,.346,184,371,.496,.499,133,203,.655,89,237,326,104,59,29,77,158,555,David Nwaba
2018-19,CLE,SF,51,14,984,126,262,.481,24,75,.320,102,187,.545,.527,58,85,.682,41,122,163,54,36,17,29,106,334,David Nwaba
2019-20,BRK,SF,20,0,268,37,71,.521,12,28,.429,25,43,.581,.606,18,27,.667,8,37,45,8,11,12,8,32,104,David Nwaba
2020-21,HOU,SF,30,9,679,106,218,.486,17,63,.270,89,155,.574,.525,47,68,.691,40,78,118,31,30,21,17,60,276,David Nwaba
2021-22,HOU,SF,46,4,609,85,176,.483,15,49,.306,70,127,.551,.526,48,67,.716,41,110,151,35,28,20,21,55,233,David Nwaba
2020-21,MIL,SF,30,2,274,62,135,.459,28,62,.452,34,73,.466,.563,19,25,.760,9,51,60,7,16,7,24,22,171,Jordan Nwora
2021-22,MIL,SF,62,13,1185,186,462,.403,79,227,.348,107,235,.455,.488,36,43,.837,37,184,221,59,25,17,57,78,487,Jordan Nwora
2022-23,2TM,SF,62,14,1188,194,445,.436,86,211,.408,108,234,.462,.533,68,86,.791,51,178,229,88,24,14,66,74,542,Jordan Nwora
2022-23,MIL,SF,38,3,597,76,197,.386,40,102,.392,36,95,.379,.487,37,43,.860,29,88,117,38,12,7,34,34,229,Jordan Nwora
2022-23,IND,SF,24,11,591,118,248,.476,46,109,.422,72,139,.518,.569,31,43,.721,22,90,112,50,12,7,32,40,313,Jordan Nwora
2023-24,2TM,SF,52,1,712,138,299,.462,44,131,.336,94,168,.560,.535,44,53,.830,28,121,149,62,26,13,53,48,364,Jordan Nwora
2023-24,IND,SF,18,0,183,37,82,.451,11,36,.306,26,46,.565,.518,9,11,.818,8,25,33,18,6,1,12,19,94,Jordan Nwora
2023-24,TOR,SF,34,1,529,101,217,.465,33,95,.347,68,122,.557,.541,35,42,.833,20,96,116,44,20,12,41,29,270,Jordan Nwora
2017-18,UTA,SF,69,4,1150,120,284,.423,42,118,.356,78,166,.470,.496,61,76,.803,25,211,236,95,36,16,55,105,343,Royce O'Neale
2018-19,UTA,SF,82,16,1671,163,343,.475,68,176,.386,95,167,.569,.574,32,42,.762,22,263,285,124,54,24,70,172,426,Royce O'Neale
2019-20,UTA,SF,71,62,2049,158,365,.433,92,244,.377,66,121,.545,.559,42,55,.764,27,362,389,180,59,32,61,202,450,Royce O'Neale
2020-21,UTA,SF,71,71,2241,175,394,.444,107,278,.385,68,116,.586,.580,39,46,.848,88,397,485,181,57,32,83,182,496,Royce O'Neale
2021-22,UTA,SF,77,77,2406,203,444,.457,119,306,.389,84,138,.609,.591,45,56,.804,64,304,368,191,86,32,79,183,570,Royce O'Neale
2022-23,BRK,SF,76,53,2409,229,593,.386,163,419,.389,66,174,.379,.524,50,69,.725,55,329,384,283,65,49,114,239,671,Royce O'Neale
2023-24,2TM,SF,79,14,1954,214,539,.397,156,422,.370,58,117,.496,.542,24,35,.686,60,317,377,219,59,44,73,174,608,Royce O'Neale
2023-24,BRK,SF,49,6,1202,126,325,.388,97,265,.366,29,60,.483,.537,15,22,.682,38,183,221,137,32,29,51,120,364,Royce O'Neale
2023-24,PHO,SF,30,8,752,88,214,.411,59,157,.376,29,57,.509,.549,9,13,.692,22,134,156,82,27,15,22,54,244,Royce O'Neale
2024-25,PHO,SF,30,9,805,115,254,.453,78,174,.448,37,80,.463,.606,16,21,.762,31,141,172,73,30,18,31,70,324,Royce O'Neale
2015-16,PHI,C,53,48,1591,397,781,.508,1,6,.167,396,775,.511,.509,133,194,.686,122,251,373,65,22,61,124,140,928,Jahlil Okafor
2016-17,PHI,C,50,33,1134,242,471,.514,0,0,,242,471,.514,.514,106,158,.671,81,159,240,58,20,49,91,122,590,Jahlil Okafor
2017-18,2TM,C,28,0,353,77,138,.558,1,4,.250,76,134,.567,.562,21,29,.724,21,64,85,12,3,18,21,51,176,Jahlil Okafor
2017-18,PHI,C,2,0,25,4,9,.444,0,0,,4,9,.444,.444,2,4,.500,4,5,9,1,0,2,3,7,10,Jahlil Okafor
2017-18,BRK,C,26,0,328,73,129,.566,1,4,.250,72,125,.576,.570,19,25,.760,17,59,76,11,3,16,18,44,166,Jahlil Okafor
2018-19,NOP,C,59,24,935,212,362,.586,1,5,.200,211,357,.591,.587,59,89,.663,82,196,278,40,15,40,52,96,484,Jahlil Okafor
2019-20,NOP,C,30,9,467,101,162,.623,1,3,.333,100,159,.629,.627,40,62,.645,48,79,127,37,7,22,38,67,243,Jahlil Okafor
2020-21,DET,C,27,2,347,63,102,.618,2,9,.222,61,93,.656,.627,17,24,.708,23,43,66,13,6,5,21,39,145,Jahlil Okafor
2020-21,ORL,PF,45,19,1133,135,324,.417,49,141,.348,86,183,.470,.492,30,40,.750,42,139,181,101,48,22,38,48,349,Chuma Okeke
2021-22,ORL,PF,70,20,1749,216,575,.376,118,371,.318,98,204,.480,.478,55,65,.846,47,300,347,118,97,42,57,95,605,Chuma Okeke
2022-23,ORL,SF,27,8,518,43,122,.352,26,86,.302,17,36,.472,.459,16,21,.762,26,70,96,37,19,11,17,40,128,Chuma Okeke
2023-24,ORL,SF,47,8,432,40,112,.357,23,82,.280,17,30,.567,.460,4,7,.571,18,62,80,20,9,7,16,19,107,Chuma Okeke
2018-19,MIN,SG,74,52,1757,196,508,.386,60,215,.279,136,293,.464,.445,118,162,.728,41,177,218,91,88,33,63,166,570,Josh Okogie
2019-20,MIN,SG,62,28,1547,170,398,.427,41,154,.266,129,244,.529,.479,152,191,.796,87,181,268,99,68,26,87,139,533,Josh Okogie
2020-21,MIN,SG,59,37,1197,102,254,.402,29,108,.269,73,146,.500,.459,83,108,.769,63,93,156,63,54,28,43,123,316,Josh Okogie
2021-22,MIN,SG,49,6,516,42,104,.404,14,47,.298,28,57,.491,.471,35,51,.686,29,41,70,25,26,12,23,53,133,Josh Okogie
2022-23,PHO,SG,72,26,1350,162,414,.391,66,197,.335,96,217,.442,.471,139,192,.724,109,142,251,105,56,34,63,114,529,Josh Okogie
2023-24,PHO,SG,60,11,960,86,206,.417,29,94,.309,57,112,.509,.488,76,102,.745,74,80,154,64,48,24,36,68,277,Josh Okogie
2024-25,PHO,SG,18,1,255,43,90,.478,13,33,.394,30,57,.526,.550,16,23,.696,23,29,52,10,17,5,13,17,115,Josh Okogie
2020-21,ATL,C,50,4,601,96,149,.644,0,3,.000,96,146,.658,.644,36,57,.632,62,101,163,18,23,33,29,100,228,Onyeka Okongwu
2021-22,ATL,C,48,6,992,156,226,.690,0,0,,156,226,.690,.690,80,110,.727,115,168,283,53,31,60,44,149,392,Onyeka Okongwu
2022-23,ATL,C,80,18,1849,317,497,.638,4,13,.308,313,484,.647,.642,153,196,.781,217,359,576,81,56,107,81,251,791,Onyeka Okongwu
2023-24,ATL,C,55,8,1405,223,365,.611,23,69,.333,200,296,.676,.642,92,116,.793,145,231,376,74,26,60,45,162,561,Onyeka Okongwu
2024-25,ATL,C,25,0,594,110,203,.542,10,41,.244,100,162,.617,.567,53,68,.779,63,103,166,35,17,17,21,55,283,Onyeka Okongwu
2020-21,CLE,SG,67,67,2173,235,559,.420,62,214,.290,173,345,.501,.476,114,157,.726,68,138,206,128,62,24,86,185,646,Isaac Okoro
2021-22,CLE,SF,67,61,1981,207,431,.480,55,157,.350,152,274,.555,.544,119,155,.768,72,129,201,121,56,22,58,164,588,Isaac Okoro
2022-23,CLE,SF,76,46,1652,175,354,.494,62,171,.363,113,183,.617,.582,78,103,.757,52,135,187,87,56,30,42,158,490,Isaac Okoro
2023-24,CLE,SF,69,42,1887,235,480,.490,84,215,.391,151,265,.570,.577,93,137,.679,67,139,206,132,57,34,54,140,647,Isaac Okoro
2024-25,CLE,SG,23,16,483,53,107,.495,30,61,.492,23,46,.500,.636,15,21,.714,21,31,52,40,17,10,9,47,151,Isaac Okoro
2019-20,MIA,PF,5,0,26,3,5,.600,0,1,.000,3,4,.750,.600,1,2,.500,1,4,5,1,2,1,1,2,7,KZ Okpala
2020-21,MIA,PF,37,9,447,36,96,.375,12,50,.240,24,46,.522,.438,8,15,.533,21,47,68,19,10,11,15,59,92,KZ Okpala
2021-22,MIA,PF,21,0,244,30,69,.435,9,26,.346,21,43,.488,.500,8,11,.727,11,30,41,14,4,7,5,25,77,KZ Okpala
2022-23,SAC,PF,35,3,248,16,38,.421,7,21,.333,9,17,.529,.513,7,8,.875,7,27,34,13,7,7,7,39,46,KZ Okpala
2013-14,ORL,PG,80,44,2487,392,936,.419,74,226,.327,318,710,.448,.458,248,318,.780,43,286,329,327,129,37,256,210,1106,Victor Oladipo
2014-15,ORL,SG,72,71,2573,473,1086,.436,84,248,.339,389,838,.464,.474,262,320,.819,51,251,302,295,120,19,204,187,1292,Victor Oladipo
2015-16,ORL,SG,72,52,2379,425,970,.438,98,282,.348,327,688,.475,.489,205,247,.830,48,297,345,282,116,54,153,174,1153,Victor Oladipo
2016-17,OKC,SG,67,67,2222,412,932,.442,127,352,.361,285,580,.491,.510,116,154,.753,39,252,291,176,78,21,119,155,1067,Victor Oladipo
2017-18,IND,SG,75,75,2552,640,1342,.477,161,434,.371,479,908,.528,.537,294,368,.799,47,343,390,323,177,57,219,175,1735,Victor Oladipo
2018-19,IND,SG,36,36,1147,249,588,.423,74,216,.343,175,372,.470,.486,103,141,.730,21,181,202,186,60,11,82,72,675,Victor Oladipo
2019-20,IND,SG,19,16,528,97,246,.394,33,104,.317,64,142,.451,.461,48,59,.814,9,66,75,56,17,4,47,36,275,Victor Oladipo
2020-21,3TM,SG,33,33,1080,235,576,.408,78,239,.326,157,337,.466,.476,104,138,.754,12,148,160,151,46,14,83,81,652,Victor Oladipo
2020-21,IND,SG,9,9,300,64,152,.421,25,69,.362,39,83,.470,.503,27,37,.730,1,50,51,38,15,2,18,23,180,Victor Oladipo
2020-21,HOU,SG,20,20,669,155,381,.407,49,153,.320,106,228,.465,.471,65,83,.783,8,87,95,99,24,10,51,45,424,Victor Oladipo
2020-21,MIA,SG,4,4,111,16,43,.372,4,17,.235,12,26,.462,.419,12,18,.667,3,11,14,14,7,2,14,13,48,Victor Oladipo
2021-22,MIA,SG,8,1,173,35,73,.479,15,36,.417,20,37,.541,.582,14,19,.737,3,20,23,28,5,1,16,13,99,Victor Oladipo
2022-23,MIA,SG,42,2,1106,160,403,.397,70,212,.330,90,191,.471,.484,59,79,.747,16,112,128,146,57,12,87,99,449,Victor Oladipo
2024-25,LAL,PG,1,0,8,1,3,.333,1,3,.333,0,0,.500,0,0,0,0,0,0,0,0,1,0,3,0,,Quincy Olivari
2020-21,HOU,SF,4,0,87,19,33,.576,4,13,.308,15,20,.750,.636,1,4,.250,5,16,21,5,2,4,3,11,43,Cameron Oliver
2021-22,ATL,SF,2,0,43,10,15,.667,1,3,.333,9,12,.750,.700,2,3,.667,2,4,6,3,1,1,0,5,23,Cameron Oliver
2013-14,BOS,C,70,9,1400,234,502,.466,40,114,.351,194,388,.500,.506,99,122,.811,140,225,365,109,35,27,106,227,607,Kelly Olynyk
2014-15,BOS,C,64,13,1423,251,528,.475,61,175,.349,190,353,.538,.533,93,136,.684,92,211,303,109,64,39,98,213,656,Kelly Olynyk
2015-16,BOS,C,69,8,1395,253,556,.455,85,210,.405,168,346,.486,.531,96,128,.750,72,209,281,105,52,33,74,163,687,Kelly Olynyk
2016-17,BOS,C,75,6,1538,260,508,.512,68,192,.354,192,316,.608,.579,90,123,.732,73,288,361,148,43,29,96,207,678,Kelly Olynyk
2017-18,MIA,PF,76,22,1779,316,636,.497,106,280,.379,210,356,.590,.580,134,174,.770,89,342,431,207,62,35,147,222,872,Kelly Olynyk
2018-19,MIA,PF,79,36,1812,261,564,.463,113,319,.354,148,245,.604,.563,152,185,.822,72,303,375,140,53,37,114,183,787,Kelly Olynyk
2019-20,MIA,C,67,9,1300,184,398,.462,95,234,.406,89,164,.543,.582,86,100,.860,44,261,305,116,45,23,71,173,549,Kelly Olynyk
2020-21,2TM,PF,70,62,1997,337,697,.484,126,368,.342,211,329,.641,.574,145,175,.829,87,402,489,203,79,42,126,207,945,Kelly Olynyk
2020-21,MIA,C,43,38,1157,162,376,.431,77,243,.317,85,133,.639,.533,31,40,.775,44,217,261,91,40,26,55,123,432,Kelly Olynyk
2020-21,HOU,PF,27,24,840,175,321,.545,49,125,.392,126,196,.643,.621,114,135,.844,43,185,228,112,39,16,71,84,513,Kelly Olynyk
2021-22,DET,C,40,1,764,128,286,.448,40,119,.336,88,167,.527,.517,69,89,.775,54,123,177,111,31,19,58,100,365,Kelly Olynyk
2022-23,UTA,C,68,68,1942,278,557,.499,93,236,.394,185,321,.576,.583,198,232,.853,82,338,420,252,60,37,168,232,847,Kelly Olynyk
2023-24,2TM,C,78,27,1759,276,497,.555,60,155,.387,216,342,.632,.616,150,180,.833,108,303,411,347,74,30,152,230,762,Kelly Olynyk
2023-24,UTA,C,50,8,1019,145,258,.562,36,84,.429,109,174,.626,.632,80,95,.842,63,191,254,219,37,12,81,132,406,Kelly Olynyk
2023-24,TOR,C,28,19,740,131,239,.548,24,71,.338,107,168,.637,.598,70,85,.824,45,112,157,128,37,18,71,98,356,Kelly Olynyk
2024-25,TOR,C,8,1,138,21,48,.438,9,19,.474,12,29,.414,.531,11,14,.786,7,31,38,21,9,2,15,23,62,Kelly Olynyk
2021-22,DAL,SF,4,0,18,2,5,.400,1,2,.500,1,3,.333,.500,2,4,.500,2,5,7,2,0,0,0,2,7,Eugene Omoruyi
2022-23,2TM,SF,40,6,645,101,228,.443,25,89,.281,76,139,.547,.498,51,75,.680,43,68,111,28,28,3,34,91,278,Eugene Omoruyi
2022-23,OKC,SF,23,2,272,44,94,.468,8,31,.258,36,63,.571,.511,17,28,.607,22,30,52,11,14,0,16,46,113,Eugene Omoruyi
2022-23,DET,SF,17,4,373,57,134,.425,17,58,.293,40,76,.526,.489,34,47,.723,21,38,59,17,14,3,18,45,165,Eugene Omoruyi
2023-24,WAS,SF,43,0,393,81,167,.485,13,46,.283,68,121,.562,.524,32,49,.653,35,50,85,35,27,5,21,62,207,Eugene Omoruyi
2019-20,UTA,SF,10,1,109,12,32,.375,7,19,.368,5,13,.385,.484,4,5,.800,5,12,17,4,4,2,4,9,35,Miye Oni
2020-21,UTA,SG,54,0,519,35,99,.354,30,88,.341,5,11,.455,.505,5,6,.833,23,61,84,28,11,8,16,61,105,Miye Oni
2021-22,UTA,SG,16,0,44,2,9,.222,1,8,.125,1,1,1.000,.278,0,1,.000,1,6,7,5,0,0,1,7,5,Miye Oni
2017-18,CLE,SF,61,12,672,90,186,.484,32,87,.368,58,99,.586,.570,26,46,.565,19,101,120,41,22,3,32,78,238,Cedi Osman
2018-19,CLE,SF,76,75,2444,360,844,.427,130,374,.348,230,470,.489,.504,141,181,.779,45,312,357,195,60,11,114,195,991,Cedi Osman
2019-20,CLE,SF,65,65,1910,266,609,.437,123,321,.383,143,288,.497,.538,63,94,.670,39,192,231,154,54,16,91,160,718,Cedi Osman
2020-21,CLE,SF,59,26,1510,219,586,.374,99,324,.306,120,262,.458,.458,76,95,.800,38,163,201,174,53,9,80,119,613,Cedi Osman
2021-22,CLE,SF,66,3,1462,247,572,.432,128,359,.357,119,213,.559,.544,87,131,.664,25,121,146,135,52,10,67,127,709,Cedi Osman
2022-23,CLE,SF,77,2,1548,239,530,.451,116,312,.372,123,218,.564,.560,75,108,.694,25,151,176,115,35,11,52,122,669,Cedi Osman
2023-24,SAS,SF,72,3,1269,184,384,.479,86,221,.389,98,163,.601,.591,35,52,.673,25,155,180,119,36,11,47,107,489,Cedi Osman
2020-21,LAC,C,30,0,161,22,52,.423,1,5,.200,21,47,.447,.433,9,12,.750,21,27,48,10,4,7,9,24,54,Daniel Oturu
2021-22,TOR,C,3,0,27,3,6,.500,0,1,.000,3,5,.600,.500,3,5,.600,1,4,5,0,0,2,0,1,9,Daniel Oturu
2015-16,WAS,SF,63,9,671,90,211,.427,25,79,.316,65,132,.492,.486,31,49,.633,25,108,133,13,22,7,34,100,236,Kelly Oubre Jr.
2016-17,WAS,SF,79,5,1605,186,442,.421,54,188,.287,132,254,.520,.482,75,99,.758,61,200,261,47,58,17,50,195,501,Kelly Oubre Jr.
2017-18,WAS,SF,81,11,2231,318,790,.403,126,369,.341,192,421,.456,.482,191,233,.820,59,304,363,98,80,35,90,234,953,Kelly Oubre Jr.
2018-19,2TM,SF,69,19,1935,375,842,.445,108,338,.320,267,504,.530,.510,189,244,.775,71,254,325,84,84,59,103,181,1047,Kelly Oubre Jr.
2018-19,WAS,SF,29,7,755,132,305,.433,41,132,.311,91,173,.526,.500,68,85,.800,24,105,129,20,27,20,30,71,373,Kelly Oubre Jr.
2018-19,PHO,SF,40,12,1180,243,537,.453,67,206,.325,176,331,.532,.515,121,159,.761,47,149,196,64,57,39,73,110,674,Kelly Oubre Jr.
2019-20,PHO,SF,56,55,1933,373,826,.452,108,307,.352,265,519,.511,.517,192,246,.780,67,294,361,85,71,40,83,192,1046,Kelly Oubre Jr.
2020-21,GSW,SF,55,50,1687,318,724,.439,90,285,.316,228,439,.519,.501,123,177,.695,82,247,329,73,57,42,70,121,849,Kelly Oubre Jr.
2021-22,CHO,SF,76,13,1999,410,932,.440,191,553,.345,219,379,.578,.542,126,189,.667,79,223,302,84,77,31,67,189,1137,Kelly Oubre Jr.
2022-23,CHO,SF,48,40,1548,353,819,.431,108,339,.319,245,480,.510,.497,158,208,.760,65,184,249,54,68,18,64,141,972,Kelly Oubre Jr.
2023-24,PHI,SF,68,52,2055,387,878,.441,101,325,.311,286,553,.517,.498,174,232,.750,94,247,341,101,77,47,87,194,1049,Kelly Oubre Jr.
2024-25,PHI,SF,28,25,905,138,306,.451,37,123,.301,101,183,.552,.511,46,65,.708,44,119,163,42,33,15,35,77,359,Kelly Oubre Jr.
2021-22,DET,SG,1,0,17,0,1,.000,0,0,0,1,.000,.000,0,0,0,2,2,0,0,0,1,2,0,0,,Trayvon Palmer
2011-12,MEM,PG,44,5,424,50,150,.333,10,38,.263,40,112,.357,.367,16,27,.593,12,25,37,55,15,0,46,46,126,Jeremy Pargo
2012-13,2TM,PG,39,11,655,99,250,.396,25,74,.338,74,176,.420,.446,42,62,.677,8,41,49,92,13,2,50,46,265,Jeremy Pargo
2012-13,CLE,PG,25,11,447,75,187,.401,18,57,.316,57,130,.438,.449,28,41,.683,7,25,32,64,12,2,37,32,196,Jeremy Pargo
2012-13,PHI,SG,14,0,208,24,63,.381,7,17,.412,17,46,.370,.437,14,21,.667,1,16,17,28,1,0,13,14,69,Jeremy Pargo
2019-20,GSW,PG,3,0,44,11,22,.500,3,7,.429,8,15,.533,.568,0,1,.000,1,2,3,8,1,0,4,8,25,Jeremy Pargo
2019-20,GSW,PF,60,26,1654,318,640,.497,37,129,.287,281,511,.550,.526,164,212,.774,82,193,275,127,32,13,94,125,837,Eric Paschall
2020-21,GSW,PF,40,2,695,148,298,.497,18,54,.333,130,244,.533,.527,67,94,.713,28,100,128,51,12,7,43,68,381,Eric Paschall
2021-22,UTA,PF,58,3,737,114,235,.485,40,108,.370,74,127,.583,.570,66,86,.767,30,76,106,36,9,5,27,51,334,Eric Paschall
2005-06,NOK,PG,78,78,2808,407,947,.430,50,177,.282,357,770,.464,.456,394,465,.847,61,339,400,611,175,6,183,218,1258,Chris Paul
2006-07,NOK,PG,64,64,2353,381,871,.437,50,143,.350,331,728,.455,.466,292,357,.818,54,226,280,569,118,3,161,154,1104,Chris Paul
2007-08,NOH,PG,80,80,3006,630,1291,.488,92,249,.369,538,1042,.516,.524,332,390,.851,62,259,321,925,217,4,201,185,1684,Chris Paul
2008-09,NOH,PG,78,78,3002,631,1255,.503,64,176,.364,567,1079,.525,.528,455,524,.868,69,363,432,861,216,10,231,212,1781,Chris Paul
2009-10,NOH,PG,45,45,1712,314,637,.493,52,127,.409,262,510,.514,.534,161,190,.847,20,171,191,480,96,8,112,118,841,Chris Paul
2010-11,NOH,PG,80,80,2880,430,928,.463,71,183,.388,359,745,.482,.502,337,384,.878,38,289,327,782,188,5,177,196,1268,Chris Paul
2011-12,LAC,PG,60,60,2181,425,890,.478,79,213,.371,346,677,.511,.522,260,302,.861,42,171,213,543,152,4,124,138,1189,Chris Paul
2012-13,LAC,PG,70,70,2335,412,856,.481,76,232,.328,336,624,.538,.526,286,323,.885,53,209,262,678,169,10,159,143,1186,Chris Paul
2013-14,LAC,PG,62,62,2171,406,870,.467,78,212,.368,328,658,.498,.511,295,345,.855,38,230,268,663,154,4,145,157,1185,Chris Paul
2014-15,LAC,PG,82,82,2857,568,1170,.485,139,349,.398,429,821,.523,.545,289,321,.900,52,324,376,838,156,15,190,203,1564,Chris Paul
2015-16,LAC,PG,74,74,2420,515,1114,.462,122,329,.371,393,785,.501,.517,294,328,.896,39,271,310,738,152,13,194,185,1446,Chris Paul
2016-17,LAC,PG,61,61,1921,374,785,.476,124,302,.411,250,483,.518,.555,232,260,.892,40,264,304,563,119,8,147,146,1104,Chris Paul
2017-18,HOU,PG,58,58,1847,367,798,.460,144,379,.380,223,419,.532,.550,203,221,.919,37,276,313,457,96,14,128,141,1081,Chris Paul
2018-19,HOU,PG,58,58,1857,302,720,.419,127,355,.358,175,365,.479,.508,175,203,.862,36,229,265,473,114,18,152,146,906,Chris Paul
2019-20,OKC,PG,70,70,2208,434,887,.489,111,304,.365,323,583,.554,.552,253,279,.907,26,323,349,472,111,11,161,158,1232,Chris Paul
2020-21,PHO,PG,70,70,2199,439,879,.499,102,258,.395,337,621,.543,.557,169,181,.934,25,287,312,622,99,19,156,166,1149,Chris Paul
2021-22,PHO,PG,65,65,2139,363,736,.493,63,199,.317,300,537,.559,.536,169,202,.837,22,261,283,702,121,20,153,134,958,Chris Paul
2022-23,PHO,PG,59,59,1889,294,668,.440,98,261,.375,196,407,.482,.513,133,160,.831,27,224,251,524,91,22,114,126,819,Chris Paul
2023-24,GSW,PG,58,18,1531,206,467,.441,78,210,.371,128,257,.498,.525,43,52,.827,18,207,225,393,70,6,76,108,533,Chris Paul
2024-25,SAS,PG,31,31,896,100,234,.427,55,151,.364,45,83,.542,.545,43,44,.977,15,112,127,255,43,6,58,57,298,Chris Paul
2015-16,OKC,PG,57,1,698,114,278,.410,36,111,.324,78,167,.467,.475,19,24,.792,9,76,85,108,36,6,44,80,283,Cameron Payne
2016-17,2TM,PG,31,0,462,64,193,.332,27,86,.314,37,107,.346,.402,5,8,.625,3,45,48,55,14,4,29,52,160,Cameron Payne
2016-17,OKC,PG,20,0,320,43,130,.331,16,52,.308,27,78,.346,.392,4,4,1.000,2,29,31,40,10,4,16,38,106,Cameron Payne
2016-17,CHI,PG,11,0,142,21,63,.333,11,34,.324,10,29,.345,.421,1,4,.250,1,16,17,15,4,0,13,14,54,Cameron Payne
2017-18,CHI,PG,25,14,582,87,215,.405,35,91,.385,52,124,.419,.486,12,16,.750,18,51,69,113,26,9,36,44,221,Cameron Payne
2018-19,2TM,PG,40,13,712,96,223,.430,25,84,.298,71,139,.511,.487,33,41,.805,13,59,72,106,28,9,45,64,250,Cameron Payne
2018-19,CHI,PG,31,12,536,69,168,.411,16,59,.271,53,109,.486,.458,22,25,.880,10,43,53,83,20,6,34,49,176,Cameron Payne
2018-19,CLE,PG,9,1,176,27,55,.491,9,25,.360,18,30,.600,.573,11,16,.688,3,16,19,23,8,3,11,15,74,Cameron Payne
2019-20,PHO,SG,8,0,183,33,68,.485,15,29,.517,18,39,.462,.596,6,7,.857,4,27,31,24,8,2,11,20,87,Cameron Payne
2020-21,PHO,PG,60,1,1079,191,395,.484,73,166,.440,118,229,.515,.576,50,56,.893,16,128,144,217,36,16,60,97,505,Cameron Payne
2021-22,PHO,PG,58,12,1278,240,587,.409,71,211,.336,169,376,.449,.469,75,89,.843,24,151,175,282,40,17,103,119,626,Cameron Payne
2022-23,PHO,PG,48,15,968,188,453,.415,68,185,.368,120,268,.448,.490,49,64,.766,12,94,106,214,33,8,81,88,493,Cameron Payne
2023-24,2TM,PG,78,10,1304,208,481,.432,104,267,.390,104,214,.486,.541,58,67,.866,21,96,117,205,42,11,66,126,578,Cameron Payne
2023-24,MIL,PG,47,2,702,101,222,.455,52,131,.397,49,91,.538,.572,37,44,.841,5,57,62,109,22,3,31,73,291,Cameron Payne
2023-24,PHI,PG,31,8,602,107,259,.413,52,136,.382,55,123,.447,.514,21,23,.913,16,39,55,96,20,8,35,53,287,Cameron Payne
2024-25,NYK,PG,25,0,396,68,155,.439,39,96,.406,29,59,.492,.565,10,12,.833,7,34,41,70,14,8,13,48,185,Cameron Payne
2014-15,ORL,PG,82,63,2489,301,708,.425,11,42,.262,290,666,.435,.433,118,214,.551,107,242,349,533,142,20,203,193,731,Elfrid Payton
2015-16,ORL,PG,73,69,2145,318,730,.436,30,92,.326,288,638,.451,.456,112,190,.589,77,184,261,468,89,20,177,159,778,Elfrid Payton
2016-17,ORL,PG,82,58,2412,430,912,.471,40,146,.274,390,766,.509,.493,146,211,.692,89,298,387,529,88,40,178,177,1046,Elfrid Payton
2017-18,2TM,PG,63,63,1808,329,667,.493,30,92,.326,299,575,.520,.516,109,168,.649,64,210,274,393,83,22,168,147,797,Elfrid Payton
2017-18,ORL,PG,44,44,1257,238,458,.520,25,67,.373,213,391,.545,.547,72,114,.632,47,127,174,275,64,16,114,97,573,Elfrid Payton
2017-18,PHO,PG,19,19,551,91,209,.435,5,25,.200,86,184,.467,.447,37,54,.685,17,83,100,118,19,6,54,50,224,Elfrid Payton
2018-19,NOP,PG,42,42,1250,179,412,.434,33,105,.314,146,307,.476,.475,55,74,.743,49,171,220,320,44,17,112,81,446,Elfrid Payton
2019-20,NYK,PG,45,36,1246,193,440,.439,14,69,.203,179,371,.482,.455,49,86,.570,52,160,212,323,70,17,96,89,449,Elfrid Payton
2020-21,NYK,PG,63,63,1484,269,622,.432,28,98,.286,241,524,.460,.455,73,107,.682,64,152,216,203,47,9,103,116,639,Elfrid Payton
2021-22,PHO,PG,50,1,549,67,175,.383,4,18,.222,63,157,.401,.394,12,32,.375,21,67,88,99,25,6,47,38,150,Elfrid Payton
,,,,,,,,,,,,,,,,,,,,,,,,,,,,Elfrid Payton
2024-25,NOP,PG,7,3,144,23,46,.500,0,1,.000,23,45,.511,.500,1,2,.500,5,19,24,48,10,3,20,10,47,Elfrid Payton
2016-17,MIL,PG,6,0,99,8,22,.364,1,9,.111,7,13,.538,.386,3,5,.600,0,12,12,13,3,4,10,9,20,Gary Payton II
2017-18,2TM,PG,23,6,221,30,74,.405,6,25,.240,24,49,.490,.446,3,9,.333,13,31,44,21,7,3,7,30,69,Gary Payton II
2017-18,MIL,PG,12,6,106,13,33,.394,2,12,.167,11,21,.524,.424,2,3,.667,4,13,17,9,3,1,3,17,30,Gary Payton II
2017-18,LAL,PG,11,0,115,17,41,.415,4,13,.308,13,28,.464,.463,1,6,.167,9,18,27,12,4,2,4,13,39,Gary Payton II
2018-19,WAS,PG,3,0,16,5,8,.625,1,2,.500,4,6,.667,.688,0,0,,1,1,2,4,3,1,1,2,11,Gary Payton II
2019-20,WAS,SF,29,17,432,48,116,.414,13,46,.283,35,70,.500,.470,4,8,.500,26,54,80,48,33,7,20,54,113,Gary Payton II
2020-21,GSW,PG,10,0,40,10,13,.769,2,4,.500,8,9,.889,.846,3,4,.750,2,9,11,1,6,1,1,8,25,Gary Payton II
2021-22,GSW,SG,71,16,1248,212,344,.616,43,120,.358,169,224,.754,.679,35,58,.603,72,175,247,64,96,22,40,131,502,Gary Payton II
2022-23,2TM,SG,22,1,367,41,69,.594,13,26,.500,28,43,.651,.688,6,7,.857,24,45,69,30,22,5,16,43,101,Gary Payton II
2022-23,POR,SG,15,1,255,24,41,.585,9,17,.529,15,24,.625,.695,4,4,1.000,10,29,39,22,16,1,12,29,61,Gary Payton II
2022-23,GSW,SG,7,0,112,17,28,.607,4,9,.444,13,19,.684,.679,2,3,.667,14,16,30,8,6,4,4,14,40,Gary Payton II
2023-24,GSW,SG,44,0,680,103,183,.563,20,55,.364,83,128,.648,.617,14,23,.609,46,67,113,48,39,18,27,77,240,Gary Payton II
2024-25,GSW,SG,28,4,368,58,106,.547,5,32,.156,53,74,.716,.571,9,15,.600,33,45,78,34,20,10,14,40,130,Gary Payton II
2019-20,PHI,C,24,0,232,25,48,.521,0,1,.000,25,47,.532,.521,7,14,.500,20,52,72,8,3,31,18,55,57,Norvel Pelle
2020-21,3TM,C,13,0,84,8,15,.533,0,0,,8,15,.533,.533,4,6,.667,6,13,19,2,1,9,3,14,20,Norvel Pelle
2020-21,BRK,C,3,0,28,3,7,.429,0,0,,3,7,.429,.429,0,0,,3,4,7,0,0,3,3,9,6,Norvel Pelle
2020-21,SAC,C,1,0,4,0,1,.000,0,0,,0,1,.000,.000,3,4,.750,1,0,1,1,0,0,0,1,3,Norvel Pelle
2020-21,NYK,C,9,0,52,5,7,.714,0,0,,5,7,.714,.714,1,2,.500,2,9,11,1,1,6,0,4,11,Norvel Pelle
2021-22,UTA,C,3,0,19,3,5,.600,0,0,,3,5,.600,.600,0,0,,3,3,6,0,0,1,2,1,6,Norvel Pelle
2023-24,MEM,SF,7,1,122,18,35,.514,5,13,.385,13,22,.591,.586,7,10,.700,11,26,37,2,6,4,5,10,48,Mãozinha Pereira
2020-21,BRK,PF,26,0,211,32,78,.410,4,21,.190,28,57,.491,.436,10,13,.769,27,46,73,14,6,6,15,40,78,Reggie Perry
2021-22,2TM,PF,10,1,187,40,79,.506,3,16,.188,37,63,.587,.525,9,15,.600,15,32,47,12,9,6,11,33,92,Reggie Perry
2021-22,POR,PF,9,1,177,39,78,.500,3,16,.188,36,62,.581,.519,9,15,.600,15,31,46,12,9,6,11,30,90,Reggie Perry
2021-22,IND,PF,1,0,10,1,1,1.000,0,0,,1,1,1.000,1.000,0,0,,0,1,1,0,0,0,0,3,2,Reggie Perry
2023-24,BOS,PF,3,0,23,4,6,.667,3,5,.600,1,1,1.000,.917,0,0,,0,1,1,1,2,0,1,1,11,Drew Peterson
2024-25,BOS,PF,8,0,89,6,16,.375,5,14,.357,1,2,.500,.531,6,7,.857,5,13,18,5,2,2,4,10,23,Drew Peterson
2023-24,2TM,C,3,0,10,1,2,.500,0,0,1,2,.500,.500,1,2,.500,0,1,1,0,0,0,0,1,3,0,Filip Petrušev
2023-24,PHI,C,1,0,3,0,0,,0,0,0,0,,,0,0,,0,1,1,0,0,0,0,0,0,0,Filip Petrušev
2023-24,SAC,C,2,0,7,1,2,.500,0,0,1,2,.500,.500,1,2,.500,0,0,0,0,0,0,0,1,3,0,Filip Petrušev
2023-24,CHI,SF,40,0,323,32,77,.416,12,38,.316,20,39,.513,.494,13,19,.684,12,24,36,13,7,7,10,40,89,Julian Phillips
2024-25,CHI,SF,30,2,429,52,123,.423,24,75,.320,28,48,.583,.520,18,28,.643,27,37,64,15,18,8,13,48,146,Julian Phillips
2023-24,DEN,SG,27,0,122,15,35,.429,9,25,.360,6,10,.600,.557,3,4,.750,1,13,14,21,4,0,9,13,42,Jalen Pickett
2024-25,DEN,SG,7,0,66,7,16,.438,5,12,.417,2,4,.500,.594,0,0,,1,7,8,17,1,1,4,6,19,Jalen Pickett
2021-22,DET,PF,13,0,176,18,50,.360,13,39,.333,5,11,.455,.490,1,2,.500,6,26,32,7,0,7,5,12,50,Jamorko Pickett
2018-19,BRK,SG,18,0,211,25,73,.342,12,46,.261,13,27,.481,.425,19,22,.864,4,32,36,21,6,0,18,15,81,Theo Pinson
2019-20,BRK,SG,33,0,365,45,155,.290,15,80,.188,30,75,.400,.339,15,16,.938,10,44,54,56,17,4,33,35,120,Theo Pinson
2020-21,NYK,SG,17,0,34,1,9,.111,0,8,.000,1,1,1.000,.111,0,0,,0,5,5,1,0,0,1,4,2,Theo Pinson
2021-22,DAL,SF,19,0,148,14,39,.359,10,30,.333,4,9,.444,.487,10,10,1.000,2,19,21,17,5,2,5,12,48,Theo Pinson
2022-23,DAL,SG,40,1,323,31,87,.356,22,62,.355,9,25,.360,.483,11,13,.846,10,53,63,46,6,1,12,34,95,Theo Pinson
2022-23,LAL,PG,6,0,32,4,12,.333,1,3,.333,3,9,.333,.375,5,9,.556,2,2,4,2,2,1,2,3,14,Scotty Pippen Jr.
2023-24,MEM,PG,21,16,527,100,203,.493,30,72,.417,70,131,.534,.567,41,55,.745,22,45,67,98,36,10,56,60,271,Scotty Pippen Jr.
2024-25,MEM,PG,32,11,719,133,280,.475,36,99,.364,97,181,.536,.539,46,68,.676,21,91,112,161,34,11,65,79,348,Scotty Pippen Jr.
2013-14,BRK,C,70,22,1275,199,302,.659,0,3,.000,199,299,.666,.659,122,195,.626,99,209,308,60,49,55,77,171,520,Mason Plumlee
2014-15,BRK,C,82,45,1743,280,489,.573,0,3,.000,280,486,.576,.573,157,317,.495,175,337,512,74,65,63,106,207,717,Mason Plumlee
2015-16,POR,C,82,82,2084,267,517,.516,0,4,.000,267,513,.520,.516,215,335,.642,201,427,628,226,68,85,154,253,749,Mason Plumlee
2016-17,2TM,C,81,64,2148,334,623,.536,0,6,.000,334,617,.541,.536,174,300,.580,170,435,605,284,69,92,134,226,842,Mason Plumlee
2016-17,POR,C,54,54,1516,235,442,.532,0,5,.000,235,437,.538,.532,127,224,.567,120,312,432,214,50,63,88,149,597,Mason Plumlee
2016-17,DEN,C,27,10,632,99,181,.547,0,1,.000,99,180,.550,.547,47,76,.618,50,123,173,70,19,29,46,77,245,Mason Plumlee
2017-18,DEN,C,74,26,1439,221,368,.601,0,1,.000,221,367,.602,.601,82,179,.458,132,268,400,142,49,81,103,184,524,Mason Plumlee
2018-19,DEN,C,82,17,1731,262,442,.593,2,10,.200,260,432,.602,.595,111,198,.561,165,359,524,243,66,76,126,252,637,Mason Plumlee
2019-20,DEN,C,61,1,1057,177,288,.615,0,5,.000,177,283,.625,.615,83,155,.535,98,219,317,154,33,38,82,143,437,Mason Plumlee
2020-21,DET,C,56,56,1499,234,381,.614,0,7,.000,234,374,.626,.614,113,169,.669,145,374,519,202,43,50,105,186,581,Mason Plumlee
2021-22,CHO,C,73,73,1793,205,320,.641,0,2,.000,205,318,.645,.641,67,171,.392,176,389,565,226,61,52,100,224,477,Mason Plumlee
2022-23,2TM,C,79,60,2054,329,484,.680,0,0,,329,484,.680,.680,199,313,.636,229,471,700,245,46,47,117,217,857,Mason Plumlee
2022-23,CHO,C,56,56,1597,265,396,.669,0,0,,265,396,.669,.669,155,256,.605,187,354,541,205,35,35,87,161,685,Mason Plumlee
2022-23,LAC,C,23,4,457,64,88,.727,0,0,,64,88,.727,.727,44,57,.772,42,117,159,40,11,12,30,56,172,Mason Plumlee
2023-24,LAC,C,46,11,674,87,153,.569,0,6,.000,87,147,.592,.569,70,99,.707,60,174,234,55,14,17,36,68,244,Mason Plumlee
2024-25,PHO,C,29,7,490,44,79,.557,0,1,.000,44,78,.564,.557,31,53,.585,46,128,174,48,9,20,24,58,119,Mason Plumlee
2023-24,GSW,SG,74,28,1968,271,597,.454,90,234,.385,181,363,.499,.529,50,79,.633,118,309,427,273,61,14,88,122,682,Brandin Podziemski
2024-25,GSW,SG,29,8,714,93,229,.406,31,105,.295,62,124,.500,.474,22,30,.733,30,103,133,96,29,7,30,44,239,Brandin Podziemski
2016-17,TOR,C,54,4,626,67,115,.583,0,0,,67,115,.583,.583,31,57,.544,78,87,165,12,17,20,29,113,165,Jakob Poeltl
2017-18,TOR,C,82,0,1524,253,384,.659,1,2,.500,252,382,.660,.660,60,101,.594,165,228,393,57,39,100,85,212,567,Jakob Poeltl
2018-19,SAS,C,77,24,1273,187,290,.645,0,0,,187,290,.645,.645,49,92,.533,178,232,410,93,29,68,48,124,423,Jakob Poeltl
2019-20,SAS,C,66,18,1171,166,266,.624,0,0,,166,266,.624,.624,40,86,.465,131,244,375,116,37,95,54,126,372,Jakob Poeltl
2020-21,SAS,C,69,51,1845,265,430,.616,0,0,,265,430,.616,.616,63,124,.508,219,328,547,134,47,123,83,172,593,Jakob Poeltl
2021-22,SAS,C,68,67,1970,410,663,.618,1,1,1.000,409,662,.618,.619,94,190,.495,262,372,634,189,45,118,109,212,915,Jakob Poeltl
2022-23,2TM,C,72,71,1906,389,618,.629,0,1,.000,389,617,.630,.629,119,201,.592,236,417,653,197,66,86,125,195,897,Jakob Poeltl
2022-23,SAS,C,46,46,1199,239,388,.616,0,1,.000,239,387,.618,.616,78,129,.605,152,264,416,141,36,52,96,118,556,Jakob Poeltl
2022-23,TOR,C,26,25,707,150,230,.652,0,0,,150,230,.652,.652,41,72,.569,84,153,237,56,30,34,29,77,341,Jakob Poeltl
2023-24,TOR,C,50,50,1319,248,378,.656,0,0,,248,378,.656,.656,59,107,.551,146,283,429,127,35,76,77,149,555,Jakob Poeltl
2024-25,TOR,C,26,25,835,172,292,.589,0,2,.000,172,290,.593,.589,60,88,.682,102,185,287,71,29,32,56,92,404,Jakob Poeltl
2020-21,OKC,PF,45,28,1090,139,408,.341,58,207,.280,81,201,.403,.412,31,42,.738,30,182,212,97,20,42,99,58,367,Aleksej Pokusevski
2021-22,OKC,PF,61,12,1233,186,456,.408,57,197,.289,129,259,.498,.470,35,50,.700,73,245,318,131,39,38,94,88,464,Aleksej Pokusevski
2022-23,OKC,PF,34,25,701,108,249,.434,38,104,.365,70,145,.483,.510,22,35,.629,45,114,159,64,20,43,43,58,276,Aleksej Pokusevski
2023-24,2TM,PF,28,0,405,49,121,.405,18,55,.327,31,66,.470,.479,30,41,.732,17,72,89,35,15,13,19,22,146,Aleksej Pokusevski
2023-24,OKC,PF,10,0,60,4,16,.250,2,11,.182,2,5,.400,.313,2,4,.500,2,8,10,5,1,1,3,5,12,Aleksej Pokusevski
2023-24,CHO,PF,18,0,345,45,105,.429,16,44,.364,29,61,.475,.505,28,37,.757,15,64,79,30,14,12,16,17,134,Aleksej Pokusevski
2019-20,TOR,PG,4,0,11,3,5,.600,1,2,.500,2,3,.667,.700,2,2,1.000,0,1,1,2,0,1,0,2,9,Shamorie Ponds
2021-22,MEM,SF,12,0,71,5,16,.313,3,9,.333,2,7,.286,.406,0,2,.000,5,7,12,1,1,4,1,6,13,Yves Pons
2019-20,GSW,SG,57,14,1274,167,502,.333,74,265,.279,93,237,.392,.406,95,119,.798,9,109,118,134,35,10,74,94,503,Jordan Poole
2020-21,GSW,SG,51,7,988,205,474,.432,97,276,.351,108,198,.545,.535,105,119,.882,15,77,92,99,26,9,51,86,612,Jordan Poole
2021-22,GSW,SG,76,51,2283,474,1058,.448,211,580,.364,263,478,.550,.548,246,266,.925,34,226,260,304,60,23,187,206,1405,Jordan Poole
2022-23,GSW,PG,82,43,2458,550,1278,.430,214,637,.336,336,641,.524,.514,361,415,.870,32,193,225,369,63,21,252,214,1675,Jordan Poole
2023-24,WAS,SG,78,66,2346,490,1186,.413,184,564,.326,306,622,.492,.491,192,219,.877,32,180,212,343,86,25,188,244,1356,Jordan Poole
2024-25,WAS,SG,26,26,821,179,414,.432,92,226,.407,87,188,.463,.543,105,125,.840,9,60,69,130,42,14,92,88,555,Jordan Poole
2023-24,CLE,PG,51,6,649,116,228,.509,12,34,.353,104,194,.536,.535,41,56,.732,21,88,109,118,21,15,45,40,285,Craig Porter Jr.
2024-25,CLE,PG,18,0,164,19,34,.559,5,11,.455,14,23,.609,.632,3,5,.600,2,14,16,24,5,6,9,8,46,Craig Porter Jr.
2020-21,MEM,PF,11,0,54,8,15,.533,3,8,.375,5,7,.714,.633,3,5,.600,4,10,14,1,3,1,7,12,22,Jontay Porter
2023-24,TOR,PF,26,5,360,40,104,.385,20,60,.333,20,44,.455,.481,15,18,.833,26,56,82,60,20,20,21,35,115,Jontay Porter
2019-20,CLE,SF,50,3,1162,186,421,.442,53,158,.335,133,263,.506,.505,73,101,.723,22,140,162,109,46,14,93,135,498,Kevin Porter Jr.
2020-21,HOU,SG,26,23,835,156,367,.425,50,161,.311,106,206,.515,.493,69,94,.734,20,79,99,164,19,8,91,61,431,Kevin Porter Jr.
2021-22,HOU,PG,61,61,1907,335,808,.415,155,413,.375,180,395,.456,.511,124,193,.642,43,224,267,376,69,22,192,156,949,Kevin Porter Jr.
2022-23,HOU,PG,59,59,2024,391,884,.442,141,385,.366,250,499,.501,.522,207,264,.784,76,238,314,338,82,17,188,156,1130,Kevin Porter Jr.
2024-25,LAC,SG,27,1,547,110,261,.421,18,72,.250,92,189,.487,.456,33,51,.647,19,80,99,81,28,7,62,46,271,Kevin Porter Jr.
2019-20,DEN,SF,55,8,903,195,383,.509,62,147,.422,133,236,.564,.590,60,72,.833,66,193,259,46,27,25,49,100,512,Michael Porter Jr.
2020-21,DEN,SF,61,54,1912,443,817,.542,170,382,.445,273,435,.628,.646,106,134,.791,91,354,445,70,40,54,77,126,1162,Michael Porter Jr.
2021-22,DEN,SF,9,9,265,37,103,.359,10,48,.208,27,55,.491,.408,5,9,.556,9,50,59,17,10,2,12,16,89,Michael Porter Jr.
2022-23,DEN,SF,62,62,1798,398,817,.487,188,454,.414,210,363,.579,.602,96,120,.800,64,277,341,65,37,29,68,119,1080,Michael Porter Jr.
2023-24,DEN,SF,81,81,2565,522,1079,.484,220,554,.397,302,525,.575,.586,92,110,.836,106,459,565,122,42,53,92,148,1356,Michael Porter Jr.
2024-25,DEN,SF,29,29,998,205,396,.518,70,176,.398,135,220,.614,.606,53,76,.697,44,151,195,81,22,12,44,64,533,Michael Porter Jr.
2013-14,WAS,SF,37,0,319,33,91,.363,4,21,.190,29,70,.414,.385,8,12,.667,21,36,57,10,8,1,14,26,78,Otto Porter Jr.
2014-15,WAS,SF,74,13,1432,176,391,.450,35,104,.337,141,287,.491,.495,58,79,.734,70,151,221,65,44,30,52,97,445,Otto Porter Jr.
2015-16,WAS,SF,75,73,2276,339,717,.473,98,267,.367,241,450,.536,.541,95,126,.754,97,294,391,120,105,32,70,163,871,Otto Porter Jr.
2016-17,WAS,SF,80,80,2605,414,803,.516,148,341,.434,266,462,.576,.608,99,119,.832,118,396,514,121,116,42,44,193,1075,Otto Porter Jr.
2017-18,WAS,SF,77,77,2432,445,885,.503,138,313,.441,307,572,.537,.581,106,128,.828,103,389,492,157,116,41,75,151,1134,Otto Porter Jr.
2018-19,2TM,SF,56,43,1683,299,643,.465,104,256,.406,195,387,.504,.546,78,96,.813,54,260,314,120,82,31,65,108,780,Otto Porter Jr.
2018-19,WAS,SF,41,28,1191,202,442,.457,65,176,.369,137,266,.515,.531,49,64,.766,40,191,231,80,64,22,40,79,518,Otto Porter Jr.
2018-19,CHI,SF,15,15,492,97,201,.483,39,80,.488,58,121,.479,.580,29,32,.906,14,69,83,40,18,9,25,29,262,Otto Porter Jr.
2019-20,CHI,SF,14,9,331,62,140,.443,24,62,.387,38,78,.487,.529,19,27,.704,13,35,48,25,15,6,11,31,167,Otto Porter Jr.
2020-21,2TM,SF,28,6,606,98,227,.432,39,104,.375,59,123,.480,.518,36,42,.857,28,124,152,55,16,4,25,41,271,Otto Porter Jr.
2020-21,CHI,SF,25,6,540,89,202,.441,38,95,.400,51,107,.477,.535,31,37,.838,28,110,138,50,12,4,25,37,247,Otto Porter Jr.
2020-21,ORL,PF,3,0,66,9,25,.360,1,9,.111,8,16,.500,.380,5,5,1.000,0,14,14,5,4,0,0,4,24,Otto Porter Jr.
2021-22,GSW,PF,63,15,1396,193,416,.464,80,216,.370,113,200,.565,.560,49,61,.803,86,276,362,94,68,29,37,83,515,Otto Porter Jr.
2022-23,TOR,SF,8,2,146,15,30,.500,6,17,.353,9,13,.692,.600,8,8,1.000,6,13,19,8,11,0,4,7,44,Otto Porter Jr.
2023-24,TOR,SF,15,1,174,14,33,.424,8,23,.348,6,10,.600,.545,3,3,1.000,6,23,29,8,5,5,2,19,39,Otto Porter Jr.
2015-16,CHI,PF,62,4,1102,186,436,.427,16,52,.308,170,384,.443,.445,48,66,.727,123,214,337,52,25,22,54,100,436,Bobby Portis
2016-17,CHI,PF,64,13,1000,183,375,.488,32,96,.333,151,279,.541,.531,39,59,.661,75,221,296,35,16,11,37,94,437,Bobby Portis
2017-18,CHI,PF,73,4,1643,382,811,.471,80,223,.359,302,588,.514,.520,120,156,.769,159,339,498,123,50,23,103,130,964,Bobby Portis
2018-19,2TM,PF,50,28,1299,279,628,.444,75,191,.393,204,437,.467,.504,77,97,.794,109,294,403,72,35,20,74,145,710,Bobby Portis
2018-19,CHI,PF,22,6,531,122,271,.450,27,72,.375,95,199,.477,.500,39,50,.780,46,115,161,29,11,8,29,61,310,Bobby Portis
2018-19,WAS,PF,28,22,768,157,357,.440,48,119,.403,109,238,.458,.507,38,47,.809,63,179,242,43,24,12,45,84,400,Bobby Portis
2019-20,NYK,PF,66,5,1393,265,589,.450,67,187,.358,198,402,.493,.507,71,93,.763,80,258,338,98,32,18,73,110,668,Bobby Portis
2020-21,MIL,C,66,7,1372,313,598,.523,74,157,.471,239,441,.542,.585,54,73,.740,124,342,466,71,52,26,56,115,754,Bobby Portis
2021-22,MIL,C,72,59,2028,417,871,.479,133,338,.393,284,533,.533,.555,85,113,.752,180,477,657,86,53,51,90,174,1052,Bobby Portis
2022-23,MIL,PF,70,22,1818,398,803,.496,95,257,.370,303,546,.555,.555,96,125,.768,154,518,672,105,29,16,81,115,987,Bobby Portis
2023-24,MIL,PF,82,4,2008,466,918,.508,100,246,.407,366,672,.545,.562,98,124,.790,142,465,607,104,68,34,91,189,1130,Bobby Portis
2024-25,MIL,PF,28,4,698,164,340,.482,38,100,.380,126,240,.525,.538,28,37,.757,49,169,218,60,19,16,36,47,394,Bobby Portis
2015-16,NYK,PF,72,72,2047,373,886,.421,81,243,.333,292,643,.454,.467,201,240,.838,132,394,526,94,53,134,121,205,1028,Kristaps Porziņģis
2016-17,NYK,PF,66,65,2164,443,985,.450,112,314,.357,331,671,.493,.507,198,252,.786,111,364,475,97,47,129,118,244,1196,Kristaps Porziņģis
2017-18,NYK,PF,48,48,1553,390,889,.439,90,228,.395,300,661,.454,.489,218,275,.793,62,254,316,57,36,115,93,141,1088,Kristaps Porziņģis
2019-20,DAL,C,57,57,1814,398,932,.427,142,403,.352,256,529,.484,.503,226,283,.799,100,440,540,102,41,115,92,185,1164,Kristaps Porziņģis
2020-21,DAL,C,43,43,1327,325,683,.476,97,258,.376,228,425,.536,.547,118,138,.855,82,299,381,68,20,58,51,115,865,Kristaps Porziņģis
2021-22,2TM,PF,51,51,1481,352,767,.459,78,252,.310,274,515,.532,.510,248,286,.867,102,309,411,119,37,84,81,137,1030,Kristaps Porziņģis
2021-22,DAL,PF,34,34,1002,229,508,.451,49,173,.283,180,335,.537,.499,147,170,.865,64,197,261,69,25,59,53,88,654,Kristaps Porziņģis
2021-22,WAS,PF,17,17,479,123,259,.475,29,79,.367,94,180,.522,.531,101,116,.871,38,112,150,50,12,25,28,49,376,Kristaps Porziņģis
2022-23,WAS,C,65,65,2120,507,1018,.498,137,356,.385,370,662,.559,.565,354,416,.851,114,432,546,174,58,100,137,196,1505,Kristaps Porziņģis
2023-24,BOS,C,57,57,1690,388,752,.516,110,293,.375,278,459,.606,.589,259,302,.858,97,312,409,115,42,111,89,156,1145,Kristaps Porziņģis
2024-25,BOS,C,11,11,299,67,148,.453,22,67,.328,45,81,.556,.527,45,53,.849,15,55,70,18,8,16,8,24,201,Kristaps Porziņģis
2021-22,DET,C,3,0,31,5,11,.455,0,2,.000,5,9,.556,.455,2,2,1.000,4,5,9,0,1,1,1,4,12,Micah Potter
2022-23,UTA,PF,7,0,52,10,15,.667,4,7,.571,6,8,.750,.800,0,0,,3,13,16,4,1,0,2,5,24,Micah Potter
2023-24,UTA,PF,16,0,186,19,40,.475,9,21,.429,10,19,.526,.588,6,8,.750,10,33,43,6,4,6,5,14,53,Micah Potter
2024-25,UTA,C,8,2,147,13,28,.464,10,23,.435,3,5,.600,.643,0,0,,14,32,46,9,2,4,6,8,36,Micah Potter
2014-15,2TM,PF,29,0,236,31,67,.463,3,11,.273,28,56,.500,.485,25,33,.758,18,32,50,9,9,6,11,40,90,Dwight Powell
2014-15,BOS,PF,5,0,9,4,5,.800,0,0,,4,5,.800,.800,1,2,.500,0,1,1,0,2,0,2,1,9,Dwight Powell
2014-15,DAL,PF,24,0,227,27,62,.435,3,11,.273,24,51,.471,.460,24,31,.774,18,31,49,9,7,6,9,39,81,Dwight Powell
2015-16,DAL,PF,69,2,992,146,296,.493,2,16,.125,144,280,.514,.497,105,142,.739,84,189,273,44,36,24,40,118,399,Dwight Powell
2016-17,DAL,C,77,3,1333,194,377,.515,21,74,.284,173,303,.571,.542,107,141,.759,93,213,306,49,61,39,34,135,516,Dwight Powell
2017-18,DAL,C,79,24,1672,255,430,.593,28,84,.333,227,346,.656,.626,133,185,.719,135,309,444,91,67,32,59,186,671,Dwight Powell
2018-19,DAL,C,77,22,1662,290,486,.597,39,127,.307,251,359,.699,.637,196,254,.772,140,271,411,112,44,50,67,201,815,Dwight Powell
2019-20,DAL,C,40,37,1061,146,229,.638,10,39,.256,136,190,.716,.659,74,111,.667,75,152,227,59,34,22,36,102,376,Dwight Powell
2020-21,DAL,C,58,19,966,120,194,.619,5,21,.238,115,173,.665,.631,97,124,.782,80,154,234,63,36,30,40,135,342,Dwight Powell
2021-22,DAL,C,82,71,1798,269,401,.671,13,37,.351,256,364,.703,.687,166,212,.783,173,231,404,97,37,39,64,220,717,Dwight Powell
2022-23,DAL,C,76,64,1458,197,269,.732,0,5,.000,197,264,.746,.732,112,168,.667,149,165,314,69,48,26,65,209,506,Dwight Powell
2023-24,DAL,C,63,9,836,72,106,.679,1,3,.333,71,103,.689,.684,63,89,.708,97,117,214,84,26,20,32,113,208,Dwight Powell
2024-25,DAL,C,24,0,184,11,13,.846,1,1,1.000,10,12,.833,.885,17,26,.654,15,26,41,16,8,10,5,30,40,Dwight Powell
2015-16,TOR,SG,49,24,725,97,229,.424,36,89,.404,61,140,.436,.502,43,53,.811,16,95,111,47,29,10,32,59,273,Norman Powell
2016-17,TOR,SG,76,18,1368,227,506,.449,56,173,.324,171,333,.514,.504,126,159,.792,26,143,169,82,52,14,70,127,636,Norman Powell
2017-18,TOR,SG,70,18,1062,150,374,.401,53,186,.285,97,188,.516,.472,32,39,.821,14,105,119,89,37,16,66,111,385,Norman Powell
2018-19,TOR,SG,60,3,1126,193,400,.483,68,170,.400,125,230,.543,.568,62,75,.827,16,123,139,91,39,13,65,96,516,Norman Powell
2019-20,TOR,SG,52,26,1479,296,598,.495,109,273,.399,187,325,.575,.586,129,153,.843,26,164,190,91,60,21,77,108,830,Norman Powell
2020-21,2TM,SG,69,58,2205,438,918,.477,171,416,.411,267,502,.532,.570,236,271,.871,42,173,215,129,82,18,119,160,1283,Norman Powell
2020-21,TOR,SG,42,31,1277,282,566,.498,118,269,.439,164,297,.552,.602,141,163,.865,19,107,126,77,47,8,77,98,823,Norman Powell
2020-21,POR,SF,27,27,928,156,352,.443,53,147,.361,103,205,.502,.518,95,108,.880,23,66,89,52,35,10,42,62,460,Norman Powell
2021-22,2TM,SG,45,41,1458,279,605,.461,106,253,.419,173,352,.491,.549,189,233,.811,20,125,145,96,42,21,69,106,853,Norman Powell
2021-22,POR,SF,40,39,1333,247,542,.456,93,229,.406,154,313,.492,.542,159,198,.803,17,114,131,82,40,17,62,92,746,Norman Powell
2021-22,LAC,SG,5,2,125,32,63,.508,13,24,.542,19,39,.487,.611,30,35,.857,3,11,14,14,2,4,7,14,107,Norman Powell
2022-23,LAC,SG,60,8,1567,340,710,.479,114,287,.397,226,423,.534,.559,225,277,.812,24,151,175,109,50,18,101,125,1019,Norman Powell
2023-24,LAC,SG,76,3,1990,373,768,.486,167,384,.435,206,384,.536,.594,143,172,.831,16,179,195,82,43,22,66,137,1056,Norman Powell
2024-25,LAC,SG,24,24,801,202,408,.495,90,193,.466,112,215,.521,.605,87,103,.845,7,72,79,60,29,5,51,52,581,Norman Powell
2022-23,LAC,PG,14,0,124,18,41,.439,5,18,.278,13,23,.565,.500,0,2,.000,2,20,22,27,2,0,10,7,41,Jason Preston
2023-24,UTA,PG,7,0,71,6,19,.316,0,3,.000,6,16,.375,.316,0,0,,6,11,17,16,2,1,2,3,12,Jason Preston
2021-22,SAS,SF,50,16,965,101,270,.374,42,137,.307,59,133,.444,.452,44,59,.746,32,81,113,81,20,23,57,79,288,Joshua Primo
2022-23,SAS,SG,4,0,93,9,26,.346,3,12,.250,6,14,.429,.404,7,9,.778,2,11,13,18,1,2,11,8,28,Joshua Primo
2023-24,LAC,SG,2,0,10,1,3,.333,0,1,.000,1,2,.500,.333,0,0,,1,0,1,0,0,1,4,0,2,Joshua Primo
2016-17,ATL,SF,59,10,981,114,285,.400,33,102,.324,81,183,.443,.458,74,94,.787,25,132,157,55,43,27,61,96,335,Taurean Prince
2017-18,ATL,SF,82,82,2464,415,975,.426,176,457,.385,239,518,.461,.516,152,180,.844,50,339,389,214,85,42,191,168,1158,Taurean Prince
2018-19,ATL,SF,55,47,1552,262,594,.441,123,315,.390,139,279,.498,.545,95,116,.819,22,177,199,118,53,19,100,141,742,Taurean Prince
2019-20,BRK,PF,64,61,1857,278,739,.376,146,431,.339,132,308,.429,.475,71,89,.798,50,331,381,116,57,25,127,159,773,Taurean Prince
2020-21,2TM,PF,41,10,905,131,327,.401,62,155,.400,69,172,.401,.495,65,76,.855,19,123,142,76,28,23,47,75,389,Taurean Prince
2020-21,BRK,PF,12,4,218,30,74,.405,13,37,.351,17,37,.459,.493,24,27,.889,2,32,34,7,8,8,11,21,97,Taurean Prince
2020-21,CLE,PF,29,6,687,101,253,.399,49,118,.415,52,135,.385,.496,41,49,.837,17,91,108,69,20,15,36,54,292,Taurean Prince
2021-22,MIN,PF,69,8,1177,177,390,.454,86,229,.376,91,161,.565,.564,62,82,.756,26,148,174,68,47,23,53,116,502,Taurean Prince
2022-23,MIN,PF,54,4,1192,177,379,.467,74,194,.381,103,185,.557,.565,65,77,.844,15,117,132,84,28,15,69,123,493,Taurean Prince
2023-24,LAL,PF,78,49,2108,253,572,.442,141,356,.396,112,216,.519,.566,50,68,.735,21,209,230,119,58,35,73,146,697,Taurean Prince
2024-25,MIL,SF,29,26,759,77,170,.453,51,107,.477,26,63,.413,.603,13,17,.765,18,100,118,50,25,5,36,59,218,Taurean Prince
2020-21,BOS,SG,66,4,1268,184,418,.440,102,248,.411,82,170,.482,.562,40,45,.889,33,125,158,120,37,9,53,104,510,Payton Pritchard
2021-22,BOS,PG,71,2,1001,160,373,.429,101,245,.412,59,128,.461,.564,21,21,1.000,32,102,134,139,25,6,41,61,442,Payton Pritchard
2022-23,BOS,PG,48,3,643,101,245,.412,56,154,.364,45,91,.495,.527,12,16,.750,25,63,88,64,14,1,40,37,270,Payton Pritchard
2023-24,BOS,PG,82,5,1825,297,635,.468,147,382,.385,150,253,.593,.583,46,56,.821,70,195,265,281,39,6,61,106,787,Payton Pritchard
2024-25,BOS,PG,31,0,893,163,350,.466,112,271,.413,51,79,.646,.626,39,46,.848,46,72,118,106,29,4,32,54,477,Payton Pritchard
2023-24,DAL,PF,40,1,336,40,104,.385,13,45,.289,27,59,.458,.447,28,41,.683,25,54,79,22,7,4,8,20,121,Olivier-Maxence Prosper
2024-25,DAL,PF,20,0,138,15,40,.375,4,14,.286,11,26,.423,.425,9,13,.692,13,22,35,8,4,2,2,7,43,Olivier-Maxence Prosper
2021-22,HOU,SG,10,0,74,15,33,.455,9,24,.375,6,9,.667,.591,4,4,1.000,7,9,16,4,5,1,7,6,43,Trevelin Queen
2022-23,IND,SG,7,0,70,7,29,.241,2,15,.133,5,14,.357,.276,5,5,1.000,8,9,17,6,2,5,7,4,21,Trevelin Queen
2023-24,ORL,SG,14,0,165,14,38,.368,3,17,.176,11,21,.524,.408,9,12,.750,3,17,20,18,7,5,7,15,40,Trevelin Queen
2024-25,ORL,SG,7,2,122,16,31,.516,8,16,.500,8,15,.533,.645,4,4,1.000,2,5,7,10,8,3,7,14,44,Trevelin Queen
2021-22,SAC,C,15,0,120,17,38,.447,0,0,,17,38,.447,.447,11,17,.647,14,17,31,6,1,8,6,18,45,Neemias Queta
2022-23,SAC,C,5,0,29,6,9,.667,0,0,,6,9,.667,.667,0,2,.000,5,6,11,1,0,2,1,7,12,Neemias Queta
2023-24,BOS,C,28,0,333,67,104,.644,0,0,,67,104,.644,.644,20,28,.714,53,69,122,20,13,21,13,50,154,Neemias Queta
2024-25,BOS,C,25,5,403,56,89,.629,0,2,.000,56,87,.644,.629,20,27,.741,41,74,115,17,7,23,18,50,132,Neemias Queta
2020-21,NYK,PG,64,3,1243,229,580,.395,118,303,.389,111,277,.401,.497,155,174,.891,25,112,137,127,30,12,58,114,731,Immanuel Quickley
2021-22,NYK,PG,78,3,1802,284,724,.392,137,396,.346,147,328,.448,.487,177,201,.881,31,216,247,275,54,3,99,167,882,Immanuel Quickley
2022-23,NYK,SG,81,21,2344,419,936,.448,168,454,.370,251,482,.521,.537,203,248,.819,58,279,337,279,80,14,100,166,1209,Immanuel Quickley
2023-24,2TM,SG,68,38,1985,388,894,.434,171,433,.395,217,461,.471,.530,209,245,.853,17,242,259,331,50,10,101,119,1156,Immanuel Quickley
2023-24,NYK,SG,30,0,720,152,335,.454,64,162,.395,88,173,.509,.549,82,94,.872,5,72,77,74,16,3,31,44,450,Immanuel Quickley
2023-24,TOR,PG,38,38,1265,236,559,.422,107,271,.395,129,288,.448,.518,127,151,.841,12,170,182,257,34,7,70,75,706,Immanuel Quickley
2024-25,TOR,PG,3,3,68,16,42,.381,6,16,.375,10,26,.385,.452,8,9,.889,1,5,6,12,2,0,4,7,46,Immanuel Quickley
2022-23,GSW,SG,4,0,18,2,5,.400,2,4,.500,0,1,.000,.600,4,6,.667,1,2,3,2,1,0,5,0,10,Lester Quiñones
2023-24,GSW,SG,37,0,394,56,141,.397,32,88,.364,24,53,.453,.511,20,29,.690,21,51,72,36,6,2,17,44,164,Lester Quiñones
2024-25,PHI,SG,4,0,17,4,8,.500,0,3,.000,4,5,.800,.500,1,1,1.000,3,1,4,1,0,0,4,0,9,Lester Quiñones
2020-21,SAC,SG,13,0,94,15,38,.395,5,19,.263,10,19,.526,.461,5,5,1.000,2,8,10,6,4,1,3,8,40,Jahmi'us Ramsey
2021-22,SAC,SG,19,0,134,24,58,.414,5,18,.278,19,40,.475,.457,7,14,.500,4,9,13,7,1,1,5,10,60,Jahmi'us Ramsey
2023-24,TOR,SG,7,1,121,18,41,.439,6,22,.273,12,19,.632,.512,5,6,.833,4,18,22,8,7,0,7,10,47,Jahmi'us Ramsey
2016-17,2TM,PG,26,0,299,40,98,.408,16,47,.340,24,51,.471,.490,41,43,.953,6,26,32,34,9,2,19,39,137,Chasson Randle
2016-17,PHI,PG,8,0,74,12,26,.462,6,15,.400,6,11,.545,.577,12,12,1.000,0,5,5,6,3,1,3,11,42,Chasson Randle
2016-17,NYK,PG,18,0,225,28,72,.389,10,32,.313,18,40,.450,.458,29,31,.935,6,21,27,28,6,1,16,28,95,Chasson Randle
2018-19,WAS,PG,49,2,743,91,217,.419,46,115,.400,45,102,.441,.525,43,62,.694,10,46,56,97,25,3,43,91,271,Chasson Randle
2019-20,GSW,PG,3,0,40,0,4,.000,0,2,.000,0,2,.000,.000,5,6,.833,0,2,2,5,2,0,0,3,5,Chasson Randle
2020-21,ORL,PG,41,5,837,92,237,.388,44,130,.338,48,107,.449,.481,38,48,.792,7,75,82,74,22,5,46,64,266,Chasson Randle
2014-15,LAL,PF,1,0,14,1,3,.333,0,0,,1,3,.333,.333,0,2,.000,0,0,0,0,0,0,1,1,2,Julius Randle
2015-16,LAL,PF,81,60,2286,358,835,.429,10,36,.278,348,799,.436,.435,193,270,.715,172,657,829,144,53,29,149,242,919,Julius Randle
2016-17,LAL,PF,74,73,2132,377,773,.488,17,63,.270,360,710,.507,.499,204,282,.723,150,486,636,264,49,37,173,248,975,Julius Randle
2017-18,LAL,C,82,49,2190,504,904,.558,10,45,.222,494,859,.575,.563,305,425,.718,181,473,654,210,43,45,213,274,1323,Julius Randle
2018-19,NOP,PF,73,49,2232,571,1089,.524,67,195,.344,504,894,.564,.555,356,487,.731,162,472,634,229,52,45,208,246,1565,Julius Randle
2019-20,NYK,PF,64,64,2080,463,1006,.460,64,231,.277,399,775,.515,.492,258,352,.733,151,471,622,198,51,22,193,178,1248,Julius Randle
2020-21,NYK,PF,71,71,2667,602,1321,.456,160,389,.411,442,932,.474,.516,348,429,.811,84,639,723,427,64,18,241,225,1712,Julius Randle
2021-22,NYK,PF,72,72,2544,512,1246,.411,120,390,.308,392,856,.458,.459,303,401,.756,125,591,716,370,53,39,245,205,1447,Julius Randle
2022-23,NYK,PF,77,77,2737,658,1432,.459,218,636,.343,440,796,.553,.536,402,531,.757,141,626,767,316,49,21,216,233,1936,Julius Randle
2023-24,NYK,PF,46,46,1630,395,836,.472,76,244,.311,319,592,.539,.518,236,302,.781,99,324,423,229,25,12,159,125,1102,Julius Randle
2024-25,MIN,PF,30,30,993,206,430,.479,55,144,.382,151,286,.528,.543,144,176,.818,56,156,212,131,21,6,90,76,611,Julius Randle
2023-24,POR,C,68,20,1214,230,499,.461,88,245,.359,142,254,.559,.549,69,93,.742,93,157,250,67,33,38,52,161,617,Duop Reath
2024-25,POR,C,14,0,86,11,29,.379,8,22,.364,3,7,.429,.517,0,0,,6,7,13,4,0,2,1,10,30,Duop Reath
2021-22,LAL,SG,61,19,1418,146,318,.459,53,167,.317,93,151,.616,.542,99,118,.839,45,148,193,110,29,20,40,87,444,Austin Reaves
2022-23,LAL,SG,64,22,1843,259,490,.529,86,216,.398,173,274,.631,.616,229,265,.864,33,160,193,215,33,19,99,108,833,Austin Reaves
2023-24,LAL,SG,82,57,2629,457,940,.486,154,420,.367,303,520,.583,.568,232,272,.853,57,295,352,450,66,25,174,153,1300,Austin Reaves
2024-25,LAL,SG,25,25,851,148,338,.438,66,186,.355,82,152,.539,.536,72,89,.809,21,81,102,128,27,4,58,53,434,Austin Reaves
2019-20,DAL,SF,4,0,28,3,9,.333,0,2,.000,3,7,.429,.333,2,2,1.000,1,2,3,3,0,0,0,5,8,Josh Reaves
2019-20,ATL,SF,58,34,1551,213,554,.384,83,250,.332,130,304,.428,.459,101,126,.802,35,181,216,87,62,28,96,132,610,Cam Reddish
2020-21,ATL,SF,26,21,750,96,263,.365,33,126,.262,63,137,.460,.428,67,82,.817,22,82,104,35,33,9,34,68,292,Cam Reddish
2021-22,2TM,SF,49,7,1012,165,408,.404,66,184,.359,99,224,.442,.485,101,112,.902,25,80,105,48,47,15,57,60,497,Cam Reddish
2021-22,ATL,SF,34,7,797,138,343,.402,58,153,.379,80,190,.421,.487,72,80,.900,20,64,84,38,35,11,44,45,406,Cam Reddish
2021-22,NYK,SF,15,0,215,27,65,.415,8,31,.258,19,34,.559,.477,29,32,.906,5,16,21,10,12,4,13,15,91,Cam Reddish
2022-23,2TM,SF,40,20,990,139,312,.446,45,144,.313,94,168,.560,.518,64,75,.853,18,70,88,57,39,14,47,72,387,Cam Reddish
2022-23,NYK,SF,20,8,438,61,136,.449,17,56,.304,44,80,.550,.511,29,33,.879,7,24,31,20,15,8,15,32,168,Cam Reddish
2022-23,POR,SF,20,12,552,78,176,.443,28,88,.318,50,88,.568,.523,35,42,.833,11,46,57,37,24,6,32,40,219,Cam Reddish
2023-24,LAL,SF,48,26,984,91,234,.389,37,110,.336,54,124,.435,.468,41,54,.759,27,72,99,48,47,14,31,64,260,Cam Reddish
2024-25,LAL,SF,23,8,450,32,67,.478,11,35,.314,21,32,.656,.560,13,19,.684,12,36,48,18,27,9,12,39,88,Cam Reddish
2017-18,PHO,SG,21,1,242,22,76,.289,11,38,.289,11,38,.289,.362,8,12,.667,2,37,39,13,10,2,10,17,63,Davon Reed
2018-19,IND,SG,10,0,47,5,12,.417,2,4,.500,3,8,.375,.500,0,0,,2,4,6,3,1,0,1,3,12,Davon Reed
2021-22,DEN,SG,48,5,668,81,161,.503,37,86,.430,44,75,.587,.618,10,15,.667,14,94,108,53,24,9,16,63,209,Davon Reed
2022-23,2TM,SG,43,1,342,28,84,.333,17,46,.370,11,38,.289,.435,16,24,.667,10,49,59,23,15,4,20,39,89,Davon Reed
2022-23,DEN,SG,35,1,315,25,80,.313,16,44,.364,9,36,.250,.413,15,20,.750,9,46,55,19,13,4,20,36,81,Davon Reed
2022-23,LAL,SG,8,0,27,3,4,.750,1,2,.500,2,2,1.000,.875,1,4,.250,1,3,4,4,2,0,0,3,8,Davon Reed
2020-21,PHI,PF,26,0,177,42,78,.538,0,6,.000,42,72,.583,.538,4,8,.500,30,31,61,12,10,13,12,29,88,Paul Reed
2021-22,PHI,C,38,2,302,54,96,.563,2,8,.250,52,88,.591,.573,6,14,.429,44,48,92,16,33,14,10,57,116,Paul Reed
2022-23,PHI,C,69,2,755,124,209,.593,1,6,.167,123,203,.606,.596,38,51,.745,112,150,262,27,46,51,45,123,287,Paul Reed
2023-24,PHI,C,82,24,1590,259,480,.540,21,57,.368,238,423,.563,.561,61,85,.718,193,295,488,109,67,84,67,198,600,Paul Reed
2024-25,DET,C,17,0,201,35,60,.583,5,13,.385,30,47,.638,.625,14,17,.824,15,28,43,18,19,12,11,31,89,Paul Reed
2024-25,OKC,PF,1,0,2,1,1,1.000,0,0,1,1,1.000,1.000,0,0,1,0,1,0,0,0,0,0,2,0,,Alex Reese
2024-25,NOP,SG,16,0,149,28,70,.400,9,34,.265,19,36,.528,.464,6,7,.857,6,12,18,10,5,0,5,7,71,Antonio Reeves
2019-20,MIN,C,30,11,495,100,243,.412,32,97,.330,68,146,.466,.477,37,53,.698,34,90,124,35,19,22,22,83,269,Naz Reid
2020-21,MIN,C,70,15,1347,304,581,.523,61,174,.351,243,407,.597,.576,115,166,.693,82,240,322,72,34,76,69,179,784,Naz Reid
2021-22,MIN,C,77,6,1215,233,476,.489,57,166,.343,176,310,.568,.549,114,149,.765,102,199,301,71,40,71,82,172,637,Naz Reid
2022-23,MIN,C,68,11,1251,310,577,.537,75,217,.346,235,360,.653,.602,86,127,.677,73,260,333,77,42,53,92,176,781,Naz Reid
2023-24,MIN,PF,81,14,1964,406,851,.477,169,408,.414,237,443,.535,.576,109,148,.736,73,350,423,106,63,73,111,172,1090,Naz Reid
2024-25,MIN,C,30,0,736,136,299,.455,52,149,.349,84,150,.560,.542,43,51,.843,20,126,146,50,22,23,38,71,367,Naz Reid
2022-23,DET,SG,14,0,198,17,44,.386,5,20,.250,12,24,.500,.443,6,6,1.000,11,26,37,4,4,1,3,23,45,Jared Rhoden
2023-24,DET,SG,17,0,245,33,66,.500,12,31,.387,21,35,.600,.591,5,8,.625,3,30,33,14,3,13,7,28,83,Jared Rhoden
2024-25,CHO,SG,4,0,12,2,8,.250,0,2,.000,2,6,.333,.250,0,0,,2,2,4,2,1,0,1,1,4,Jared Rhoden
2020-21,CHO,PF,18,0,63,4,9,.444,0,1,.000,4,8,.500,.444,7,11,.636,4,7,11,2,0,0,3,7,15,Nick Richards
2021-22,CHO,C,50,5,367,60,90,.667,0,0,,60,90,.667,.667,30,43,.698,34,52,86,13,9,21,24,51,150,Nick Richards
2022-23,CHO,C,65,9,1217,197,313,.629,1,1,1.000,196,312,.628,.631,137,183,.749,147,269,416,38,11,71,59,154,532,Nick Richards
2023-24,CHO,C,67,51,1759,260,376,.691,0,1,.000,260,375,.693,.691,132,179,.737,172,367,539,54,26,74,73,176,652,Nick Richards
2024-25,CHO,C,15,9,347,53,92,.576,0,1,.000,53,91,.582,.576,49,72,.681,37,87,124,21,6,19,26,42,155,Nick Richards
2015-16,MIA,SG,52,2,1107,123,272,.452,53,115,.461,70,157,.446,.550,42,63,.667,21,86,107,73,36,25,35,107,341,Josh Richardson
2016-17,MIA,SG,53,34,1614,202,513,.394,75,227,.330,127,286,.444,.467,60,77,.779,35,133,168,140,60,39,65,132,539,Josh Richardson
2017-18,MIA,SF,81,81,2689,399,885,.451,127,336,.378,272,549,.495,.523,120,142,.845,69,216,285,231,121,75,140,199,1045,Josh Richardson
2018-19,MIA,SG,73,73,2539,423,1026,.412,164,460,.357,259,566,.458,.492,199,231,.861,54,209,263,298,79,34,113,200,1209,Josh Richardson
2019-20,PHI,SG,55,53,1693,278,646,.430,85,249,.341,193,397,.486,.496,114,141,.809,41,133,174,162,52,36,104,136,755,Josh Richardson
2020-21,DAL,SG,59,56,1790,264,618,.427,88,267,.330,176,351,.501,.498,99,108,.917,51,144,195,153,61,24,79,130,715,Josh Richardson
2021-22,2TM,SG,65,7,1600,234,534,.438,102,246,.415,132,288,.458,.534,96,108,.889,42,143,185,115,56,29,66,116,666,Josh Richardson
2021-22,BOS,SG,44,0,1087,152,343,.443,62,156,.397,90,187,.481,.534,61,71,.859,26,99,125,66,34,23,39,82,427,Josh Richardson
2021-22,SAS,SG,21,7,513,82,191,.429,40,90,.444,42,101,.416,.534,35,37,.946,16,44,60,49,22,6,27,34,239,Josh Richardson
2022-23,2TM,SG,65,10,1530,239,554,.431,107,293,.365,132,261,.506,.528,69,81,.852,41,134,175,174,69,20,86,117,654,Josh Richardson
2022-23,SAS,SG,42,6,997,177,406,.436,74,207,.357,103,199,.518,.527,53,60,.883,30,89,119,137,40,11,63,70,481,Josh Richardson
2022-23,NOP,SG,23,4,533,62,148,.419,33,86,.384,29,62,.468,.530,16,21,.762,11,45,56,37,29,9,23,47,173,Josh Richardson
2023-24,MIA,SG,43,6,1103,154,347,.444,66,190,.347,88,157,.561,.539,51,54,.944,18,103,121,105,24,14,36,76,425,Josh Richardson
2024-25,MIA,SG,8,0,150,11,38,.289,6,22,.273,5,16,.313,.368,4,4,1.000,6,6,12,12,8,1,8,17,32,Josh Richardson
2020-21,CHO,PG,7,0,27,8,12,.667,2,4,.500,6,8,.750,.750,0,0,0,1,1,3,1,0,1,0,18,0,Grant Riller
2024-25,ATL,SF,31,29,727,122,308,.396,38,135,.281,84,173,.486,.458,51,74,.689,34,67,101,37,25,19,37,65,333,Zaccharie Risacher
2012-13,NOH,SG,61,26,1418,145,390,.372,28,86,.326,117,304,.385,.408,59,108,.546,16,93,109,127,26,9,74,122,377,Austin Rivers
2013-14,NOP,PG,69,4,1339,192,474,.405,36,99,.364,156,375,.416,.443,110,173,.636,26,103,129,160,45,9,77,134,530,Austin Rivers
2014-15,2TM,SG,76,5,1563,203,496,.409,39,131,.298,164,365,.449,.449,85,126,.675,27,125,152,155,48,14,65,146,530,Austin Rivers
2014-15,NOP,SG,35,3,772,86,222,.387,14,50,.280,72,172,.419,.419,53,71,.746,12,56,68,87,18,7,30,65,239,Austin Rivers
2014-15,LAC,SG,41,2,791,117,274,.427,25,81,.309,92,193,.477,.473,32,55,.582,15,69,84,68,30,7,35,81,291,Austin Rivers
2015-16,LAC,SG,67,7,1464,226,516,.438,62,185,.335,164,331,.495,.498,79,116,.681,22,108,130,99,48,9,61,137,593,Austin Rivers
2016-17,LAC,SG,74,29,2054,323,731,.442,111,299,.371,212,432,.491,.518,132,191,.691,20,141,161,204,48,10,115,187,889,Austin Rivers
2017-18,LAC,SG,61,59,2057,341,805,.424,136,360,.378,205,445,.461,.508,102,159,.642,27,118,145,242,74,16,109,152,920,Austin Rivers
2018-19,2TM,SG,76,15,2028,232,572,.406,104,327,.318,128,245,.522,.497,50,95,.526,25,137,162,167,47,23,68,207,618,Austin Rivers
2018-19,WAS,SG,29,2,683,76,194,.392,33,106,.311,43,88,.489,.477,25,46,.543,10,61,71,58,18,10,36,72,210,Austin Rivers
2018-19,HOU,SG,47,13,1345,156,378,.413,71,221,.321,85,157,.541,.507,25,49,.510,15,76,91,109,29,13,32,135,408,Austin Rivers
2019-20,HOU,SG,68,4,1594,211,501,.421,96,270,.356,115,231,.498,.517,78,111,.703,27,148,175,113,49,10,50,129,596,Austin Rivers
2020-21,2TM,SG,36,7,845,104,245,.424,55,149,.369,49,96,.510,.537,22,31,.710,8,74,82,81,30,2,36,64,285,Austin Rivers
2020-21,NYK,SG,21,2,442,58,135,.430,28,77,.364,30,58,.517,.533,10,14,.714,5,42,47,42,12,0,22,32,154,Austin Rivers
2020-21,DEN,SG,15,5,403,46,110,.418,27,72,.375,19,38,.500,.541,12,17,.706,3,32,35,39,18,2,14,32,131,Austin Rivers
2021-22,DEN,SG,67,18,1480,146,350,.417,79,231,.342,67,119,.563,.530,32,44,.727,19,95,114,90,51,6,54,121,403,Austin Rivers
2022-23,MIN,SG,52,10,1016,91,209,.435,43,123,.350,48,86,.558,.538,30,39,.769,5,78,83,75,28,4,23,80,255,Austin Rivers
2024-25,MIL,C,7,0,33,2,4,.500,0,1,.000,2,3,.667,.500,1,4,.250,4,3,7,1,1,1,1,4,5,Liam Robbins
2018-19,MIA,SF,15,1,161,18,46,.391,10,35,.286,8,11,.727,.500,4,6,.667,2,17,19,5,5,0,4,11,50,Duncan Robinson
2019-20,MIA,SG,73,68,2166,323,687,.470,270,606,.446,53,81,.654,.667,67,72,.931,10,222,232,102,35,19,70,193,983,Duncan Robinson
2020-21,MIA,SF,72,72,2262,315,717,.439,250,613,.408,65,104,.625,.614,62,75,.827,7,243,250,127,43,20,81,181,942,Duncan Robinson
2021-22,MIA,SG,79,68,2043,290,726,.399,232,624,.372,58,102,.569,.559,51,61,.836,24,179,203,129,42,14,60,201,863,Duncan Robinson
2022-23,MIA,SF,42,1,691,88,237,.371,63,192,.328,25,45,.556,.504,29,32,.906,8,61,69,46,14,0,28,77,268,Duncan Robinson
2023-24,MIA,SF,68,36,1905,304,675,.450,187,473,.395,117,202,.579,.589,80,90,.889,15,158,173,192,46,16,95,163,875,Duncan Robinson
2024-25,MIA,SF,27,16,620,105,253,.415,67,178,.376,38,75,.507,.547,19,22,.864,10,51,61,65,13,3,25,58,296,Duncan Robinson
2018-19,LAC,SG,33,0,320,44,110,.400,18,57,.316,26,53,.491,.482,6,9,.667,3,38,41,19,11,3,13,46,112,Jerome Robinson
2019-20,2TM,SG,63,6,979,115,310,.371,49,153,.320,66,157,.420,.450,40,57,.702,13,116,129,87,28,17,49,112,319,Jerome Robinson
2019-20,LAC,SG,42,1,476,46,136,.338,19,67,.284,27,69,.391,.408,11,19,.579,5,55,60,46,13,8,26,55,122,Jerome Robinson
2019-20,WAS,SG,21,5,503,69,174,.397,30,86,.349,39,88,.443,.483,29,38,.763,8,61,69,41,15,9,23,57,197,Jerome Robinson
2020-21,WAS,SG,17,6,305,28,95,.295,11,42,.262,17,53,.321,.353,16,20,.800,4,34,38,25,12,6,19,31,83,Jerome Robinson
2023-24,GSW,SG,22,0,81,11,33,.333,2,17,.118,9,16,.563,.364,7,11,.636,1,5,6,5,1,3,2,5,31,Jerome Robinson
2019-20,WAS,PG,9,0,49,5,12,.417,3,5,.600,2,7,.286,.542,0,0,,1,4,5,7,0,1,3,2,13,Justin Robinson
2020-21,OKC,PG,9,0,88,7,21,.333,4,14,.286,3,7,.429,.429,3,5,.600,1,6,7,9,3,0,2,10,21,Justin Robinson
2021-22,3TM,PG,25,0,304,28,93,.301,18,61,.295,10,32,.313,.398,4,8,.500,4,17,21,32,9,1,17,27,78,Justin Robinson
2021-22,MIL,PG,17,0,198,18,57,.316,10,37,.270,8,20,.400,.404,2,2,1.000,2,11,13,21,8,0,11,17,48,Justin Robinson
2021-22,SAC,PG,3,0,15,1,8,.125,0,3,.000,1,5,.200,.125,0,0,,0,1,1,2,0,0,1,2,2,Justin Robinson
2021-22,DET,PG,5,0,91,9,28,.321,8,21,.381,1,7,.143,.464,2,6,.333,2,5,7,9,1,1,5,8,28,Justin Robinson
2018-19,NYK,C,66,19,1360,202,291,.694,0,0,202,291,.694,.694,81,135,.600,177,246,423,37,52,161,35,217,485,0,Mitchell Robinson
2019-20,NYK,C,61,7,1412,253,341,.742,0,0,253,341,.742,.742,84,148,.568,186,242,428,36,52,119,37,194,590,0,Mitchell Robinson
2020-21,NYK,C,31,29,853,115,176,.653,0,0,115,176,.653,.653,26,53,.491,113,139,252,17,35,45,26,86,256,0,Mitchell Robinson
2021-22,NYK,C,72,62,1848,261,343,.761,0,0,261,343,.761,.761,88,181,.486,295,322,617,38,58,133,60,195,610,0,Mitchell Robinson
2022-23,NYK,C,59,58,1591,188,280,.671,0,0,188,280,.671,.671,59,122,.484,267,288,555,53,56,109,41,160,435,0,Mitchell Robinson
2023-24,NYK,C,31,21,768,73,127,.575,0,0,73,127,.575,.575,27,66,.409,142,121,263,18,37,35,25,55,173,0,Mitchell Robinson
2022-23,MIA,C,31,1,425,47,89,.528,0,6,.000,47,83,.566,.528,22,31,.710,48,78,126,25,12,12,16,53,116,Orlando Robinson
2023-24,MIA,C,36,7,304,36,72,.500,8,15,.533,28,57,.491,.556,19,25,.760,28,56,84,34,7,8,18,35,99,Orlando Robinson
2024-25,SAC,C,8,0,50,6,15,.400,1,5,.200,5,10,.500,.433,3,6,.500,3,9,12,9,2,1,3,6,16,Orlando Robinson
2021-22,OKC,C,49,36,1087,134,324,.414,58,165,.352,76,159,.478,.503,40,54,.741,75,199,274,49,29,15,39,75,366,Jeremiah Robinson-Earl
2022-23,OKC,PF,43,20,814,110,248,.444,37,111,.333,73,137,.533,.518,35,42,.833,71,109,180,43,24,11,19,71,292,Jeremiah Robinson-Earl
2023-24,NOP,PF,39,1,334,45,95,.474,13,39,.333,32,56,.571,.542,12,16,.750,23,53,76,21,10,4,16,24,115,Jeremiah Robinson-Earl
2024-25,NOP,PF,29,4,563,74,168,.440,23,75,.307,51,93,.548,.509,25,29,.862,59,81,140,35,22,3,24,38,196,Jeremiah Robinson-Earl
2019-20,OKC,PF,3,0,11,0,1,.000,0,0,,0,1,.000,.000,0,0,,0,2,2,0,0,0,1,1,0,Isaiah Roby
2020-21,OKC,PF,61,34,1425,207,429,.483,32,109,.294,175,320,.547,.520,87,117,.744,89,252,341,107,52,37,113,162,533,Isaiah Roby
2021-22,OKC,PF,45,28,948,166,323,.514,44,99,.444,122,224,.545,.582,78,116,.672,75,142,217,71,36,34,43,109,454,Isaiah Roby
2022-23,SAS,PF,42,2,474,67,155,.432,18,60,.300,49,95,.516,.490,20,41,.488,21,86,107,38,18,7,31,53,172,Isaiah Roby
2022-23,MEM,PF,70,4,1258,180,420,.429,65,212,.307,115,208,.553,.506,41,65,.631,50,143,193,59,29,19,57,107,466,David Roddy
2023-24,2TM,PF,65,13,1177,165,409,.403,48,164,.293,117,245,.478,.462,47,68,.691,53,158,211,80,27,11,57,72,425,David Roddy
2023-24,MEM,PF,48,13,1114,155,386,.402,47,156,.301,108,230,.470,.462,46,67,.687,51,149,200,76,25,11,54,68,403,David Roddy
2023-24,PHO,PF,17,0,63,10,23,.435,1,8,.125,9,15,.600,.457,1,1,1.000,2,9,11,4,2,0,3,4,22,David Roddy
2024-25,ATL,PF,16,1,215,29,51,.569,11,26,.423,18,25,.720,.676,11,13,.846,4,38,42,19,6,3,14,11,80,David Roddy
2022-23,GSW,PG,12,0,62,7,20,.350,3,9,.333,4,11,.364,.425,6,6,1.000,3,9,12,6,1,1,16,10,23,Ryan Rollins
2023-24,2TM,PG,13,0,78,14,27,.519,3,4,.750,11,23,.478,.574,13,17,.765,2,11,13,14,10,3,8,8,44,Ryan Rollins
2023-24,WAS,PG,10,0,66,13,25,.520,2,3,.667,11,22,.500,.560,13,17,.765,2,9,11,11,8,3,7,7,41,Ryan Rollins
2023-24,MIL,PG,3,0,12,1,2,.500,1,1,1.000,0,1,.000,.750,0,0,,0,2,2,3,2,0,1,1,3,Ryan Rollins
2024-25,MIL,PG,15,4,166,25,55,.455,12,27,.444,13,28,.464,.564,7,9,.778,5,18,23,17,16,6,16,17,69,Ryan Rollins
2015-16,BOS,PG,39,0,311,29,106,.274,6,27,.222,23,79,.291,.302,8,10,.800,24,39,63,37,6,1,19,23,72,Terry Rozier
2016-17,BOS,PG,74,0,1263,151,411,.367,57,179,.318,94,232,.405,.437,51,66,.773,40,187,227,131,46,11,47,69,410,Terry Rozier
2017-18,BOS,PG,80,16,2068,316,800,.395,153,402,.381,163,398,.410,.491,115,149,.772,63,313,376,232,80,19,80,123,900,Terry Rozier
2018-19,BOS,PG,79,14,1791,258,666,.387,119,337,.353,139,329,.422,.477,73,93,.785,32,275,307,231,68,21,68,101,708,Terry Rozier
2019-20,CHO,PG,63,63,2164,398,941,.423,172,423,.407,226,518,.436,.514,166,190,.874,50,226,276,259,61,10,141,126,1134,Terry Rozier
2020-21,CHO,SG,69,69,2383,510,1134,.450,222,571,.389,288,563,.512,.548,165,202,.817,47,255,302,293,87,26,128,119,1407,Terry Rozier
2021-22,CHO,SG,73,73,2458,518,1167,.444,222,593,.374,296,574,.516,.539,150,176,.852,56,259,315,326,93,25,96,119,1408,Terry Rozier
2022-23,CHO,SG,63,63,2221,493,1188,.415,165,505,.327,328,683,.480,.484,178,220,.809,51,208,259,319,74,16,134,119,1329,Terry Rozier
2023-24,2TM,SG,61,60,2040,442,998,.443,149,410,.363,293,588,.498,.518,172,198,.869,35,212,247,342,63,21,106,101,1205,Terry Rozier
2023-24,CHO,SG,30,30,1065,252,549,.459,83,232,.358,169,317,.533,.535,109,129,.845,17,100,117,198,32,12,65,52,696,Terry Rozier
2023-24,MIA,PG,31,30,975,190,449,.423,66,178,.371,124,271,.458,.497,63,69,.913,18,112,130,144,31,9,41,49,509,Terry Rozier
2024-25,MIA,PG,25,12,716,107,265,.404,45,130,.346,62,135,.459,.489,43,49,.878,19,80,99,73,16,9,37,37,302,Terry Rozier
2023-24,POR,SG,39,12,633,54,161,.335,28,78,.359,26,83,.313,.422,19,25,.760,24,68,92,62,12,3,31,56,155,Rayan Rupert
2024-25,POR,SG,23,0,235,29,67,.433,9,30,.300,20,37,.541,.500,12,16,.750,17,18,35,11,7,2,13,16,79,Rayan Rupert
2015-16,LAL,PG,80,48,2259,392,956,.410,130,370,.351,262,586,.447,.478,140,190,.737,47,227,274,266,93,13,196,142,1054,D'Angelo Russell
2016-17,LAL,PG,63,60,1811,351,867,.405,135,384,.352,216,483,.447,.483,147,188,.782,31,190,221,303,87,16,176,130,984,D'Angelo Russell
2017-18,BRK,PG,48,35,1234,278,672,.414,90,278,.324,188,394,.477,.481,97,131,.740,30,159,189,249,36,17,147,93,743,D'Angelo Russell
2018-19,BRK,PG,81,81,2448,659,1517,.434,234,635,.369,425,882,.482,.512,160,205,.780,53,262,315,563,100,20,253,141,1712,D'Angelo Russell
2019-20,2TM,PG,45,45,1452,360,846,.426,158,431,.367,202,415,.487,.519,161,199,.809,17,160,177,285,48,13,147,86,1039,D'Angelo Russell
2019-20,GSW,PG,33,33,1060,273,635,.430,120,321,.374,153,314,.487,.524,113,144,.785,14,108,122,206,31,9,101,64,779,D'Angelo Russell
2019-20,MIN,PG,12,12,392,87,211,.412,38,110,.345,49,101,.485,.502,48,55,.873,3,52,55,79,17,4,46,22,260,D'Angelo Russell
2020-21,MIN,PG,42,26,1196,281,652,.431,120,310,.387,161,342,.471,.523,114,149,.765,16,95,111,244,45,18,112,68,796,D'Angelo Russell
2021-22,MIN,PG,65,65,2077,401,975,.411,176,518,.340,225,457,.492,.502,198,240,.825,25,191,216,460,62,22,165,130,1176,D'Angelo Russell
2022-23,2TM,PG,71,71,2304,445,948,.469,194,490,.396,251,458,.548,.572,179,216,.829,35,180,215,437,70,29,186,140,1263,D'Angelo Russell
2022-23,MIN,PG,54,54,1778,338,727,.465,148,379,.391,190,348,.546,.567,143,167,.856,28,137,165,334,60,21,147,117,967,D'Angelo Russell
2022-23,LAL,PG,17,17,526,107,221,.484,46,111,.414,61,110,.555,.588,36,49,.735,7,43,50,103,10,8,39,23,296,D'Angelo Russell
2023-24,LAL,PG,76,69,2484,492,1080,.456,226,545,.415,266,535,.497,.560,159,192,.828,28,208,236,482,69,36,156,156,1369,D'Angelo Russell
2024-25,LAL,PG,28,10,735,125,301,.415,55,164,.335,70,137,.511,.507,45,53,.849,8,70,78,132,23,4,49,52,350,D'Angelo Russell
2021-22,BOS,SF,1,0,5,1,5,.200,1,5,.200,0,0,,.300,0,0,,0,0,0,0,1,0,0,0,3,Matt Ryan
2022-23,2TM,SF,34,0,310,40,108,.370,32,84,.381,8,24,.333,.519,10,12,.833,4,22,26,16,5,1,7,27,122,Matt Ryan
2022-23,LAL,SF,12,0,129,15,49,.306,13,35,.371,2,14,.143,.439,4,5,.800,2,12,14,4,2,0,3,14,47,Matt Ryan
2022-23,MIN,SF,22,0,181,25,59,.424,19,49,.388,6,10,.600,.585,6,7,.857,2,10,12,12,3,1,4,13,75,Matt Ryan
2023-24,NOP,SF,28,1,390,49,113,.434,41,91,.451,8,22,.364,.615,13,14,.929,6,34,40,18,6,1,19,32,152,Matt Ryan
2024-25,NYK,SF,9,0,45,6,21,.286,3,14,.214,3,7,.429,.357,0,0,,0,2,2,0,1,0,3,0,15,Matt Ryan
2016-17,OKC,PF,81,66,1632,192,481,.399,51,159,.321,141,322,.438,.452,44,67,.657,46,242,288,82,39,32,83,200,479,Domantas Sabonis
2017-18,IND,C,74,19,1810,340,661,.514,13,37,.351,327,624,.524,.524,168,224,.750,165,407,572,151,40,32,137,220,861,Domantas Sabonis
2018-19,IND,C,74,5,1838,413,700,.590,9,17,.529,404,683,.592,.596,208,291,.715,186,504,690,212,48,30,160,239,1043,Domantas Sabonis
2019-20,IND,PF,62,62,2159,458,848,.540,17,67,.254,441,781,.565,.550,214,296,.723,189,582,771,310,47,30,170,195,1147,Domantas Sabonis
2020-21,IND,PF,62,62,2231,484,904,.535,52,162,.321,432,742,.582,.564,240,328,.732,150,592,742,415,76,33,213,203,1260,Domantas Sabonis
2021-22,2TM,PF,62,61,2136,443,773,.573,39,125,.312,404,648,.623,.598,246,332,.741,201,551,752,323,59,27,195,203,1171,Domantas Sabonis
2021-22,IND,PF,47,46,1632,331,571,.580,35,108,.324,296,463,.639,.610,191,258,.740,155,412,567,236,46,22,143,146,888,Domantas Sabonis
2021-22,SAC,PF,15,15,504,112,202,.554,4,17,.235,108,185,.584,.564,55,74,.743,46,139,185,87,13,5,52,57,283,Domantas Sabonis
2022-23,SAC,C,79,79,2736,577,938,.615,31,83,.373,546,855,.639,.632,325,438,.742,251,722,973,573,65,39,230,279,1510,Domantas Sabonis
2023-24,SAC,C,82,82,2928,634,1068,.594,33,87,.379,601,981,.613,.609,292,415,.704,294,826,1120,673,74,48,272,250,1593,Domantas Sabonis
2024-25,SAC,C,28,28,1007,231,383,.603,28,67,.418,203,316,.642,.640,102,129,.791,99,280,379,169,23,12,81,96,592,Domantas Sabonis
2024-25,CHO,PF,26,8,490,42,130,.323,26,86,.302,16,44,.364,.423,15,22,.682,28,80,108,29,15,5,21,34,125,Tidjane Salaün
2019-20,SAS,PF,3,1,48,5,16,.313,3,8,.375,2,8,.250,.406,3,4,.750,1,9,10,6,0,2,2,6,16,Luka Šamanić
2020-21,SAS,PF,33,4,308,47,105,.448,12,43,.279,35,62,.565,.505,16,29,.552,16,52,68,15,8,8,20,43,122,Luka Šamanić
2022-23,UTA,PF,7,4,161,26,57,.456,8,31,.258,18,26,.692,.526,9,13,.692,0,30,30,15,6,2,10,17,69,Luka Šamanić
2023-24,UTA,PF,43,7,404,60,158,.380,13,64,.203,47,94,.500,.421,44,56,.786,22,80,102,19,5,7,28,32,177,Luka Šamanić
2018-19,CHI,SG,14,2,214,28,60,.467,11,29,.379,17,31,.548,.558,4,6,.667,3,13,16,10,8,3,12,19,71,Brandon Sampson
2023-24,HOU,SF,14,0,60,9,14,.643,0,2,.000,9,12,.750,.643,2,2,1.000,3,10,13,3,1,2,0,5,20,Jermaine Samuels
2023-24,CHI,PF,9,0,66,14,27,.519,0,0,14,27,.519,.519,8,12,.667,19,17,36,0,1,0,5,5,36,0,Adama Sanogo
2024-25,CHI,C,4,0,21,4,7,.571,0,0,4,7,.571,.571,0,0,,5,1,6,1,0,0,1,1,8,0,Adama Sanogo
2023-24,GSW,PF,23,0,192,28,55,.509,10,27,.370,18,28,.643,.600,16,17,.941,17,32,49,14,4,2,7,23,82,Gui Santos
2024-25,GSW,PF,8,0,35,2,6,.333,1,4,.250,1,2,.500,.417,1,2,.500,2,6,8,3,0,1,3,6,6,Gui Santos
2016-17,PHI,PF,81,36,2129,381,927,.411,106,341,.311,275,586,.469,.468,172,220,.782,112,401,513,182,57,30,183,162,1040,Dario Šarić
2017-18,PHI,PF,78,73,2310,403,890,.453,157,399,.393,246,491,.501,.541,178,207,.860,154,366,520,202,51,20,148,160,1141,Dario Šarić
2018-19,2TM,PF,81,41,2023,304,696,.437,118,323,.365,186,373,.499,.522,132,150,.880,126,331,457,127,45,9,97,182,858,Dario Šarić
2018-19,PHI,PF,13,13,396,48,132,.364,21,70,.300,27,62,.435,.443,27,30,.900,21,65,86,26,4,3,25,39,144,Dario Šarić
2018-19,MIN,PF,68,28,1627,256,564,.454,97,253,.383,159,311,.511,.540,105,120,.875,105,266,371,101,41,6,72,143,714,Dario Šarić
2019-20,PHO,PF,66,51,1632,256,538,.476,84,235,.357,172,303,.568,.554,108,128,.844,100,306,406,123,37,16,88,156,704,Dario Šarić
2020-21,PHO,C,50,4,871,153,342,.447,47,135,.348,106,207,.512,.516,84,99,.848,46,144,190,65,30,4,57,95,437,Dario Šarić
2022-23,2TM,C,57,12,806,127,277,.458,45,115,.391,82,162,.506,.540,63,76,.829,53,154,207,74,20,7,55,99,362,Dario Šarić
2022-23,PHO,PF,37,12,533,76,178,.427,27,69,.391,49,109,.450,.503,36,44,.818,39,103,142,57,13,5,36,69,215,Dario Šarić
2022-23,OKC,C,20,0,273,51,99,.515,18,46,.391,33,53,.623,.606,27,32,.844,14,51,65,17,7,2,19,30,147,Dario Šarić
2023-24,GSW,C,64,9,1098,181,388,.466,74,197,.376,107,191,.560,.562,79,93,.849,73,210,283,144,31,10,78,112,515,Dario Šarić
2024-25,DEN,C,10,3,136,12,40,.300,5,19,.263,7,21,.333,.363,5,6,.833,9,26,35,11,6,0,11,14,34,Dario Šarić
2024-25,WAS,C,25,25,680,108,268,.403,35,116,.302,73,152,.480,.468,33,54,.611,49,107,156,52,19,46,37,67,284,Alex Sarr
2021-22,OKC,C,22,2,421,58,101,.574,13,29,.448,45,72,.625,.639,24,29,.828,34,59,93,19,6,15,22,52,153,Olivier Sarr
2022-23,OKC,C,9,1,114,15,30,.500,1,8,.125,14,22,.636,.517,5,7,.714,12,19,31,4,1,5,4,17,36,Olivier Sarr
2023-24,OKC,C,15,0,98,11,19,.579,2,6,.333,9,13,.692,.632,10,15,.667,10,26,36,2,0,7,3,18,34,Olivier Sarr
2023-24,DET,PG,71,11,1351,219,512,.428,90,240,.375,129,272,.474,.516,58,66,.879,11,114,125,236,44,12,90,103,586,Marcus Sasser
2024-25,DET,PG,20,0,267,50,94,.532,18,44,.409,32,50,.640,.628,6,6,1.000,7,12,19,36,17,3,15,22,124,Marcus Sasser
2021-22,WAS,SG,4,0,30,1,11,.091,1,6,.167,0,5,.000,.136,2,2,1.000,2,6,8,0,1,0,1,0,5,Jordan Schakel
2022-23,WAS,SF,2,0,6,1,2,.500,1,1,1.000,0,1,.000,.750,0,0,,0,0,0,1,1,0,0,1,3,Jordan Schakel
2024-25,BOS,SG,5,0,34,1,10,.100,0,6,.000,1,4,.250,.100,2,2,1.000,2,5,7,2,1,0,0,3,4,Baylor Scheierman
2019-20,WAS,PF,33,2,368,35,92,.380,19,61,.311,16,31,.516,.484,10,15,.667,7,40,47,15,8,4,7,50,99,Admiral Schofield
2021-22,ORL,SF,38,1,469,54,129,.419,26,79,.329,28,50,.560,.519,12,15,.800,17,72,89,25,4,5,21,58,146,Admiral Schofield
2022-23,ORL,PF,37,0,451,55,122,.451,24,74,.324,31,48,.646,.549,21,23,.913,23,39,62,31,8,5,16,61,155,Admiral Schofield
2023-24,ORL,PF,23,0,84,10,26,.385,6,16,.375,4,10,.400,.500,0,2,.000,3,14,17,7,1,0,5,9,26,Admiral Schofield
2013-14,ATL,PG,49,0,641,72,188,.383,10,42,.238,62,146,.425,.410,29,43,.674,5,55,60,93,17,0,61,54,183,Dennis Schröder
2014-15,ATL,PG,77,10,1516,284,665,.427,52,148,.351,232,517,.449,.466,148,179,.827,29,135,164,317,49,4,150,127,768,Dennis Schröder
2015-16,ATL,PG,80,6,1621,329,781,.421,77,239,.322,252,542,.465,.471,144,182,.791,25,179,204,349,70,9,183,138,879,Dennis Schröder
2016-17,ATL,PG,79,78,2485,548,1214,.451,100,294,.340,448,920,.487,.493,218,255,.855,42,206,248,499,74,16,258,149,1414,Dennis Schröder
2017-18,ATL,PG,67,67,2078,500,1146,.436,76,262,.290,424,884,.480,.469,225,265,.849,44,164,208,417,72,6,183,147,1301,Dennis Schröder
2018-19,OKC,PG,79,14,2314,457,1104,.414,124,364,.341,333,740,.450,.470,186,227,.819,38,246,284,323,65,12,172,189,1224,Dennis Schröder
2019-20,OKC,PG,65,2,1999,453,965,.469,125,325,.385,328,640,.513,.534,198,236,.839,19,217,236,262,45,14,166,146,1229,Dennis Schröder
2020-21,LAL,SG,61,61,1956,332,760,.437,71,212,.335,261,548,.476,.484,206,243,.848,30,181,211,351,70,13,163,159,941,Dennis Schröder
2021-22,2TM,PG,64,29,1837,312,724,.431,86,250,.344,226,474,.477,.490,157,184,.853,34,180,214,296,53,8,143,154,867,Dennis Schröder
2021-22,BOS,PG,49,25,1433,257,584,.440,67,192,.349,190,392,.485,.497,123,145,.848,28,136,164,208,41,5,104,116,704,Dennis Schröder
2021-22,HOU,PG,15,4,404,55,140,.393,19,58,.328,36,82,.439,.461,34,39,.872,6,44,50,88,12,3,39,38,163,Dennis Schröder
2022-23,LAL,PG,66,50,1986,270,650,.415,74,225,.329,196,425,.461,.472,216,252,.857,21,144,165,298,50,10,112,145,830,Dennis Schröder
2023-24,2TM,PG,80,58,2486,403,927,.435,138,368,.375,265,559,.474,.509,178,213,.836,39,203,242,488,63,17,153,164,1122,Dennis Schröder
2023-24,TOR,PG,51,33,1559,247,559,.442,77,220,.350,170,339,.501,.511,127,149,.852,22,118,140,313,46,8,83,105,698,Dennis Schröder
2023-24,BRK,PG,29,25,927,156,368,.424,61,148,.412,95,220,.432,.507,51,64,.797,17,85,102,175,17,9,70,59,424,Dennis Schröder
2024-25,2TM,PG,28,28,904,161,375,.429,62,173,.358,99,202,.490,.512,81,93,.871,4,71,75,173,29,5,70,71,465,Dennis Schröder
2024-25,BRK,PG,23,23,772,147,325,.452,58,150,.387,89,175,.509,.542,72,81,.889,4,64,68,152,26,4,59,56,424,Dennis Schröder
2024-25,GSW,PG,5,5,132,14,50,.280,4,23,.174,10,27,.370,.320,9,12,.750,0,7,7,21,3,1,11,15,41,Dennis Schröder
2020-21,LAC,SG,4,1,84,14,36,.389,2,9,.222,12,27,.444,.417,5,5,1.000,2,12,14,1,4,0,7,5,35,Jay Scrubb
2021-22,LAC,SG,18,0,121,18,46,.391,6,21,.286,12,25,.480,.457,7,10,.700,2,14,16,8,4,3,7,9,49,Jay Scrubb
2022-23,ORL,SG,2,0,30,5,7,.714,2,2,1.000,3,5,.600,.857,1,2,.500,0,6,6,1,2,0,3,2,13,Jay Scrubb
2022-23,NOP,SG,5,0,12,2,5,.400,0,0,,2,5,.400,.400,0,0,,1,0,1,0,0,0,0,1,4,Dereon Seabron
2023-24,NOP,SG,6,0,55,4,13,.308,1,2,.500,3,11,.273,.346,5,6,.833,1,6,7,5,2,1,0,4,14,Dereon Seabron
2021-22,HOU,C,72,13,1489,249,525,.474,29,117,.248,220,408,.539,.502,165,232,.711,138,255,393,185,59,68,145,214,692,Alperen Sengun
2022-23,HOU,C,75,72,2171,442,799,.553,19,57,.333,423,742,.570,.565,206,288,.715,242,436,678,291,70,70,193,258,1109,Alperen Sengun
2023-24,HOU,C,63,63,2046,527,982,.537,33,111,.297,494,871,.567,.553,244,352,.693,183,406,589,312,76,46,162,211,1331,Alperen Sengun
2024-25,HOU,C,31,31,968,231,473,.488,11,47,.234,220,426,.516,.500,115,152,.757,108,220,328,158,36,30,71,84,588,Alperen Sengun
2023-24,UTA,SF,32,11,584,85,218,.390,34,115,.296,51,103,.495,.468,37,41,.902,16,86,102,55,13,6,47,43,241,Brice Sensabaugh
2024-25,UTA,SF,23,0,379,62,141,.440,34,88,.386,28,53,.528,.560,16,18,.889,15,41,56,30,15,2,33,25,174,Brice Sensabaugh
2018-19,CLE,PG,82,72,2605,519,1206,.430,119,296,.402,400,910,.440,.480,214,255,.839,57,179,236,243,44,6,185,186,1371,Collin Sexton
2019-20,CLE,PG,65,65,2143,513,1086,.472,97,255,.380,416,831,.501,.517,226,267,.846,61,143,204,192,65,7,158,142,1349,Collin Sexton
2020-21,CLE,SG,60,60,2115,525,1105,.475,98,264,.371,427,841,.508,.519,312,383,.815,58,129,187,262,62,10,167,157,1460,Collin Sexton
2021-22,CLE,SG,11,11,316,68,151,.450,11,45,.244,57,106,.538,.487,29,39,.744,13,23,36,23,10,0,31,25,176,Collin Sexton
2022-23,UTA,PG,48,15,1145,237,468,.506,48,122,.393,189,346,.546,.558,163,199,.819,37,68,105,138,27,6,85,112,685,Collin Sexton
2023-24,UTA,SG,78,51,2075,506,1038,.487,128,325,.394,378,713,.530,.549,318,370,.859,71,134,205,383,62,18,165,154,1458,Collin Sexton
2024-25,UTA,SG,29,27,820,176,366,.481,56,129,.434,120,237,.506,.557,90,101,.891,23,50,73,106,23,3,76,68,498,Collin Sexton
2018-19,2TM,SG,79,27,1802,240,557,.431,167,396,.422,73,161,.453,.581,75,93,.806,21,113,134,117,37,10,45,155,722,Landry Shamet
2018-19,PHI,SG,54,4,1108,153,347,.441,99,245,.404,54,102,.529,.584,44,54,.815,14,64,78,59,24,8,26,106,449,Landry Shamet
2018-19,LAC,SG,25,23,694,87,210,.414,68,151,.450,19,59,.322,.576,31,39,.795,7,49,56,58,13,2,19,49,273,Landry Shamet
2019-20,LAC,SG,53,30,1452,158,391,.404,111,296,.375,47,95,.495,.546,65,76,.855,6,94,100,99,20,10,42,142,492,Landry Shamet
2020-21,BRK,SG,61,12,1403,186,456,.408,129,333,.387,57,123,.463,.549,66,78,.846,11,101,112,99,31,10,48,93,567,Landry Shamet
2021-22,PHO,SG,69,14,1437,191,485,.394,123,334,.368,68,151,.450,.521,68,81,.840,16,110,126,108,28,9,41,92,573,Landry Shamet
2022-23,PHO,SG,40,9,807,113,300,.377,75,199,.377,38,101,.376,.502,45,51,.882,11,56,67,93,26,5,36,61,346,Landry Shamet
2023-24,WAS,SG,46,5,726,118,274,.431,53,157,.338,65,117,.556,.527,38,46,.826,16,46,62,54,25,10,30,76,327,Landry Shamet
2024-25,NYK,SG,2,0,12,4,5,.800,1,1,1.000,3,4,.750,.900,0,0,,0,1,1,0,2,0,0,0,9,Landry Shamet
2024-25,MIN,SG,10,0,45,7,13,.538,1,3,.333,6,10,.600,.577,0,0,0,2,2,5,2,1,3,1,15,0,Terrence Shannon Jr.
2021-22,BRK,PF,32,8,391,86,149,.577,2,7,.286,84,142,.592,.584,24,41,.585,81,79,160,17,10,15,30,60,198,Day'Ron Sharpe
2022-23,BRK,C,48,3,552,93,171,.544,6,11,.545,87,160,.544,.561,35,55,.636,99,101,200,37,15,32,42,89,227,Day'Ron Sharpe
2023-24,BRK,C,61,1,921,168,294,.571,4,15,.267,164,279,.588,.578,75,123,.610,161,228,389,85,24,44,70,131,415,Day'Ron Sharpe
2024-25,BRK,C,10,0,150,23,57,.404,2,11,.182,21,46,.457,.421,15,17,.882,25,28,53,8,9,4,11,17,63,Day'Ron Sharpe
2022-23,POR,SG,80,15,1779,306,648,.472,102,283,.360,204,365,.559,.551,75,105,.714,63,173,236,94,38,24,83,136,789,Shaedon Sharpe
2023-24,POR,SG,32,25,1059,176,434,.406,60,180,.333,116,254,.457,.475,98,119,.824,42,118,160,94,28,12,72,88,510,Shaedon Sharpe
2024-25,POR,SG,22,20,668,146,320,.456,41,139,.295,105,181,.580,.520,60,75,.800,15,63,78,55,18,6,36,36,393,Shaedon Sharpe
2019-20,PHI,SG,4,0,28,3,12,.250,2,6,.333,1,6,.167,.333,3,4,.750,1,6,7,1,0,1,3,4,11,Marial Shayok
2024-25,TOR,PG,27,0,409,54,131,.412,18,55,.327,36,76,.474,.481,9,12,.750,5,27,32,86,15,3,37,51,135,Jamal Shead
2023-24,IND,SG,57,1,814,90,229,.393,49,156,.314,41,73,.562,.500,23,26,.885,15,74,89,53,33,2,15,88,252,Ben Sheppard
2024-25,IND,SG,18,6,358,37,87,.425,24,62,.387,13,25,.520,.563,0,0,,8,31,39,20,7,5,7,43,98,Ben Sheppard
2024-25,HOU,PG,29,0,344,38,118,.322,19,68,.279,19,50,.380,.403,5,6,.833,10,28,38,35,15,10,17,28,100,Reed Sheppard
2016-17,TOR,PF,55,38,859,103,205,.502,1,7,.143,102,198,.515,.505,22,32,.688,64,121,185,17,26,45,33,109,229,Pascal Siakam
2017-18,TOR,PF,81,5,1679,253,498,.508,29,132,.220,224,366,.612,.537,54,87,.621,79,285,364,159,62,42,67,166,589,Pascal Siakam
2018-19,TOR,PF,80,79,2548,519,945,.549,79,214,.369,440,731,.602,.591,237,302,.785,124,425,549,248,73,52,154,241,1354,Pascal Siakam
2019-20,TOR,PF,60,60,2110,500,1104,.453,131,365,.359,369,739,.499,.512,240,303,.792,64,375,439,207,61,53,148,170,1371,Pascal Siakam
2020-21,TOR,PF,56,56,2006,437,961,.455,73,246,.297,364,715,.509,.493,249,301,.827,95,310,405,250,64,37,130,174,1196,Pascal Siakam
2021-22,TOR,PF,68,68,2578,596,1207,.494,75,218,.344,521,989,.527,.525,284,379,.749,128,452,580,360,85,42,181,225,1551,Pascal Siakam
2022-23,TOR,PF,71,71,2652,630,1313,.480,93,287,.324,537,1026,.523,.515,367,474,.774,131,425,556,415,65,36,169,228,1720,Pascal Siakam
2023-24,2TM,PF,80,80,2657,681,1271,.536,85,246,.346,596,1025,.581,.569,290,396,.732,139,426,565,342,63,25,141,193,1737,Pascal Siakam
2023-24,TOR,PF,39,39,1354,325,623,.522,46,145,.317,279,478,.584,.559,169,223,.758,54,192,246,190,32,10,83,87,865,Pascal Siakam
2023-24,IND,PF,41,41,1303,356,648,.549,39,101,.386,317,547,.580,.579,121,173,.699,85,234,319,152,31,15,58,106,872,Pascal Siakam
2024-25,IND,PF,32,32,1084,243,466,.521,63,144,.438,180,322,.559,.589,89,115,.774,54,175,229,105,29,9,44,94,638,Pascal Siakam
2019-20,MIA,PF,44,0,346,48,78,.615,0,3,.000,48,75,.640,.615,37,55,.673,60,66,126,23,9,21,32,85,133,Chris Silva
2020-21,2TM,PF,15,0,92,10,16,.625,1,1,1.000,9,15,.600,.656,11,15,.733,7,20,27,6,1,6,10,24,32,Chris Silva
2020-21,MIA,PF,11,0,83,9,13,.692,1,1,1.000,8,12,.667,.731,11,15,.733,7,18,25,6,1,5,9,20,30,Chris Silva
2020-21,SAC,PF,4,0,9,1,3,.333,0,0,,1,3,.333,.333,0,0,,0,2,2,0,0,1,1,4,2,Chris Silva
2021-22,2TM,PF,10,0,91,8,15,.533,0,0,,8,15,.533,.533,10,12,.833,13,23,36,7,0,1,8,20,26,Chris Silva
2021-22,MIN,PF,1,0,3,0,0,,0,0,,0,0,,,0,0,,0,1,1,0,0,0,0,0,0,Chris Silva
2021-22,MIA,PF,9,0,88,8,15,.533,0,0,,8,15,.533,.533,10,12,.833,13,22,35,7,0,1,8,20,26,Chris Silva
2022-23,DAL,PF,1,0,3,1,1,1.000,0,0,,1,1,1.000,1.000,0,0,,0,0,0,0,0,0,1,2,2,Chris Silva
2017-18,PHI,PG,81,81,2732,544,998,.545,0,11,.000,544,987,.551,.545,191,341,.560,145,514,659,661,140,70,278,211,1279,Ben Simmons
2018-19,PHI,PG,79,79,2700,540,960,.563,0,6,.000,540,954,.566,.563,257,428,.600,172,525,697,610,112,61,274,209,1337,Ben Simmons
2019-20,PHI,PG,57,57,2017,375,647,.580,2,7,.286,373,640,.583,.581,185,298,.621,113,331,444,455,119,33,200,186,937,Ben Simmons
2020-21,PHI,PG,58,58,1877,325,583,.557,3,10,.300,322,573,.562,.560,176,287,.613,93,324,417,401,93,35,173,171,829,Ben Simmons
2022-23,BRK,PG,42,33,1105,133,235,.566,0,2,.000,133,233,.571,.566,25,57,.439,40,223,263,256,54,24,97,139,291,Ben Simmons
2023-24,BRK,PG,15,12,359,43,74,.581,0,0,,43,74,.581,.581,6,15,.400,31,88,119,86,12,9,27,36,92,Ben Simmons
2024-25,BRK,PG,24,18,598,65,115,.565,0,0,,65,115,.565,.565,15,21,.714,22,105,127,166,21,12,70,55,145,Ben Simmons
2017-18,MEM,PG,32,12,643,80,189,.423,11,39,.282,69,150,.460,.452,25,25,1.000,14,36,50,68,18,5,44,61,196,Kobi Simmons
2018-19,CLE,PG,1,0,2,0,0,,0,0,,0,0,,,0,0,,0,0,0,0,0,0,0,0,0,Kobi Simmons
2022-23,CHO,SG,5,0,28,1,6,.167,1,5,.200,0,1,.000,.250,2,2,1.000,1,3,4,5,0,2,1,0,5,Kobi Simmons
2023-24,TOR,PG,4,0,67,9,21,.429,2,8,.250,7,13,.538,.476,0,0,,1,6,7,12,6,2,1,5,20,Kobi Simmons
2021-22,CHI,C,9,0,35,4,15,.267,1,5,.200,3,10,.300,.300,8,11,.727,5,5,10,0,1,1,2,6,17,Marko Simonovic
2022-23,CHI,C,7,0,20,2,7,.286,1,4,.250,1,3,.333,.357,1,2,.500,1,1,2,0,0,0,0,5,6,Marko Simonovic
2018-19,POR,SG,20,1,141,28,63,.444,10,29,.345,18,34,.529,.524,9,16,.563,3,10,13,13,1,0,11,9,75,Anfernee Simons
2019-20,POR,SG,70,4,1449,214,536,.399,75,226,.332,139,310,.448,.469,76,92,.826,25,127,152,97,26,10,61,135,579,Anfernee Simons
2020-21,POR,SG,64,0,1104,168,401,.419,120,282,.426,48,119,.403,.569,46,57,.807,14,126,140,89,18,8,43,96,502,Anfernee Simons
2021-22,POR,SG,57,30,1681,353,797,.443,179,442,.405,174,355,.490,.555,103,116,.888,26,125,151,221,30,6,115,110,988,Anfernee Simons
2022-23,POR,SG,62,62,2171,467,1045,.447,212,562,.377,255,483,.528,.548,160,179,.894,18,143,161,253,42,14,128,142,1306,Anfernee Simons
2023-24,POR,SG,46,46,1582,360,837,.430,156,405,.385,204,432,.472,.523,163,178,.916,22,145,167,255,23,5,126,98,1039,Anfernee Simons
2024-25,POR,SG,27,27,836,163,400,.408,66,206,.320,97,194,.500,.490,68,75,.907,9,60,69,129,28,2,64,52,460,Anfernee Simons
2024-25,CHO,PG,9,0,120,12,40,.300,3,20,.150,9,20,.450,.338,8,10,.800,9,6,15,18,5,2,9,13,35,KJ Simpson
2021-22,OKC,PG,4,4,174,19,52,.365,1,8,.125,18,44,.409,.375,5,5,1.000,2,19,21,30,5,4,10,15,44,Zavier Simpson
2023-24,MEM,PG,7,0,161,17,54,.315,5,17,.294,12,37,.324,.361,3,4,.750,4,16,20,25,7,3,10,11,42,Zavier Simpson
2021-22,NYK,PF,41,5,555,39,54,.722,0,0,,39,54,.722,.722,12,29,.414,61,108,169,21,11,22,20,66,90,Jericho Sims
2022-23,NYK,C,52,16,812,83,107,.776,0,1,.000,83,106,.783,.776,12,16,.750,99,143,242,25,15,28,27,96,178,Jericho Sims
2023-24,NYK,C,45,11,585,38,55,.691,0,0,,38,55,.691,.691,16,24,.667,56,91,147,25,8,19,16,45,92,Jericho Sims
2024-25,NYK,C,28,2,335,22,34,.647,0,0,,22,34,.647,.647,6,9,.667,38,64,102,17,7,9,15,39,50,Jericho Sims
2020-21,DET,SG,20,0,133,14,40,.350,10,28,.357,4,12,.333,.475,3,6,.500,0,29,29,5,2,0,5,9,41,Deividas Sirvydis
2021-22,DET,SG,3,0,27,1,10,.100,1,7,.143,0,3,.000,.150,0,0,,0,6,6,1,3,1,0,4,3,Deividas Sirvydis
2023-24,NYK,C,2,0,2,0,1,.000,0,0,0,1,.000,.000,0,0,0,0,0,0,0,0,0,0,0,0,,Dmytro Skapintsev
2023-24,SAC,SF,12,0,37,4,6,.667,0,2,.000,4,4,1.000,.667,0,0,1,6,7,2,1,1,2,8,8,0,Jalen Slawson
2019-20,GSW,C,14,0,139,20,40,.500,3,13,.231,17,27,.630,.538,16,19,.842,10,17,27,13,3,4,11,14,59,Alen Smailagić
2020-21,GSW,PF,15,1,84,11,27,.407,4,10,.400,7,17,.412,.481,2,6,.333,6,10,16,4,3,5,5,11,28,Alen Smailagić
2021-22,2TM,PG,17,1,200,19,60,.317,8,27,.296,11,33,.333,.383,5,6,.833,5,19,24,16,6,3,11,12,51,Javonte Smart
2021-22,MIL,PG,13,1,160,11,43,.256,4,18,.222,7,25,.280,.302,5,6,.833,4,15,19,14,4,2,9,11,31,Javonte Smart
2021-22,MIA,PG,4,0,40,8,17,.471,4,9,.444,4,8,.500,.588,0,0,,1,4,5,2,2,1,2,1,20,Javonte Smart
2023-24,PHI,PG,1,0,1,0,0,,0,0,,0,0,,,0,0,,0,0,0,0,0,0,0,0,0,Javonte Smart
2014-15,BOS,PG,67,38,1808,175,477,.367,91,272,.335,84,205,.410,.462,82,127,.646,61,161,222,208,99,18,90,176,523,Marcus Smart
2015-16,BOS,PG,61,10,1667,184,529,.348,61,241,.253,123,288,.427,.405,129,166,.777,76,179,255,185,91,18,80,183,558,Marcus Smart
2016-17,BOS,SG,79,24,2399,269,749,.359,94,332,.283,175,417,.420,.422,203,250,.812,78,227,305,364,125,34,159,192,835,Marcus Smart
2017-18,BOS,SG,54,11,1614,189,515,.367,75,249,.301,114,266,.429,.440,97,133,.729,43,146,189,259,71,23,129,133,550,Marcus Smart
2018-19,BOS,SG,80,60,2200,239,567,.422,126,346,.364,113,221,.511,.533,104,129,.806,57,177,234,321,143,28,123,201,708,Marcus Smart
2019-20,BOS,SG,60,40,1919,256,682,.375,137,395,.347,119,287,.415,.476,127,152,.836,42,183,225,291,101,29,103,162,776,Marcus Smart
2020-21,BOS,PG,48,45,1581,203,510,.398,93,282,.330,110,228,.482,.489,128,162,.790,36,131,167,273,72,23,96,126,627,Marcus Smart
2021-22,BOS,PG,71,71,2296,300,718,.418,119,360,.331,181,358,.506,.501,142,179,.793,42,228,270,417,119,18,159,160,861,Marcus Smart
2022-23,BOS,PG,61,61,1957,250,602,.415,115,342,.336,135,260,.519,.511,88,118,.746,46,145,191,382,93,23,143,172,703,Marcus Smart
2023-24,MEM,PG,20,20,605,102,237,.430,42,134,.313,60,103,.583,.519,43,56,.768,6,47,53,86,41,5,62,53,289,Marcus Smart
2024-25,MEM,PG,18,6,382,53,142,.373,29,87,.333,24,55,.436,.475,30,36,.833,14,28,42,69,23,6,34,30,165,Marcus Smart
2017-18,DAL,PG,69,69,2049,404,1024,.395,106,339,.313,298,685,.435,.446,134,193,.694,50,210,260,358,71,18,194,152,1048,Dennis Smith Jr.
2018-19,2TM,PG,53,50,1508,278,650,.428,67,208,.322,211,442,.477,.479,99,156,.635,32,123,155,252,67,20,154,129,722,Dennis Smith Jr.
2018-19,DAL,PG,32,32,908,157,357,.440,43,125,.344,114,232,.491,.500,57,82,.695,18,79,97,138,40,11,100,82,414,Dennis Smith Jr.
2018-19,NYK,PG,21,18,600,121,293,.413,24,83,.289,97,210,.462,.454,42,74,.568,14,44,58,114,27,9,54,47,308,Dennis Smith Jr.
2019-20,NYK,PG,34,3,537,72,211,.341,16,54,.296,56,157,.357,.379,27,53,.509,21,57,78,98,28,8,58,65,187,Dennis Smith Jr.
2020-21,2TM,PG,23,9,420,58,145,.400,19,58,.328,39,87,.448,.466,19,26,.731,12,43,55,77,23,14,26,37,154,Dennis Smith Jr.
2020-21,NYK,PG,3,0,28,2,10,.200,0,4,.000,2,6,.333,.200,5,6,.833,0,2,2,3,3,0,1,4,9,Dennis Smith Jr.
2020-21,DET,PG,20,9,392,56,135,.415,19,54,.352,37,81,.457,.485,14,20,.700,12,41,53,74,20,14,25,33,145,Dennis Smith Jr.
2021-22,POR,PG,37,4,638,79,189,.418,6,27,.222,73,162,.451,.434,42,64,.656,20,68,88,132,45,12,51,52,206,Dennis Smith Jr.
2022-23,CHO,PG,54,15,1390,186,452,.412,24,111,.216,162,341,.475,.438,78,106,.736,27,140,167,261,75,25,82,122,474,Dennis Smith Jr.
2023-24,BRK,PG,56,2,1059,147,338,.435,32,109,.294,115,229,.502,.482,43,58,.741,50,114,164,203,68,12,68,121,369,Dennis Smith Jr.
2022-23,2TM,SG,15,1,158,18,45,.400,5,19,.263,13,26,.500,.456,3,3,1.000,2,22,24,22,10,4,3,23,44,Dru Smith
2022-23,MIA,SG,5,1,67,5,14,.357,1,6,.167,4,8,.500,.393,0,0,,1,8,9,5,4,3,1,10,11,Dru Smith
2022-23,BRK,SG,10,0,91,13,31,.419,4,13,.308,9,18,.500,.484,3,3,1.000,1,14,15,17,6,1,2,13,33,Dru Smith
2023-24,MIA,SG,9,0,131,15,33,.455,7,17,.412,8,16,.500,.561,2,2,1.000,6,8,14,14,9,3,5,12,39,Dru Smith
2024-25,MIA,SG,14,1,268,31,61,.508,16,30,.533,15,31,.484,.639,10,13,.769,12,24,36,23,21,6,17,30,88,Dru Smith
2010-11,2TM,PG,43,3,442,43,115,.374,3,10,.300,40,105,.381,.387,12,21,.571,7,40,47,79,18,2,34,37,101,Ish Smith
2010-11,HOU,PG,28,3,329,32,83,.386,3,8,.375,29,75,.387,.404,7,10,.700,6,36,42,64,13,2,26,26,74,Ish Smith
2010-11,MEM,PG,15,0,113,11,32,.344,0,2,.000,11,30,.367,.344,5,11,.455,1,4,5,15,5,0,8,11,27,Ish Smith
2011-12,2TM,PG,26,1,234,31,81,.383,3,9,.333,28,72,.389,.401,7,10,.700,7,28,35,41,15,2,13,15,72,Ish Smith
2011-12,GSW,PG,6,1,63,12,30,.400,2,5,.400,10,25,.400,.433,1,2,.500,2,7,9,9,4,0,1,4,27,Ish Smith
2011-12,ORL,PG,20,0,171,19,51,.373,1,4,.250,18,47,.383,.382,6,8,.750,5,21,26,32,11,2,12,11,45,Ish Smith
2012-13,2TM,PG,52,3,516,56,159,.352,8,27,.296,48,132,.364,.377,3,7,.429,12,49,61,87,21,9,37,26,123,Ish Smith
2012-13,ORL,PG,36,3,378,39,116,.336,4,17,.235,35,99,.354,.353,3,7,.429,11,35,46,57,13,6,27,14,85,Ish Smith
2012-13,MIL,PG,16,0,138,17,43,.395,4,10,.400,13,33,.394,.442,0,0,,1,14,15,30,8,3,10,12,38,Ish Smith
2013-14,PHO,PG,70,1,1006,119,281,.423,1,23,.043,118,258,.457,.425,22,39,.564,31,98,129,179,49,13,65,66,261,Ish Smith
2014-15,2TM,PG,55,14,832,143,367,.390,18,60,.300,125,307,.407,.414,34,57,.596,15,85,100,180,36,6,78,50,338,Ish Smith
2014-15,OKC,PG,30,0,155,15,45,.333,1,5,.200,14,40,.350,.344,6,9,.667,5,22,27,28,4,1,9,12,37,Ish Smith
2014-15,PHI,PG,25,14,677,128,322,.398,17,55,.309,111,267,.416,.424,28,48,.583,10,63,73,152,32,5,69,38,301,Ish Smith
2015-16,2TM,PG,77,53,2239,397,967,.411,56,170,.329,341,797,.428,.440,122,176,.693,43,262,305,502,88,24,175,133,972,Ish Smith
2015-16,NOP,PG,27,3,617,98,228,.430,10,33,.303,88,195,.451,.452,33,43,.767,14,78,92,154,24,6,45,38,239,Ish Smith
2015-16,PHI,PG,50,50,1622,299,739,.405,46,137,.336,253,602,.420,.436,89,133,.669,29,184,213,348,64,18,130,95,733,Ish Smith
2016-17,DET,PG,81,32,1955,329,749,.439,28,105,.267,301,644,.467,.458,72,102,.706,21,214,235,418,61,33,112,127,758,Ish Smith
2017-18,DET,PG,82,35,2043,389,801,.486,35,101,.347,354,700,.506,.507,81,116,.698,27,197,224,360,64,20,108,140,894,Ish Smith
2018-19,DET,PG,56,0,1251,205,489,.419,44,135,.326,161,354,.455,.464,47,62,.758,23,122,145,203,28,11,61,109,501,Ish Smith
2019-20,WAS,PG,68,23,1787,308,689,.447,62,169,.367,246,520,.473,.492,62,86,.721,30,189,219,334,59,30,95,106,740,Ish Smith
2020-21,WAS,PG,44,1,924,129,297,.434,18,49,.367,111,248,.448,.465,19,33,.576,22,128,150,172,32,13,41,62,295,Ish Smith
2021-22,2TM,PG,65,1,1126,185,430,.430,25,67,.373,160,363,.441,.459,15,24,.625,25,115,140,244,47,23,78,78,410,Ish Smith
2021-22,CHO,PG,37,1,511,73,185,.395,10,25,.400,63,160,.394,.422,12,19,.632,11,46,57,98,20,10,36,34,168,Ish Smith
2021-22,WAS,PG,28,0,615,112,245,.457,15,42,.357,97,203,.478,.488,3,5,.600,14,69,83,146,27,13,42,44,242,Ish Smith
2022-23,DEN,PG,43,0,398,52,131,.397,2,12,.167,50,119,.420,.405,2,4,.500,5,49,54,100,8,7,44,33,108,Ish Smith
2023-24,CHO,PG,43,5,741,66,158,.418,4,8,.500,62,150,.413,.430,3,4,.750,11,65,76,145,17,4,47,49,139,Ish Smith
2022-23,HOU,PF,79,79,2451,364,892,.408,120,391,.307,244,501,.487,.475,162,206,.786,122,447,569,101,43,74,104,227,1010,Jabari Smith Jr.
2023-24,HOU,PF,76,76,2424,378,833,.454,138,380,.363,240,453,.530,.537,150,185,.811,139,477,616,121,52,61,89,200,1044,Jabari Smith Jr.
2024-25,HOU,PF,31,31,972,129,297,.434,53,151,.351,76,146,.521,.524,63,72,.875,57,154,211,33,10,31,27,72,374,Jabari Smith Jr.
2020-21,PHO,PF,27,1,156,22,50,.440,4,17,.235,18,33,.545,.480,5,7,.714,7,30,37,4,1,5,7,16,53,Jalen Smith
2021-22,2TM,PF,51,8,925,176,350,.503,40,122,.328,136,228,.596,.560,78,102,.765,101,206,307,24,15,41,42,96,470,Jalen Smith
2021-22,PHO,PF,29,4,382,63,137,.460,9,39,.231,54,98,.551,.493,40,52,.769,55,84,139,6,6,18,22,52,175,Jalen Smith
2021-22,IND,PF,22,4,543,113,213,.531,31,83,.373,82,130,.631,.603,38,50,.760,46,122,168,18,9,23,20,44,295,Jalen Smith
2022-23,IND,C,68,31,1279,242,508,.476,54,191,.283,188,317,.593,.530,104,137,.759,129,265,394,66,21,60,72,153,642,Jalen Smith
2023-24,IND,C,61,14,1047,234,395,.592,61,144,.424,173,251,.689,.670,72,104,.692,112,225,337,63,17,38,44,124,601,Jalen Smith
2024-25,CHI,C,28,1,430,78,166,.470,31,88,.352,47,78,.603,.563,34,43,.791,39,116,155,22,9,20,17,44,221,Jalen Smith
2023-24,CHO,SG,51,0,729,113,289,.391,63,146,.432,50,143,.350,.500,13,15,.867,18,54,72,59,10,7,39,55,302,Nick Smith Jr.
2024-25,CHO,SG,14,0,125,17,49,.347,9,27,.333,8,22,.364,.439,1,2,.500,1,10,11,10,4,1,3,8,44,Nick Smith Jr.
2023-24,PHI,PG,16,0,84,18,46,.391,13,35,.371,5,11,.455,.533,3,5,.600,0,4,4,12,8,0,7,8,52,Terquavion Smith
2024-25,MIL,PF,11,0,38,9,14,.643,3,8,.375,6,6,1.000,.750,1,2,.500,1,9,10,1,0,3,3,4,22,Tyler Smith
2018-19,PHI,SG,6,2,111,14,34,.412,6,16,.375,8,18,.444,.500,6,8,.750,3,10,13,10,2,2,6,8,40,Zhaire Smith
2019-20,PHI,SF,7,0,32,3,11,.273,0,3,.000,3,8,.375,.273,2,4,.500,0,2,2,2,3,0,2,4,8,Zhaire Smith
2021-22,2TM,SF,9,0,39,2,10,.200,1,8,.125,1,2,.500,.250,0,0,,2,4,6,1,0,0,0,2,5,Xavier Sneed
2021-22,MEM,SF,2,0,8,0,2,.000,0,2,.000,0,0,,.000,0,0,,1,1,2,0,0,0,0,2,0,Xavier Sneed
2021-22,UTA,SF,7,0,31,2,8,.250,1,6,.167,1,2,.500,.313,0,0,,1,3,4,1,0,0,0,0,5,Xavier Sneed
2022-23,CHO,SF,4,0,48,5,10,.500,3,6,.500,2,4,.500,.650,4,4,1.000,0,5,5,5,0,1,3,7,17,Xavier Sneed
2022-23,SAS,PF,56,53,1458,250,552,.453,33,134,.246,217,418,.519,.483,81,116,.698,95,200,295,142,43,23,97,138,614,Jeremy Sochan
2023-24,SAS,PF,74,73,2193,340,776,.438,70,227,.308,270,549,.492,.483,111,144,.771,137,339,476,249,62,40,140,168,861,Jeremy Sochan
2024-25,SAS,PF,18,15,532,105,195,.538,8,31,.258,97,164,.591,.559,51,70,.729,51,105,156,52,17,12,34,44,269,Jeremy Sochan
2018-19,2TM,PF,14,3,148,25,47,.532,0,3,.000,25,44,.568,.532,4,12,.333,15,33,48,5,9,8,9,23,54,Ray Spalding
2018-19,DAL,PF,1,0,1,0,0,,0,0,,0,0,,,0,0,,0,0,0,0,0,0,0,0,0,Ray Spalding
2018-19,PHO,PF,13,3,147,25,47,.532,0,3,.000,25,44,.568,.532,4,12,.333,15,33,48,5,9,8,9,23,54,Ray Spalding
2020-21,HOU,C,2,0,19,2,4,.500,0,1,.000,2,3,.667,.500,0,2,.000,2,2,4,0,0,2,3,3,4,Ray Spalding
2018-19,ATL,PF,46,11,805,98,244,.402,44,128,.344,54,116,.466,.492,32,45,.711,72,122,194,47,26,25,31,67,272,Omari Spellman
2019-20,GSW,C,49,3,886,127,295,.431,43,110,.391,84,185,.454,.503,73,92,.793,77,142,219,47,33,24,54,63,370,Omari Spellman
2024-25,MEM,SG,6,0,59,7,14,.500,3,6,.500,4,8,.500,.607,4,4,1.000,1,6,7,7,1,1,3,6,21,Cam Spencer
2023-24,GSW,PG,6,0,26,2,4,.500,0,2,.000,2,2,1.000,.500,0,0,,2,2,4,5,0,0,1,1,4,Pat Spencer
2024-25,GSW,PG,9,0,45,6,16,.375,0,3,.000,6,13,.462,.375,2,2,1.000,4,3,7,12,5,0,4,4,14,Pat Spencer
2021-22,PHI,SG,2,0,6,1,1,1.000,0,0,,1,1,1.000,1.000,0,0,,1,1,2,0,0,2,1,0,2,Jaden Springer
2022-23,PHI,SG,16,2,89,17,35,.486,2,5,.400,15,30,.500,.514,6,8,.750,6,8,14,8,7,3,3,15,42,Jaden Springer
2023-24,2TM,SG,49,2,507,59,148,.399,10,48,.208,49,100,.490,.432,35,42,.833,33,45,78,44,36,15,34,66,163,Jaden Springer
2023-24,PHI,SG,32,1,377,46,118,.390,8,37,.216,38,81,.469,.424,28,34,.824,25,33,58,35,25,11,26,49,128,Jaden Springer
2023-24,BOS,SG,17,1,130,13,30,.433,2,11,.182,11,19,.579,.467,7,8,.875,8,12,20,9,11,4,8,17,35,Jaden Springer
2024-25,BOS,SG,11,0,51,3,11,.273,0,3,.000,3,8,.375,.273,10,13,.769,4,9,13,3,3,0,1,6,16,Jaden Springer
2020-21,IND,SG,24,0,93,13,43,.302,3,13,.231,10,30,.333,.337,7,9,.778,8,12,20,1,1,2,1,14,36,Cassius Stanley
2021-22,DET,SG,9,1,155,19,46,.413,4,17,.235,15,29,.517,.457,10,10,1.000,5,14,19,4,5,2,6,17,52,Cassius Stanley
2014-15,SAC,SG,73,1,1127,108,296,.365,48,149,.322,60,147,.408,.446,55,64,.859,11,77,88,67,20,17,40,92,319,Nik Stauskas
2015-16,PHI,SG,73,35,1809,210,545,.385,106,325,.326,104,220,.473,.483,91,118,.771,23,160,183,138,44,20,94,115,617,Nik Stauskas
2016-17,PHI,SG,80,27,2188,251,634,.396,132,359,.368,119,275,.433,.500,122,150,.813,21,205,226,188,45,32,128,144,756,Nik Stauskas
2017-18,2TM,SG,41,0,523,60,154,.390,40,100,.400,20,54,.370,.519,21,29,.724,4,60,64,39,9,4,26,24,181,Nik Stauskas
2017-18,PHI,SG,6,0,45,1,4,.250,0,1,.000,1,3,.333,.250,2,2,1.000,0,1,1,1,4,0,4,3,4,Nik Stauskas
2017-18,BRK,SG,35,0,478,59,150,.393,40,99,.404,19,51,.373,.527,19,27,.704,4,59,63,38,5,4,22,21,177,Nik Stauskas
2018-19,2TM,SG,68,0,1015,136,338,.402,70,188,.372,66,150,.440,.506,57,64,.891,18,109,127,81,21,7,51,50,399,Nik Stauskas
2018-19,POR,SG,44,0,673,96,229,.419,43,125,.344,53,104,.510,.513,32,36,.889,10,70,80,62,14,4,40,31,267,Nik Stauskas
2018-19,CLE,SG,24,0,342,40,109,.367,27,63,.429,13,46,.283,.491,25,28,.893,8,39,47,19,7,3,11,19,132,Nik Stauskas
2021-22,2TM,SG,8,0,39,5,14,.357,4,10,.400,1,4,.250,.500,4,6,.667,1,2,3,2,0,0,1,1,18,Nik Stauskas
2021-22,MIA,SG,2,0,24,3,8,.375,2,4,.500,1,4,.250,.500,3,4,.750,1,2,3,1,0,0,0,1,11,Nik Stauskas
2021-22,BOS,SG,6,0,15,2,6,.333,2,6,.333,0,0,,.500,1,2,.500,0,0,0,1,0,0,1,0,7,Nik Stauskas
2020-21,CLE,PF,40,0,499,62,136,.456,4,25,.160,58,111,.523,.471,37,51,.725,24,72,96,25,17,13,23,53,165,Lamar Stevens
2021-22,CLE,PF,63,13,1015,156,319,.489,18,65,.277,138,254,.543,.517,53,75,.707,47,117,164,44,31,18,41,106,383,Lamar Stevens
2022-23,CLE,SF,62,25,1120,129,288,.448,30,95,.316,99,193,.513,.500,40,57,.702,48,159,207,33,27,19,27,79,328,Lamar Stevens
2023-24,2TM,PF,38,3,559,108,240,.450,14,46,.304,94,194,.485,.479,42,54,.778,36,91,127,28,23,22,24,45,272,Lamar Stevens
2023-24,BOS,PF,19,1,122,21,45,.467,3,8,.375,18,37,.486,.500,8,11,.727,12,19,31,8,6,5,9,14,53,Lamar Stevens
2023-24,MEM,PF,19,2,437,87,195,.446,11,38,.289,76,157,.484,.474,34,43,.791,24,72,96,20,17,17,15,31,219,Lamar Stevens
2020-21,DET,C,68,14,1455,226,409,.553,21,63,.333,205,346,.592,.578,64,92,.696,159,294,453,59,39,86,67,184,537,Isaiah Stewart
2021-22,DET,C,71,71,1816,250,490,.510,15,46,.326,235,444,.529,.526,74,103,.718,226,391,617,82,22,78,85,211,589,Isaiah Stewart
2022-23,DET,C,50,47,1414,195,441,.442,67,205,.327,128,236,.542,.518,110,149,.738,115,288,403,70,20,34,68,133,567,Isaiah Stewart
2023-24,DET,PF,46,45,1423,186,382,.487,67,175,.383,119,207,.575,.575,64,85,.753,74,231,305,73,17,38,66,99,503,Isaiah Stewart
2024-25,DET,C,27,3,579,64,116,.552,5,21,.238,59,95,.621,.573,29,33,.879,60,101,161,47,13,34,29,73,162,Isaiah Stewart
2023-24,DEN,SF,50,0,545,82,222,.369,41,138,.297,41,84,.488,.462,22,31,.710,5,56,61,47,17,7,23,54,227,Julian Strawther
2024-25,DEN,SG,29,0,595,93,199,.467,40,102,.392,53,97,.546,.568,41,49,.837,9,50,59,38,19,11,24,69,267,Julian Strawther
2019-20,CHI,SF,2,0,6,2,3,.667,0,1,.000,2,2,1.000,.667,1,1,1.000,1,0,1,0,0,0,0,1,5,Max Strus
2020-21,MIA,SF,39,0,507,85,187,.455,50,148,.338,35,39,.897,.588,16,24,.667,5,36,41,24,11,2,8,43,236,Max Strus
2021-22,MIA,SF,68,16,1587,249,564,.441,181,442,.410,68,122,.557,.602,42,53,.792,24,178,202,92,28,16,57,116,721,Max Strus
2022-23,MIA,SF,80,33,2272,324,790,.410,197,563,.350,127,227,.559,.535,78,89,.876,49,209,258,171,42,12,70,166,923,Max Strus
2023-24,CLE,SF,70,70,2239,304,728,.418,168,479,.351,136,249,.546,.533,77,97,.794,66,272,338,283,64,29,112,170,853,Max Strus
2024-25,CLE,SF,3,0,65,6,17,.353,4,14,.286,2,3,.667,.471,0,0,,3,8,11,5,1,0,1,9,16,Max Strus
2021-22,ORL,PG,48,45,1307,198,548,.361,42,196,.214,156,352,.443,.400,126,163,.773,26,145,171,209,59,19,143,142,564,Jalen Suggs
2022-23,ORL,SG,53,19,1246,186,444,.419,66,202,.327,120,242,.496,.493,86,119,.723,55,106,161,155,67,27,94,120,524,Jalen Suggs
2023-24,ORL,SG,75,75,2025,336,714,.471,153,385,.397,183,329,.556,.578,118,156,.756,48,181,229,205,106,47,132,205,943,Jalen Suggs
2024-25,ORL,PG,31,31,926,181,439,.412,69,222,.311,112,217,.516,.491,90,98,.918,21,110,131,120,46,31,95,87,521,Jalen Suggs
2017-18,IND,PG,1,0,2,1,1,1.000,0,0,,1,1,1.000,1.000,0,0,,0,1,1,0,0,0,0,1,2,Edmond Sumner
2018-19,IND,PG,23,2,210,22,64,.344,7,27,.259,15,37,.405,.398,15,24,.625,9,15,24,10,12,5,10,26,66,Edmond Sumner
2019-20,IND,SG,31,3,447,61,142,.430,14,53,.264,47,89,.528,.479,16,29,.552,11,35,46,55,15,9,22,44,152,Edmond Sumner
2020-21,IND,SG,53,24,861,148,282,.525,35,88,.398,113,194,.582,.587,68,83,.819,18,76,94,49,33,10,51,88,399,Edmond Sumner
2022-23,BRK,SG,53,12,736,124,269,.461,31,87,.356,93,182,.511,.519,99,108,.917,13,66,79,68,31,10,50,83,378,Edmond Sumner
2022-23,LAL,SF,7,0,41,3,9,.333,3,8,.375,0,1,.000,.500,0,0,,1,6,7,4,0,0,0,3,9,Cole Swider
2023-24,MIA,SF,18,0,87,15,38,.395,10,30,.333,5,8,.625,.526,2,2,1.000,1,6,7,5,1,1,8,4,42,Cole Swider
2024-25,DET,SF,2,0,13,0,5,.000,0,5,.000,0,0,,.000,0,0,,0,2,2,1,0,0,0,1,0,Cole Swider
2021-22,WAS,SG,3,0,19,3,4,.750,0,1,.000,3,3,1.000,.750,0,0,0,0,0,1,4,0,1,7,6,0,Craig Sword
2021-22,IND,PG,32,11,566,69,190,.363,27,90,.300,42,100,.420,.434,15,17,.882,8,37,45,62,12,4,33,51,180,Keifer Sykes
2020-21,HOU,SF,70,58,2043,316,625,.506,60,195,.308,256,430,.595,.554,102,147,.694,132,242,374,178,85,36,98,222,794,Jae'Sean Tate
2021-22,HOU,PF,78,77,2056,363,729,.498,63,202,.312,300,527,.569,.541,130,184,.707,135,285,420,222,72,41,139,286,919,Jae'Sean Tate
2022-23,HOU,SF,31,7,677,110,229,.480,13,46,.283,97,183,.530,.509,50,69,.725,41,77,118,84,21,7,47,106,283,Jae'Sean Tate
2023-24,HOU,SF,65,9,1031,108,229,.472,23,77,.299,85,152,.559,.522,26,39,.667,61,136,197,64,42,15,37,137,265,Jae'Sean Tate
2024-25,HOU,SF,15,0,125,20,37,.541,1,7,.143,19,30,.633,.554,12,17,.706,8,25,33,10,9,0,8,23,53,Jae'Sean Tate
2017-18,BOS,SF,80,80,2443,397,835,.475,105,242,.434,292,593,.492,.538,213,258,.826,50,352,402,128,83,58,114,170,1112,Jayson Tatum
2018-19,BOS,SF,79,79,2455,466,1036,.450,116,311,.373,350,725,.483,.506,195,228,.855,70,407,477,168,84,57,122,168,1243,Jayson Tatum
2019-20,BOS,PF,66,66,2265,552,1226,.450,189,469,.403,363,757,.480,.527,254,313,.812,64,396,460,200,93,57,155,136,1547,Jayson Tatum
2020-21,BOS,SF,64,64,2290,605,1318,.459,187,485,.386,418,833,.502,.530,295,340,.868,50,422,472,276,75,31,171,122,1692,Jayson Tatum
2021-22,BOS,SF,76,76,2731,708,1564,.453,230,651,.353,478,913,.524,.526,400,469,.853,85,524,609,334,75,49,217,174,2046,Jayson Tatum
2022-23,BOS,SF,74,74,2732,727,1559,.466,240,686,.350,487,873,.558,.543,531,622,.854,78,571,649,342,78,51,213,160,2225,Jayson Tatum
2023-24,BOS,PF,74,74,2645,672,1426,.471,229,609,.376,443,817,.542,.552,414,497,.833,67,534,601,364,75,43,188,145,1987,Jayson Tatum
2024-25,BOS,PF,28,28,1020,266,571,.466,110,295,.373,156,276,.565,.562,162,201,.806,17,252,269,156,34,13,77,71,804,Jayson Tatum
2021-22,IND,PF,33,7,714,135,220,.614,12,38,.316,123,182,.676,.641,36,51,.706,95,77,172,41,14,8,23,61,318,Terry Taylor
2022-23,2TM,PF,31,2,264,39,75,.520,5,19,.263,34,56,.607,.553,6,11,.545,27,20,47,10,3,6,9,26,89,Terry Taylor
2022-23,IND,PF,26,2,228,30,65,.462,4,18,.222,26,47,.553,.492,5,7,.714,22,17,39,10,3,5,9,24,69,Terry Taylor
2022-23,CHI,PF,5,0,36,9,10,.900,1,1,1.000,8,9,.889,.950,1,4,.250,5,3,8,0,0,1,0,2,20,Terry Taylor
2023-24,CHI,PF,31,0,188,20,39,.513,2,9,.222,18,30,.600,.538,4,5,.800,17,20,37,10,5,2,7,17,46,Terry Taylor
2009-10,3TM,SG,27,4,334,44,101,.436,13,37,.351,31,64,.484,.500,35,50,.700,6,25,31,21,13,6,27,42,136,Garrett Temple
2009-10,HOU,SG,9,0,118,13,29,.448,3,12,.250,10,17,.588,.500,16,24,.667,2,12,14,7,4,4,14,16,45,Garrett Temple
2009-10,SAC,SG,5,0,23,3,8,.375,0,2,.000,3,6,.500,.375,5,5,1.000,1,2,3,2,1,0,2,1,11,Garrett Temple
2009-10,SAS,SG,13,4,193,28,64,.438,10,23,.435,18,41,.439,.516,14,21,.667,3,11,14,12,8,2,11,25,80,Garrett Temple
2010-11,3TM,PG,24,0,230,20,68,.294,10,37,.270,10,31,.323,.368,7,17,.412,1,22,23,32,11,6,23,24,57,Garrett Temple
2010-11,SAS,SG,3,0,21,1,5,.200,0,1,.000,1,4,.250,.200,0,2,.000,1,1,2,2,1,1,1,2,2,Garrett Temple
2010-11,MIL,SG,9,0,83,7,21,.333,3,10,.300,4,11,.364,.405,0,4,.000,0,6,6,6,1,1,2,8,17,Garrett Temple
2010-11,CHA,PG,12,0,126,12,42,.286,7,26,.269,5,16,.313,.369,7,11,.636,0,15,15,24,9,4,20,14,38,Garrett Temple
2012-13,WAS,SG,51,36,1156,105,258,.407,26,80,.325,79,178,.444,.457,26,37,.703,29,94,123,115,50,17,61,94,262,Garrett Temple
2013-14,WAS,SG,75,0,638,51,141,.362,6,29,.207,45,112,.402,.383,30,43,.698,21,47,68,72,35,11,42,72,138,Garrett Temple
2014-15,WAS,SG,52,18,735,68,170,.400,33,88,.375,35,82,.427,.497,35,48,.729,24,66,90,56,42,9,34,76,204,Garrett Temple
2015-16,WAS,SF,80,43,1951,201,505,.398,89,258,.345,112,247,.453,.486,91,125,.728,36,176,212,140,69,18,64,195,582,Garrett Temple
2016-17,SAC,SG,65,20,1728,183,432,.424,82,220,.373,101,212,.476,.519,58,74,.784,32,152,184,168,84,28,78,141,506,Garrett Temple
2017-18,SAC,SG,65,35,1615,199,476,.418,89,227,.392,110,249,.442,.512,60,78,.769,22,130,152,124,57,27,79,135,547,Garrett Temple
2018-19,2TM,SG,75,55,2040,208,493,.422,90,264,.341,118,229,.515,.513,80,107,.748,28,188,216,106,76,30,70,204,586,Garrett Temple
2018-19,MEM,SG,49,49,1530,166,387,.429,74,210,.352,92,177,.520,.525,57,76,.750,18,134,152,69,50,25,54,134,463,Garrett Temple
2018-19,LAC,SG,26,6,510,42,106,.396,16,54,.296,26,52,.500,.472,23,31,.742,10,54,64,37,26,5,16,70,123,Garrett Temple
2019-20,BRK,SG,62,35,1730,222,587,.378,127,386,.329,95,201,.473,.486,70,87,.805,29,189,218,156,49,29,62,108,641,Garrett Temple
2020-21,CHI,SG,56,25,1528,158,381,.415,67,200,.335,91,181,.503,.503,40,50,.800,29,131,160,124,43,30,58,126,423,Garrett Temple
2021-22,NOP,SG,59,16,1098,111,295,.376,59,185,.319,52,110,.473,.476,28,41,.683,29,114,143,74,43,23,42,81,309,Garrett Temple
2022-23,NOP,SG,25,0,162,18,45,.400,11,26,.423,7,19,.368,.522,3,4,.750,5,12,17,13,9,2,4,15,50,Garrett Temple
2023-24,TOR,SG,27,2,289,29,78,.372,12,40,.300,17,38,.447,.449,18,22,.818,18,27,45,28,12,3,14,28,88,Garrett Temple
2024-25,TOR,SG,10,0,40,2,10,.200,1,5,.200,1,5,.200,.250,0,0,,1,5,6,6,4,1,3,6,5,Garrett Temple
2022-23,CHI,SG,38,0,214,32,72,.444,7,27,.259,25,45,.556,.493,14,21,.667,12,25,37,22,11,5,8,24,85,Dalen Terry
2023-24,CHI,SG,59,2,681,69,157,.439,17,74,.230,52,83,.627,.494,25,43,.581,29,84,113,81,27,18,32,81,180,Dalen Terry
2024-25,CHI,SG,28,1,374,42,87,.483,11,32,.344,31,55,.564,.546,22,28,.786,18,21,39,26,16,8,24,43,117,Dalen Terry
2020-21,DAL,PG,11,0,56,5,16,.313,0,7,.000,5,9,.556,.313,1,3,.333,0,6,6,6,5,0,2,2,11,Tyrell Terry
2021-22,MEM,PG,2,0,3,1,1,1.000,0,0,,1,1,1.000,1.000,0,0,,0,0,0,0,0,0,0,1,2,Tyrell Terry
2017-18,BOS,C,63,3,936,126,233,.541,18,58,.310,108,175,.617,.579,61,81,.753,90,184,274,56,30,48,56,157,331,Daniel Theis
2018-19,BOS,C,66,2,908,146,266,.549,26,67,.388,120,199,.603,.598,56,76,.737,87,138,225,68,21,42,33,161,374,Daniel Theis
2019-20,BOS,C,65,64,1566,241,426,.566,32,96,.333,209,330,.633,.603,87,114,.763,140,286,426,111,37,84,54,219,601,Daniel Theis
2020-21,2TM,C,65,51,1601,252,466,.541,49,152,.322,203,314,.646,.593,74,110,.673,93,263,356,108,41,57,66,167,627,Daniel Theis
2020-21,BOS,C,42,37,1027,159,288,.552,33,95,.347,126,193,.653,.609,46,67,.687,54,166,220,67,25,43,41,120,397,Daniel Theis
2020-21,CHI,C,23,14,574,93,178,.522,16,57,.281,77,121,.636,.567,28,43,.651,39,97,136,41,16,14,25,47,230,Daniel Theis
2021-22,2TM,C,47,27,977,151,291,.519,33,107,.308,118,184,.641,.576,49,72,.681,59,169,228,41,20,31,46,111,384,Daniel Theis
2021-22,HOU,C,26,21,584,84,179,.469,23,79,.291,61,100,.610,.534,27,40,.675,32,98,130,20,11,17,31,62,218,Daniel Theis
2021-22,BOS,C,21,6,393,67,112,.598,10,28,.357,57,84,.679,.643,22,32,.688,27,71,98,21,9,14,15,49,166,Daniel Theis
2022-23,IND,C,7,1,109,21,44,.477,2,11,.182,19,33,.576,.500,5,12,.417,7,15,22,9,2,6,3,7,49,Daniel Theis
2023-24,2TM,C,60,3,1015,156,293,.532,26,71,.366,130,222,.586,.577,38,50,.760,85,159,244,61,21,51,42,127,376,Daniel Theis
2023-24,IND,C,1,0,8,1,4,.250,0,1,.000,1,3,.333,.250,0,0,,0,0,0,0,0,0,0,1,2,Daniel Theis
2023-24,LAC,C,59,3,1007,155,289,.536,26,70,.371,129,219,.589,.581,38,50,.760,85,159,244,61,21,51,42,126,374,Daniel Theis
2024-25,NOP,C,22,7,323,30,70,.429,5,22,.227,25,48,.521,.464,18,20,.900,20,63,83,34,9,13,14,41,83,Daniel Theis
2020-21,2TM,SG,32,1,399,39,108,.361,16,59,.271,23,49,.469,.435,31,46,.674,8,45,53,30,15,10,22,40,125,Brodric Thomas
2020-21,HOU,SG,4,0,24,2,7,.286,1,6,.167,1,1,1.000,.357,5,7,.714,1,3,4,4,1,1,4,5,10,Brodric Thomas
2020-21,CLE,SG,28,1,375,37,101,.366,15,53,.283,22,48,.458,.441,26,39,.667,7,42,49,26,14,9,18,35,115,Brodric Thomas
2021-22,BOS,SG,12,0,60,8,18,.444,2,9,.222,6,9,.667,.500,3,5,.600,2,8,10,11,1,1,6,7,21,Brodric Thomas
2021-22,BRK,SG,67,2,1176,218,503,.433,47,174,.270,171,329,.520,.480,87,105,.829,16,145,161,78,33,8,55,66,570,Cam Thomas
2022-23,BRK,SG,57,4,948,201,456,.441,51,133,.383,150,323,.464,.497,151,174,.868,8,87,95,78,20,7,63,55,604,Cam Thomas
2023-24,BRK,SG,66,51,2075,526,1190,.442,144,396,.364,382,794,.481,.503,286,334,.856,28,186,214,192,45,16,124,138,1482,Cam Thomas
2024-25,BRK,SG,17,17,568,137,297,.461,49,126,.389,88,171,.515,.544,97,112,.866,6,49,55,57,12,1,48,34,420,Cam Thomas
2011-12,SAC,PG,65,37,1656,256,571,.448,83,219,.379,173,352,.491,.521,154,185,.832,48,120,168,266,53,8,105,121,749,Isaiah Thomas
2012-13,SAC,PG,79,62,2122,366,832,.440,115,321,.358,251,511,.491,.509,253,287,.882,29,132,161,316,67,3,140,167,1100,Isaiah Thomas
2013-14,SAC,PG,72,54,2497,496,1096,.453,127,364,.349,369,732,.504,.510,346,407,.850,47,163,210,454,93,8,213,185,1465,Isaiah Thomas
2014-15,2TM,PG,67,1,1726,335,797,.420,129,346,.373,206,451,.457,.501,302,348,.868,33,120,153,284,57,5,143,150,1101,Isaiah Thomas
2014-15,PHO,PG,46,1,1181,218,512,.426,81,207,.391,137,305,.449,.505,184,211,.872,26,83,109,171,45,5,89,105,701,Isaiah Thomas
2014-15,BOS,PG,21,0,545,117,285,.411,48,139,.345,69,146,.473,.495,118,137,.861,7,37,44,113,12,0,54,45,400,Isaiah Thomas
2015-16,BOS,PG,82,79,2644,591,1382,.428,167,465,.359,424,917,.462,.488,474,544,.871,46,197,243,509,91,9,220,167,1823,Isaiah Thomas
2016-17,BOS,PG,76,76,2569,682,1473,.463,245,646,.379,437,827,.528,.546,590,649,.909,43,162,205,448,70,13,210,167,2199,Isaiah Thomas
2017-18,2TM,PG,32,15,862,157,421,.373,55,188,.293,102,233,.438,.438,117,131,.893,17,50,67,153,15,3,95,58,486,Isaiah Thomas
2017-18,CLE,PG,15,14,406,70,194,.361,22,87,.253,48,107,.449,.418,59,68,.868,7,24,31,68,9,2,41,25,221,Isaiah Thomas
2017-18,LAL,PG,17,1,456,87,227,.383,33,101,.327,54,126,.429,.456,58,63,.921,10,26,36,85,6,1,54,33,265,Isaiah Thomas
2018-19,DEN,SG,12,0,181,34,99,.343,12,43,.279,22,56,.393,.404,17,27,.630,5,8,13,23,5,1,18,17,97,Isaiah Thomas
2019-20,WAS,PG,40,37,925,174,426,.408,78,189,.413,96,237,.405,.500,62,76,.816,11,57,68,146,13,6,77,77,488,Isaiah Thomas
2020-21,NOP,PG,3,0,48,9,27,.333,3,12,.250,6,15,.400,.389,2,2,1.000,1,3,4,5,1,0,6,3,23,Isaiah Thomas
2021-22,3TM,PG,22,1,333,67,167,.401,28,83,.337,39,84,.464,.485,22,26,.846,4,25,29,34,7,5,15,34,184,Isaiah Thomas
2021-22,LAL,PG,4,1,101,12,39,.308,5,22,.227,7,17,.412,.372,8,11,.727,1,7,8,6,0,2,5,12,37,Isaiah Thomas
2021-22,DAL,PG,1,0,13,3,8,.375,0,3,.000,3,5,.600,.375,0,0,,0,0,0,4,0,0,0,0,6,Isaiah Thomas
2021-22,CHO,PG,17,0,219,52,120,.433,23,58,.397,29,62,.468,.529,14,15,.933,3,18,21,24,7,3,10,22,141,Isaiah Thomas
2023-24,PHO,PG,6,0,19,3,10,.300,2,4,.500,1,6,.167,.400,0,0,,0,0,0,3,0,0,0,0,8,Isaiah Thomas
2018-19,DET,SG,26,0,195,22,69,.319,10,35,.286,12,34,.353,.391,7,11,.636,4,16,20,8,7,5,4,22,61,Khyri Thomas
2019-20,DET,SG,8,0,61,5,17,.294,5,14,.357,0,3,.000,.441,2,4,.500,1,0,1,3,3,0,3,9,17,Khyri Thomas
2020-21,HOU,SG,5,2,153,32,66,.485,9,27,.333,23,39,.590,.553,9,9,1.000,7,11,18,25,9,6,6,8,82,Khyri Thomas
2023-24,HOU,SF,62,23,1388,239,446,.536,8,58,.138,231,388,.595,.545,106,155,.684,148,261,409,163,78,38,90,141,592,Amen Thompson
2024-25,HOU,SF,31,5,859,146,262,.557,11,41,.268,135,221,.611,.578,74,106,.698,76,146,222,66,34,35,59,71,377,Amen Thompson
2023-24,DET,SF,63,38,1583,232,480,.483,21,113,.186,211,367,.575,.505,71,119,.597,129,273,402,120,68,59,84,175,556,Ausar Thompson
2024-25,DET,SF,11,3,185,34,72,.472,4,16,.250,30,56,.536,.500,9,17,.529,14,30,44,20,9,4,15,31,81,Ausar Thompson
2011-12,GSW,SG,66,29,1608,318,718,.443,111,268,.414,207,450,.460,.520,79,91,.868,24,137,161,133,49,20,103,155,826,Klay Thompson
2012-13,GSW,SG,82,82,2936,508,1205,.422,211,526,.401,297,679,.437,.509,132,157,.841,32,274,306,183,86,45,157,237,1359,Klay Thompson
2013-14,GSW,SG,81,81,2868,559,1259,.444,223,535,.417,336,724,.464,.533,147,185,.795,38,211,249,181,74,37,135,234,1488,Klay Thompson
2014-15,GSW,SG,77,77,2455,602,1299,.463,239,545,.439,363,754,.481,.555,225,256,.879,27,220,247,222,87,60,149,122,1668,Klay Thompson
2015-16,GSW,SG,80,80,2666,651,1386,.470,276,650,.425,375,736,.510,.569,193,221,.873,35,271,306,166,60,49,138,152,1771,Klay Thompson
2016-17,GSW,SG,78,78,2649,644,1376,.468,268,647,.414,376,729,.516,.565,186,218,.853,49,236,285,160,66,40,128,139,1742,Klay Thompson
2017-18,GSW,SG,73,73,2506,575,1179,.488,229,521,.440,346,658,.526,.585,82,98,.837,31,246,277,185,55,34,128,117,1461,Klay Thompson
2018-19,GSW,SG,78,78,2652,655,1402,.467,241,599,.402,414,803,.516,.553,129,158,.816,37,262,299,186,84,47,115,157,1680,Klay Thompson
2021-22,GSW,SG,32,32,941,246,573,.429,114,296,.385,132,277,.477,.529,46,51,.902,15,110,125,88,16,17,43,54,652,Klay Thompson
2022-23,GSW,SF,69,69,2279,546,1252,.436,301,731,.412,245,521,.470,.556,116,132,.879,39,247,286,163,49,29,123,130,1509,Klay Thompson
2023-24,GSW,SF,77,63,2284,490,1133,.432,268,692,.387,222,441,.503,.551,127,137,.927,35,219,254,176,50,35,117,127,1375,Klay Thompson
2024-25,DAL,SF,27,27,740,137,324,.423,82,213,.385,55,111,.495,.549,26,29,.897,17,78,95,52,26,11,32,36,382,Klay Thompson
2011-12,CLE,PF,60,25,1424,194,442,.439,0,2,.000,194,440,.441,.439,106,192,.552,187,202,389,27,27,62,81,134,494,Tristan Thompson
2012-13,CLE,PF,82,82,2564,390,799,.488,0,3,.000,390,796,.490,.488,177,291,.608,306,467,773,108,60,71,123,234,957,Tristan Thompson
2013-14,CLE,PF,82,82,2594,363,761,.477,0,1,.000,363,760,.478,.477,235,339,.693,269,485,754,72,42,35,108,188,961,Tristan Thompson
2014-15,CLE,PF,82,15,2194,267,488,.547,0,0,,267,488,.547,.547,159,248,.641,274,383,657,39,34,61,83,189,693,Tristan Thompson
2015-16,CLE,PF,82,34,2269,247,420,.588,0,0,,247,420,.588,.588,149,242,.616,268,470,738,62,38,51,61,202,643,Tristan Thompson
2016-17,CLE,C,78,78,2336,262,437,.600,0,3,.000,262,434,.604,.600,106,213,.498,286,429,715,77,39,84,64,176,630,Tristan Thompson
2017-18,CLE,C,53,22,1072,132,235,.562,0,0,,132,235,.562,.562,43,79,.544,126,226,352,33,16,17,36,102,307,Tristan Thompson
2018-19,CLE,C,43,40,1198,201,380,.529,0,0,,201,380,.529,.529,68,106,.642,173,265,438,86,28,16,59,89,470,Tristan Thompson
2019-20,CLE,C,57,51,1721,288,562,.512,9,23,.391,279,539,.518,.520,99,161,.615,226,351,577,120,33,50,103,124,684,Tristan Thompson
2020-21,BOS,C,54,43,1287,169,326,.518,0,3,.000,169,323,.523,.518,71,120,.592,169,270,439,67,24,33,62,119,409,Tristan Thompson
2021-22,3TM,C,57,6,897,141,267,.528,1,3,.333,140,264,.530,.530,61,116,.526,120,168,288,34,23,21,45,98,344,Tristan Thompson
2021-22,SAC,C,30,3,455,76,151,.503,1,1,1.000,75,150,.500,.507,32,60,.533,72,89,161,18,11,12,29,52,185,Tristan Thompson
2021-22,IND,C,4,0,66,13,24,.542,0,0,,13,24,.542,.542,3,8,.375,7,11,18,2,0,2,4,7,29,Tristan Thompson
2021-22,CHI,C,23,3,376,52,92,.565,0,2,.000,52,90,.578,.565,26,48,.542,41,68,109,14,12,7,12,39,130,Tristan Thompson
2023-24,CLE,C,49,0,549,73,120,.608,0,1,.000,73,119,.613,.608,15,52,.288,73,101,174,51,12,14,29,59,161,Tristan Thompson
2024-25,CLE,PF,12,0,90,13,27,.481,0,1,.000,13,26,.500,.481,4,14,.286,8,24,32,4,0,4,5,10,30,Tristan Thompson
2021-22,CHO,PF,33,0,262,24,55,.436,7,27,.259,17,28,.607,.500,12,20,.600,11,32,43,19,8,11,10,26,67,JT Thor
2022-23,CHO,PF,69,8,969,95,238,.399,39,123,.317,56,115,.487,.481,33,47,.702,36,116,152,36,22,23,44,66,262,JT Thor
2023-24,CHO,PF,63,3,781,80,183,.437,28,81,.346,52,102,.510,.514,11,20,.550,43,103,146,29,11,27,15,60,199,JT Thor
2024-25,CLE,PF,4,0,21,7,8,.875,3,3,1.000,4,5,.800,1.063,6,6,1.000,1,2,3,0,2,3,2,4,23,JT Thor
2019-20,PHI,SG,65,14,1287,112,265,.423,56,157,.357,56,108,.519,.528,25,41,.610,44,63,107,79,94,47,51,141,305,Matisse Thybulle
2020-21,PHI,SG,65,8,1298,102,243,.420,43,143,.301,59,100,.590,.508,8,18,.444,30,94,124,63,105,71,32,127,255,Matisse Thybulle
2021-22,PHI,SG,66,50,1685,150,300,.500,45,144,.313,105,156,.673,.575,34,43,.791,42,109,151,75,115,71,39,158,379,Matisse Thybulle
2022-23,2TM,SF,71,28,1200,110,253,.435,54,148,.365,56,105,.533,.542,19,28,.679,40,100,140,53,83,32,24,113,293,Matisse Thybulle
2022-23,PHI,SF,49,6,591,50,116,.431,21,63,.333,29,53,.547,.522,9,12,.750,20,43,63,23,45,14,8,65,130,Matisse Thybulle
2022-23,POR,SG,22,22,609,60,137,.438,33,85,.388,27,52,.519,.558,10,16,.625,20,57,77,30,38,18,16,48,163,Matisse Thybulle
2023-24,POR,SF,65,19,1487,126,317,.397,80,231,.346,46,86,.535,.524,22,29,.759,30,106,136,90,113,49,40,93,354,Matisse Thybulle
2020-21,MEM,C,18,1,182,19,57,.333,10,33,.303,9,24,.375,.421,9,11,.818,6,18,24,8,5,8,2,20,57,Killian Tillie
2021-22,MEM,C,36,3,461,43,127,.339,27,86,.314,16,41,.390,.445,5,8,.625,21,39,60,22,23,15,13,58,118,Killian Tillie
2020-21,MEM,PF,59,12,1085,167,299,.559,22,65,.338,145,234,.620,.595,34,53,.642,74,182,256,75,44,33,45,116,390,Xavier Tillman Sr.
2021-22,MEM,PF,53,2,701,98,216,.454,10,49,.204,88,167,.527,.477,46,71,.648,66,95,161,62,49,15,34,63,252,Xavier Tillman Sr.
2022-23,MEM,C,61,29,1180,188,306,.614,4,15,.267,184,291,.632,.621,49,89,.551,121,186,307,96,58,29,44,97,429,Xavier Tillman Sr.
2023-24,2TM,PF,54,15,974,121,279,.434,20,81,.247,101,198,.510,.470,22,50,.440,70,141,211,77,51,44,34,75,284,Xavier Tillman Sr.
2023-24,MEM,C,34,13,700,87,213,.408,12,53,.226,75,160,.469,.437,18,43,.419,56,101,157,57,42,35,29,60,204,Xavier Tillman Sr.
2023-24,BOS,PF,20,2,274,34,66,.515,8,28,.286,26,38,.684,.576,4,7,.571,14,40,54,20,9,9,5,15,80,Xavier Tillman Sr.
2024-25,BOS,C,19,1,156,9,34,.265,4,18,.222,5,16,.313,.324,1,2,.500,8,26,34,6,5,3,6,13,23,Xavier Tillman Sr.
2021-22,WAS,PF,12,0,74,7,26,.269,4,16,.250,3,10,.300,.346,2,6,.333,3,9,12,4,4,2,4,4,20,Isaiah Todd
2022-23,WAS,PF,6,1,61,3,19,.158,1,10,.100,2,9,.222,.184,2,2,1.000,2,10,12,4,1,0,2,4,9,Isaiah Todd
2023-24,NYK,SF,9,0,38,5,9,.556,1,4,.250,4,5,.800,.611,2,2,1.000,3,4,7,3,0,1,1,3,13,Jacob Toppin
2024-25,NYK,SF,8,0,22,1,3,.333,0,2,.000,1,1,1.000,.333,0,0,,0,3,3,2,0,0,1,1,2,Jacob Toppin
2020-21,NYK,PF,62,0,683,104,209,.498,26,85,.306,78,124,.629,.560,19,26,.731,26,112,138,29,17,15,23,55,253,Obi Toppin
2021-22,NYK,PF,72,10,1230,251,473,.531,52,169,.308,199,304,.655,.586,94,124,.758,69,199,268,77,25,33,56,102,648,Obi Toppin
2022-23,NYK,PF,67,5,1050,187,419,.446,85,247,.344,102,172,.593,.548,38,47,.809,29,158,187,66,23,12,38,68,497,Obi Toppin
2023-24,IND,PF,82,28,1730,332,579,.573,102,253,.403,230,326,.706,.661,77,100,.770,85,235,320,128,47,43,69,143,843,Obi Toppin
2024-25,IND,PF,30,0,598,123,222,.554,38,106,.358,85,116,.733,.640,31,36,.861,21,101,122,52,24,11,19,47,315,Obi Toppin
2019-20,GSW,SG,13,6,272,29,63,.460,8,23,.348,21,40,.525,.524,3,5,.600,9,43,52,26,13,5,16,30,69,Juan Toscano-Anderson
2020-21,GSW,SG,53,16,1107,121,209,.579,37,92,.402,84,117,.718,.667,22,31,.710,29,205,234,150,41,26,61,111,301,Juan Toscano-Anderson
2021-22,GSW,SF,73,6,994,115,235,.489,28,87,.322,87,148,.588,.549,40,70,.571,28,148,176,127,48,17,68,115,298,Juan Toscano-Anderson
2022-23,2TM,SF,52,9,700,64,143,.448,8,43,.186,56,100,.560,.476,19,24,.792,28,96,124,65,16,10,34,80,155,Juan Toscano-Anderson
2022-23,LAL,SF,30,7,365,33,66,.500,4,20,.200,29,46,.630,.530,11,15,.733,14,47,61,25,10,7,17,46,81,Juan Toscano-Anderson
2022-23,UTA,SF,22,2,335,31,77,.403,4,23,.174,27,54,.500,.429,8,9,.889,14,49,63,40,6,3,17,34,74,Juan Toscano-Anderson
2023-24,SAC,SF,11,0,53,3,12,.250,1,4,.250,2,8,.250,.292,0,0,,4,10,14,4,1,1,2,11,7,Juan Toscano-Anderson
2015-16,MIN,C,82,82,2627,625,1153,.542,30,88,.341,595,1065,.559,.555,223,275,.811,229,629,858,161,58,138,183,245,1503,Karl-Anthony Towns
2016-17,MIN,C,82,82,3030,802,1480,.542,101,275,.367,701,1205,.582,.576,356,428,.832,296,711,1007,220,56,103,212,241,2061,Karl-Anthony Towns
2017-18,MIN,C,82,82,2918,639,1172,.545,120,285,.421,519,887,.585,.596,345,402,.858,238,774,1012,199,64,115,159,285,1743,Karl-Anthony Towns
2018-19,MIN,C,77,77,2545,681,1314,.518,142,355,.400,539,959,.562,.572,376,450,.836,263,691,954,259,67,125,240,292,1880,Karl-Anthony Towns
2019-20,MIN,C,35,35,1187,316,622,.508,114,277,.412,202,345,.586,.600,180,226,.796,95,283,378,153,33,42,110,117,926,Karl-Anthony Towns
2020-21,MIN,C,50,50,1689,425,875,.486,122,315,.387,303,560,.541,.555,267,311,.859,133,396,529,225,39,57,160,186,1239,Karl-Anthony Towns
2021-22,MIN,C,74,74,2476,642,1214,.529,150,366,.410,492,848,.580,.591,384,467,.822,194,533,727,269,72,83,226,267,1818,Karl-Anthony Towns
2022-23,MIN,PF,29,29,957,212,428,.495,60,164,.366,152,264,.576,.565,118,135,.874,48,188,236,140,20,17,86,111,602,Karl-Anthony Towns
2023-24,MIN,PF,62,62,2026,479,951,.504,136,327,.416,343,624,.550,.575,255,292,.873,94,421,515,189,43,41,177,204,1349,Karl-Anthony Towns
2024-25,NYK,C,29,29,984,249,462,.539,65,145,.448,184,317,.580,.609,142,170,.835,82,309,391,98,25,26,76,105,705,Karl-Anthony Towns
2024-25,LAL,SF,8,0,61,5,18,.278,0,7,.000,5,11,.455,.278,2,7,.286,1,13,14,1,4,2,2,6,12,Armel Traoré
2024-25,CLE,SG,6,0,42,3,7,.429,0,3,.000,3,4,.750,.429,2,2,1.000,1,5,6,5,1,1,2,3,8,Luke Travers
2018-19,POR,SG,15,1,111,16,50,.320,5,21,.238,11,29,.379,.370,3,7,.429,1,10,11,5,1,2,4,4,40,Gary Trent Jr.
2019-20,POR,SF,61,8,1332,196,441,.444,112,268,.418,84,173,.486,.571,37,45,.822,25,75,100,61,48,16,21,90,541,Gary Trent Jr.
2020-21,2TM,SG,58,38,1802,320,785,.408,165,429,.385,155,356,.435,.513,83,106,.783,27,125,152,80,56,10,43,92,888,Gary Trent Jr.
2020-21,POR,SG,41,23,1262,217,524,.414,121,305,.397,96,219,.438,.530,58,75,.773,21,70,91,58,37,6,31,63,613,Gary Trent Jr.
2020-21,TOR,SG,17,15,540,103,261,.395,44,124,.355,59,137,.431,.479,25,31,.806,6,55,61,22,19,4,12,29,275,Gary Trent Jr.
2021-22,TOR,SG,70,69,2448,450,1086,.414,209,545,.383,241,541,.445,.511,174,204,.853,26,165,191,141,122,19,73,144,1283,Gary Trent Jr.
2022-23,TOR,SG,66,44,2118,405,935,.433,166,450,.369,239,485,.493,.522,172,205,.839,30,143,173,106,104,14,55,102,1148,Gary Trent Jr.
2023-24,TOR,SG,71,41,1994,361,847,.426,178,453,.393,183,394,.464,.531,74,96,.771,25,163,188,119,77,10,47,96,974,Gary Trent Jr.
2024-25,MIL,SG,27,7,681,89,212,.420,55,137,.401,34,75,.453,.550,23,26,.885,5,55,60,24,27,1,17,57,256,Gary Trent Jr.
2023-24,IND,PF,8,0,42,10,20,.500,0,0,10,20,.500,.500,6,8,.750,8,8,16,2,2,1,0,3,26,0,Oscar Tshiebwe
2024-25,UTA,PF,1,0,16,0,0,,0,0,0,0,,,3,4,.750,3,6,9,0,2,0,1,3,3,0,Oscar Tshiebwe
2006-07,TOR,SF,17,0,83,11,22,.500,0,0,,11,22,.500,.500,8,14,.571,11,12,23,3,2,0,6,12,30,P.J. Tucker
2012-13,PHO,SG,79,45,1910,210,444,.473,22,70,.314,188,374,.503,.498,64,86,.744,132,218,350,109,62,19,67,145,506,P.J. Tucker
2013-14,PHO,SF,81,81,2490,265,615,.431,74,191,.387,191,424,.450,.491,156,201,.776,161,368,529,141,110,23,102,204,760,P.J. Tucker
2014-15,PHO,SF,78,63,2383,261,596,.438,87,252,.345,174,344,.506,.511,104,143,.727,114,388,502,122,107,23,96,179,713,P.J. Tucker
2015-16,PHO,SF,82,80,2540,239,582,.411,68,206,.330,171,376,.455,.469,106,142,.746,165,347,512,177,106,20,111,202,652,P.J. Tucker
2016-17,2TM,SF,81,21,2236,199,482,.413,70,196,.357,129,286,.451,.485,72,93,.774,117,354,471,99,116,19,66,196,540,P.J. Tucker
2016-17,PHO,SF,57,17,1627,147,354,.415,46,136,.338,101,218,.463,.480,61,77,.792,94,248,342,73,85,14,52,143,401,P.J. Tucker
2016-17,TOR,SF,24,4,609,52,128,.406,24,60,.400,28,68,.412,.500,11,16,.688,23,106,129,26,31,5,14,53,139,P.J. Tucker
2017-18,HOU,PF,82,34,2281,172,441,.390,115,310,.371,57,131,.435,.520,43,60,.717,93,364,457,77,78,26,74,205,502,P.J. Tucker
2018-19,HOU,PF,82,82,2802,207,523,.396,146,387,.377,61,136,.449,.535,41,59,.695,121,358,479,96,132,39,63,252,601,P.J. Tucker
2019-20,HOU,PF,72,72,2467,177,426,.415,107,299,.358,70,127,.551,.541,39,48,.813,112,364,476,115,77,36,72,229,500,P.J. Tucker
2020-21,2TM,PF,52,33,1356,66,177,.373,40,119,.336,26,58,.448,.486,21,28,.750,51,153,204,61,39,20,40,125,193,P.J. Tucker
2020-21,HOU,PF,32,32,959,48,131,.366,27,86,.314,21,45,.467,.469,18,23,.783,33,115,148,45,29,18,33,91,141,P.J. Tucker
2020-21,MIL,PF,20,1,397,18,46,.391,13,33,.394,5,13,.385,.533,3,5,.600,18,38,56,16,10,2,7,34,52,P.J. Tucker
2021-22,MIA,PF,71,70,1981,207,428,.484,80,193,.415,127,235,.540,.577,45,61,.738,100,287,387,149,58,15,66,161,539,P.J. Tucker
2022-23,PHI,PF,75,75,1920,96,225,.427,55,140,.393,41,85,.482,.549,19,23,.826,95,200,295,60,39,15,44,180,266,P.J. Tucker
2023-24,2TM,PF,31,10,486,18,50,.360,13,35,.371,5,15,.333,.490,3,3,1.000,28,57,85,16,16,7,8,54,52,P.J. Tucker
2023-24,PHI,PF,3,3,66,2,5,.400,2,5,.400,0,0,,.600,0,0,,1,13,14,0,3,2,2,9,6,P.J. Tucker
2023-24,LAC,PF,28,7,420,16,45,.356,11,30,.367,5,15,.333,.478,3,3,1.000,27,44,71,16,13,5,6,45,46,P.J. Tucker
2019-20,UTA,SG,20,0,161,20,43,.465,3,17,.176,17,26,.654,.500,19,23,.826,3,17,20,5,1,1,8,10,62,Rayjon Tucker
2020-21,PHI,PG,14,0,68,9,18,.500,2,7,.286,7,11,.636,.556,14,19,.737,1,10,11,6,2,0,4,8,34,Rayjon Tucker
2021-22,2TM,SG,5,0,71,6,9,.667,4,5,.800,2,4,.500,.889,5,7,.714,3,5,8,10,4,0,1,5,21,Rayjon Tucker
2021-22,DEN,SG,3,0,29,1,2,.500,1,2,.500,0,0,,.750,3,4,.750,1,3,4,4,1,0,0,3,6,Rayjon Tucker
2021-22,MIL,SG,2,0,42,5,7,.714,3,3,1.000,2,4,.500,.929,2,3,.667,2,2,4,6,3,0,1,2,15,Rayjon Tucker
2015-16,IND,C,60,30,1367,264,530,.498,3,14,.214,261,516,.506,.501,88,121,.727,68,264,332,41,25,86,67,158,619,Myles Turner
2016-17,IND,C,81,81,2541,444,869,.511,40,115,.348,404,754,.536,.534,245,303,.809,139,450,589,106,74,172,105,262,1173,Myles Turner
2017-18,IND,C,65,62,1836,306,639,.479,56,157,.357,250,482,.519,.523,160,206,.777,93,324,417,87,38,118,96,186,828,Myles Turner
2018-19,IND,C,74,74,2119,380,780,.487,76,196,.388,304,584,.521,.536,148,201,.736,101,430,531,115,60,199,100,195,984,Myles Turner
2019-20,IND,C,62,62,1826,268,587,.457,86,250,.344,182,337,.540,.530,127,169,.751,86,321,407,72,46,132,85,166,749,Myles Turner
2020-21,IND,C,47,47,1455,206,432,.477,69,206,.335,137,226,.606,.557,111,142,.782,63,243,306,48,40,159,67,165,592,Myles Turner
2021-22,IND,C,42,42,1235,200,393,.509,61,183,.333,139,210,.662,.587,79,105,.752,65,232,297,44,28,118,54,119,540,Myles Turner
2022-23,IND,C,62,62,1825,402,733,.548,93,249,.373,309,484,.638,.612,216,276,.783,88,378,466,89,36,140,103,215,1113,Myles Turner
2023-24,IND,C,77,77,2076,476,909,.524,116,324,.358,360,585,.615,.587,245,317,.773,113,420,533,100,39,144,109,232,1313,Myles Turner
2024-25,IND,C,30,30,937,162,337,.481,60,152,.395,102,185,.551,.570,65,90,.722,40,173,213,46,24,64,72,90,449,Myles Turner
2023-24,DEN,PF,18,0,48,8,20,.400,4,14,.286,4,6,.667,.500,0,0,,1,8,9,2,1,0,2,10,20,Hunter Tyson
2024-25,DEN,PF,19,0,179,18,39,.462,8,22,.364,10,17,.588,.564,13,15,.867,8,28,36,9,4,3,8,22,57,Hunter Tyson
2024-25,CLE,SG,18,1,141,17,36,.472,4,13,.308,13,23,.565,.528,4,8,.500,12,17,29,13,5,0,9,23,42,Jaylon Tyson
2022-23,DET,SG,1,0,2,0,1,.000,0,1,.000,0,0,,.000,2,2,1.000,0,0,0,0,1,1,0,0,2,Stanley Umude
2023-24,DET,SG,24,2,307,37,84,.440,24,53,.453,13,31,.419,.583,29,32,.906,8,43,51,11,8,7,14,40,127,Stanley Umude
2024-25,MIL,SG,8,0,26,1,5,.200,1,4,.250,0,1,.000,.300,0,2,.000,0,6,6,2,1,1,0,1,3,Stanley Umude
2012-13,TOR,C,62,57,1482,204,366,.557,0,0,,204,366,.557,.557,146,185,.789,121,251,372,45,17,78,94,188,554,Jonas Valančiūnas
2013-14,TOR,C,81,81,2282,359,676,.531,0,1,.000,359,675,.532,.531,198,260,.762,226,488,714,57,24,71,136,249,916,Jonas Valančiūnas
2014-15,TOR,C,80,80,2096,373,652,.572,0,1,.000,373,651,.573,.572,217,276,.786,215,478,693,39,33,95,109,222,963,Jonas Valančiūnas
2015-16,TOR,C,60,59,1557,303,536,.565,0,0,,303,536,.565,.565,162,213,.761,184,363,547,42,25,80,85,158,768,Jonas Valančiūnas
2016-17,TOR,C,80,80,2066,391,702,.557,1,2,.500,390,700,.557,.558,176,217,.811,226,533,759,57,37,63,106,216,959,Jonas Valančiūnas
2017-18,TOR,C,77,77,1727,390,687,.568,30,74,.405,360,613,.587,.590,170,211,.806,183,477,660,81,29,69,115,192,980,Jonas Valančiūnas
2018-19,2TM,C,49,27,1091,301,538,.559,14,48,.292,287,490,.586,.572,147,185,.795,106,313,419,70,19,53,90,146,763,Jonas Valančiūnas
2018-19,TOR,C,30,10,564,149,259,.575,9,30,.300,140,229,.611,.593,77,94,.819,54,162,216,29,13,23,39,82,384,Jonas Valančiūnas
2018-19,MEM,C,19,17,527,152,279,.545,5,18,.278,147,261,.563,.554,70,91,.769,52,151,203,41,6,30,51,64,379,Jonas Valančiūnas
2019-20,MEM,C,70,70,1845,432,739,.585,32,91,.352,400,648,.617,.606,148,200,.740,213,575,788,131,30,76,127,185,1044,Jonas Valančiūnas
2020-21,MEM,C,62,61,1755,440,743,.592,21,57,.368,419,686,.611,.606,157,203,.773,253,523,776,112,35,57,100,179,1058,Jonas Valančiūnas
2021-22,NOP,C,74,74,2240,510,938,.544,57,158,.361,453,780,.581,.574,237,289,.820,226,617,843,190,41,60,179,247,1314,Jonas Valančiūnas
2022-23,NOP,C,79,79,1968,446,816,.547,38,109,.349,408,707,.577,.570,185,224,.826,225,579,804,140,20,52,159,245,1115,Jonas Valančiūnas
2023-24,NOP,C,82,82,1925,402,719,.559,37,120,.308,365,599,.609,.585,161,205,.785,186,535,721,173,32,68,111,218,1002,Jonas Valančiūnas
2024-25,WAS,C,28,7,556,132,239,.552,2,17,.118,130,222,.586,.556,60,65,.923,64,161,225,63,13,22,49,45,326,Jonas Valančiūnas
2016-17,CHI,SG,57,0,976,102,288,.354,73,208,.351,29,80,.363,.481,14,18,.778,11,140,151,63,30,7,49,86,291,Denzel Valentine
2017-18,CHI,SG,77,37,2095,301,721,.417,143,370,.386,158,351,.450,.517,38,51,.745,48,345,393,244,65,11,99,185,783,Denzel Valentine
2019-20,CHI,SF,36,5,488,97,237,.409,46,137,.336,51,100,.510,.506,6,8,.750,9,65,74,43,26,6,26,51,246,Denzel Valentine
2020-21,CHI,SG,62,3,1036,155,416,.373,80,242,.331,75,174,.431,.469,16,17,.941,24,173,197,105,30,7,42,70,406,Denzel Valentine
2021-22,2TM,SG,24,0,222,25,66,.379,19,47,.404,6,19,.316,.523,0,0,,9,33,42,11,8,0,12,20,69,Denzel Valentine
2021-22,CLE,SG,22,0,204,23,62,.371,18,44,.409,5,18,.278,.516,0,0,,9,29,38,11,7,0,10,17,64,Denzel Valentine
2021-22,UTA,SG,2,0,18,2,4,.500,1,3,.333,1,1,1.000,.625,0,0,,0,4,4,0,1,0,2,3,5,Denzel Valentine
2016-17,TOR,PG,37,0,294,39,111,.351,11,29,.379,28,82,.341,.401,18,22,.818,4,38,42,35,16,3,15,36,107,Fred VanVleet
2017-18,TOR,PG,76,0,1520,232,545,.426,108,261,.414,124,284,.437,.525,84,101,.832,25,159,184,243,68,19,74,130,656,Fred VanVleet
2018-19,TOR,PG,64,28,1760,246,600,.410,112,296,.378,134,304,.441,.503,97,115,.843,21,146,167,307,57,20,82,110,701,Fred VanVleet
2019-20,TOR,SG,54,54,1928,319,773,.413,146,374,.390,173,399,.434,.507,168,198,.848,18,185,203,357,100,17,121,132,952,Fred VanVleet
2020-21,TOR,SG,52,52,1899,338,870,.389,174,476,.366,164,394,.416,.489,169,191,.885,32,188,220,328,87,37,95,119,1019,Fred VanVleet
2021-22,TOR,PG,65,65,2462,442,1097,.403,242,642,.377,200,455,.440,.513,194,222,.874,44,245,289,434,111,35,170,162,1320,Fred VanVleet
2022-23,TOR,PG,69,69,2535,437,1112,.393,207,606,.342,230,506,.455,.486,254,283,.898,30,250,280,495,123,38,140,193,1335,Fred VanVleet
2023-24,HOU,PG,73,73,2684,423,1018,.416,227,586,.387,196,432,.454,.527,197,229,.860,33,245,278,589,101,59,126,183,1270,Fred VanVleet
2024-25,HOU,PG,29,29,1016,156,410,.380,74,230,.322,82,180,.456,.471,59,74,.797,23,107,130,174,40,14,42,67,445,Fred VanVleet
2018-19,DEN,PF,17,0,69,9,19,.474,0,1,.000,9,18,.500,.474,6,10,.600,7,16,23,3,6,1,8,8,24,Jarred Vanderbilt
2019-20,2TM,PF,11,0,46,5,8,.625,0,1,.000,5,7,.714,.625,2,2,1.000,3,6,9,2,3,1,7,6,12,Jarred Vanderbilt
2019-20,DEN,PF,9,0,41,5,7,.714,0,0,,5,7,.714,.714,0,0,,3,5,8,2,3,1,7,6,10,Jarred Vanderbilt
2019-20,MIN,PF,2,0,5,0,1,.000,0,1,.000,0,0,,.000,2,2,1.000,0,1,1,0,0,0,0,0,2,Jarred Vanderbilt
2020-21,MIN,PF,64,30,1139,143,236,.606,1,5,.200,142,231,.615,.608,57,102,.559,118,250,368,76,64,46,53,123,344,Jarred Vanderbilt
2021-22,MIN,PF,74,67,1880,212,361,.587,2,14,.143,210,347,.605,.590,86,131,.656,215,409,624,94,99,46,73,181,512,Jarred Vanderbilt
2022-23,2TM,PF,78,65,1879,247,451,.548,29,90,.322,218,361,.604,.580,96,139,.691,170,412,582,184,83,21,97,190,619,Jarred Vanderbilt
2022-23,UTA,PF,52,41,1254,173,311,.556,19,57,.333,154,254,.606,.587,67,102,.657,121,288,409,142,53,15,68,133,432,Jarred Vanderbilt
2022-23,LAL,PF,26,24,625,74,140,.529,10,33,.303,64,107,.598,.564,29,37,.784,49,124,173,42,30,6,29,57,187,Jarred Vanderbilt
2023-24,LAL,PF,29,6,581,59,114,.518,8,27,.296,51,87,.586,.553,24,36,.667,41,97,138,36,36,5,28,43,150,Jarred Vanderbilt
2020-21,SAS,SF,62,7,1056,123,303,.406,52,150,.347,71,153,.464,.492,43,51,.843,24,150,174,56,43,18,22,88,341,Devin Vassell
2021-22,SAS,SF,71,32,1937,326,764,.427,137,380,.361,189,384,.492,.516,83,99,.838,44,262,306,136,76,41,58,143,872,Devin Vassell
2022-23,SAS,SG,38,32,1178,261,595,.439,103,266,.387,158,329,.480,.525,78,100,.780,8,140,148,136,43,17,57,57,703,Devin Vassell
2023-24,SAS,SG,68,62,2248,498,1056,.472,166,446,.372,332,610,.544,.550,161,201,.801,27,234,261,277,73,23,108,74,1323,Devin Vassell
2024-25,SAS,SG,16,5,434,91,202,.450,35,90,.389,56,112,.500,.537,29,35,.829,11,34,45,44,17,7,26,31,246,Devin Vassell
2023-24,SAC,PF,42,0,511,84,191,.440,45,120,.375,39,71,.549,.558,12,15,.800,30,66,96,19,20,7,12,42,225,Sasha Vezenkov
2019-20,MIA,PG,9,0,83,8,37,.216,6,27,.222,2,10,.200,.297,0,0,,0,5,5,6,5,0,1,6,22,Gabe Vincent
2020-21,MIA,PG,50,7,655,88,233,.378,46,149,.309,42,84,.500,.476,20,23,.870,10,46,56,67,21,2,34,79,242,Gabe Vincent
2021-22,MIA,PG,68,27,1589,214,513,.417,119,323,.368,95,190,.500,.533,44,54,.815,22,104,126,210,62,12,98,158,591,Gabe Vincent
2022-23,MIA,PG,68,34,1759,228,567,.402,117,350,.334,111,217,.512,.505,68,78,.872,27,118,145,167,62,5,92,154,641,Gabe Vincent
2023-24,LAL,PG,11,0,218,15,49,.306,3,28,.107,12,21,.571,.337,1,2,.500,4,5,9,21,9,0,5,19,34,Gabe Vincent
2024-25,LAL,PG,30,4,579,50,133,.376,29,87,.333,21,46,.457,.485,4,8,.500,10,30,40,29,24,5,18,60,133,Gabe Vincent
2014-15,CHO,PF,25,0,259,30,76,.395,5,13,.385,25,63,.397,.428,18,26,.692,28,58,86,4,4,9,11,20,83,Noah Vonleh
2015-16,POR,PF,78,56,1174,117,278,.421,11,46,.239,106,232,.457,.441,38,51,.745,91,214,305,30,27,26,50,152,283,Noah Vonleh
2016-17,POR,PF,74,41,1265,130,270,.481,7,20,.350,123,250,.492,.494,60,94,.638,131,256,387,31,30,27,64,154,327,Noah Vonleh
2017-18,2TM,PF,54,16,875,104,234,.444,20,66,.303,84,168,.500,.487,36,58,.621,70,241,311,34,19,17,31,68,264,Noah Vonleh
2017-18,POR,PF,33,12,476,47,96,.490,2,6,.333,45,90,.500,.500,23,31,.742,35,132,167,13,6,11,15,42,119,Noah Vonleh
2017-18,CHI,PF,21,4,399,57,138,.413,18,60,.300,39,78,.500,.478,13,27,.481,35,109,144,21,13,6,16,26,145,Noah Vonleh
2018-19,NYK,PF,68,57,1722,207,440,.470,46,137,.336,161,303,.531,.523,111,156,.712,113,415,528,129,46,51,88,174,571,Noah Vonleh
2019-20,2TM,C,36,1,377,52,92,.565,3,15,.200,49,77,.636,.582,25,32,.781,37,87,124,28,11,6,21,40,132,Noah Vonleh
2019-20,MIN,C,29,1,347,47,86,.547,2,14,.143,45,72,.625,.558,23,28,.821,34,82,116,26,11,6,19,36,119,Noah Vonleh
2019-20,DEN,C,7,0,30,5,6,.833,1,1,1.000,4,5,.800,.917,2,4,.500,3,5,8,2,0,0,2,4,13,Noah Vonleh
2020-21,BRK,C,4,0,11,0,3,.000,0,2,.000,0,1,.000,.000,0,0,,0,1,1,1,0,0,2,2,0,Noah Vonleh
2022-23,BOS,C,23,1,171,11,24,.458,1,4,.250,10,20,.500,.479,2,2,1.000,18,30,48,7,2,8,11,35,25,Noah Vonleh
2011-12,PHI,C,51,15,812,131,291,.450,3,8,.375,128,283,.452,.455,18,34,.529,88,158,246,31,20,34,33,111,283,Nikola Vučević
2012-13,ORL,C,77,77,2559,461,889,.519,0,3,.000,461,886,.520,.519,86,126,.683,273,644,917,143,61,79,141,218,1008,Nikola Vučević
2013-14,ORL,C,57,57,1812,353,696,.507,0,0,,353,696,.507,.507,105,137,.766,185,441,626,104,60,47,112,169,811,Nikola Vučević
2014-15,ORL,C,74,74,2529,631,1206,.523,2,6,.333,629,1200,.524,.524,164,218,.752,238,572,810,147,54,54,148,220,1428,Nikola Vučević
2015-16,ORL,C,65,60,2037,533,1046,.510,2,9,.222,531,1037,.512,.511,113,150,.753,174,402,576,179,53,70,123,173,1181,Nikola Vučević
2016-17,ORL,C,75,55,2163,483,1031,.468,23,75,.307,460,956,.481,.480,107,160,.669,176,603,779,208,76,74,117,180,1096,Nikola Vučević
2017-18,ORL,C,57,57,1683,399,840,.475,64,204,.314,335,636,.527,.513,77,94,.819,101,422,523,191,56,62,109,144,939,Nikola Vučević
2018-19,ORL,C,80,80,2510,701,1354,.518,84,231,.364,617,1123,.549,.549,179,227,.789,224,736,960,307,81,89,159,157,1665,Nikola Vučević
2019-20,ORL,C,62,62,1998,493,1033,.477,98,289,.339,395,744,.531,.525,131,167,.784,140,533,673,222,54,47,88,135,1215,Nikola Vučević
2020-21,2TM,C,70,70,2348,666,1396,.477,176,440,.400,490,956,.513,.540,131,156,.840,146,671,817,269,65,48,126,137,1639,Nikola Vučević
2020-21,ORL,C,44,44,1500,436,908,.480,117,288,.406,319,620,.515,.545,91,110,.827,87,430,517,167,42,28,83,79,1080,Nikola Vučević
2020-21,CHI,C,26,26,848,230,488,.471,59,152,.388,171,336,.509,.532,40,46,.870,59,241,300,102,23,20,43,58,559,Nikola Vučević
2021-22,CHI,C,73,73,2418,546,1154,.473,104,331,.314,442,823,.537,.518,92,121,.760,142,662,804,236,70,71,136,181,1288,Nikola Vučević
2022-23,CHI,C,82,82,2746,597,1148,.520,121,347,.349,476,801,.594,.573,132,158,.835,159,744,903,265,60,57,139,179,1447,Nikola Vučević
2023-24,CHI,C,76,74,2610,586,1211,.484,92,313,.294,494,898,.550,.522,106,129,.822,210,591,801,254,50,60,120,190,1370,Nikola Vučević
2024-25,CHI,C,30,30,957,250,430,.581,62,136,.456,188,294,.639,.653,58,68,.853,62,231,293,96,24,22,50,70,620,Nikola Vučević
2023-24,WAS,C,10,4,153,29,67,.433,10,36,.278,19,31,.613,.507,17,22,.773,6,30,36,13,5,7,10,28,85,Tristan Vukcevic
2024-25,WAS,C,1,0,3,0,2,.000,0,2,.000,0,0,,.000,0,0,,0,0,0,0,0,1,0,0,0,Tristan Vukcevic
2019-20,CLE,PF,12,0,71,9,13,.692,2,4,.500,7,9,.778,.769,0,1,.000,3,16,19,2,2,4,3,8,20,Dean Wade
2020-21,CLE,PF,63,19,1212,134,311,.431,78,213,.366,56,98,.571,.556,30,39,.769,38,177,215,74,35,21,30,78,376,Dean Wade
2021-22,CLE,PF,51,28,980,99,217,.456,51,142,.359,48,75,.640,.574,20,30,.667,31,119,150,52,29,7,16,88,269,Dean Wade
2022-23,CLE,PF,44,13,891,73,177,.412,45,127,.354,28,50,.560,.540,15,23,.652,20,130,150,37,28,21,17,89,206,Dean Wade
2023-24,CLE,PF,54,32,1108,96,232,.414,79,202,.391,17,30,.567,.584,20,26,.769,37,181,218,43,40,25,20,93,291,Dean Wade
2024-25,CLE,PF,22,13,489,43,109,.394,34,94,.362,9,15,.600,.550,11,23,.478,18,86,104,34,23,10,6,32,131,Dean Wade
2021-22,ORL,SF,79,79,2429,456,975,.468,96,271,.354,360,704,.511,.517,189,219,.863,84,272,356,231,68,34,119,164,1197,Franz Wagner
2022-23,ORL,SF,80,80,2609,542,1118,.485,130,360,.361,412,758,.544,.543,271,322,.842,70,259,329,283,77,17,167,183,1485,Franz Wagner
2023-24,ORL,SF,72,72,2337,528,1096,.482,94,334,.281,434,762,.570,.525,271,319,.850,72,309,381,269,76,28,137,168,1421,Franz Wagner
2024-25,ORL,SF,25,25,829,220,473,.465,51,159,.321,169,314,.538,.519,119,135,.881,23,117,140,142,43,12,61,58,610,Franz Wagner
2018-19,LAL,C,43,5,446,71,171,.415,22,77,.286,49,94,.521,.480,43,53,.811,17,68,85,24,11,13,39,57,207,Moritz Wagner
2019-20,WAS,C,45,5,835,145,266,.545,25,80,.313,120,186,.645,.592,78,95,.821,56,163,219,56,28,19,66,152,393,Moritz Wagner
2020-21,3TM,C,45,24,722,104,229,.454,31,91,.341,73,138,.529,.522,71,87,.816,27,119,146,50,26,18,43,108,310,Moritz Wagner
2020-21,WAS,C,25,13,375,62,122,.508,13,42,.310,49,80,.613,.561,41,52,.788,13,60,73,32,22,8,21,62,178,Moritz Wagner
2020-21,BOS,C,9,1,61,4,14,.286,2,6,.333,2,8,.250,.357,1,2,.500,3,16,19,6,0,1,9,10,11,Moritz Wagner
2020-21,ORL,C,11,10,286,38,93,.409,16,43,.372,22,50,.440,.495,29,33,.879,11,43,54,12,4,9,13,36,121,Moritz Wagner
2021-22,ORL,C,63,3,960,197,396,.497,66,201,.328,131,195,.672,.581,104,129,.806,42,190,232,87,20,13,56,123,564,Moritz Wagner
2022-23,ORL,C,57,18,1109,198,396,.500,51,163,.313,147,233,.631,.564,153,182,.841,69,190,259,84,37,13,68,136,600,Moritz Wagner
2023-24,ORL,C,80,1,1415,332,552,.601,38,115,.330,294,437,.673,.636,166,204,.814,117,230,347,96,39,21,97,160,868,Moritz Wagner
2024-25,ORL,C,30,1,564,140,249,.562,27,75,.360,113,174,.649,.616,79,110,.718,40,108,148,42,24,12,49,55,386,Moritz Wagner
2021-22,PHO,PF,45,0,359,41,104,.394,19,59,.322,22,45,.489,.486,7,12,.583,27,27,54,15,20,6,13,49,108,Ish Wainright
2022-23,PHO,SF,60,2,915,84,227,.370,57,173,.329,27,54,.500,.496,26,31,.839,45,94,139,53,38,22,22,117,251,Ish Wainright
2023-24,2TM,SF,11,0,62,7,24,.292,7,20,.350,0,4,.000,.438,2,2,1.000,3,11,14,1,4,1,2,8,23,Ish Wainright
2023-24,POR,SF,7,0,46,6,18,.333,6,16,.375,0,2,.000,.500,2,2,1.000,0,9,9,0,2,1,1,4,20,Ish Wainright
2023-24,PHO,SF,4,0,16,1,6,.167,1,4,.250,0,2,.000,.250,0,0,,3,2,5,1,2,0,1,4,3,Ish Wainright
2022-23,POR,SF,56,0,619,83,198,.419,16,56,.286,67,142,.472,.460,34,45,.756,48,83,131,34,10,13,29,69,216,Jabari Walker
2023-24,POR,SF,72,23,1700,234,509,.460,41,139,.295,193,370,.522,.500,129,171,.754,151,357,508,71,42,22,66,173,638,Jabari Walker
2024-25,POR,SF,23,1,244,32,73,.438,4,21,.190,28,52,.538,.466,12,15,.800,21,50,71,13,8,3,13,27,80,Jabari Walker
2023-24,IND,PF,33,0,340,45,110,.409,22,55,.400,23,55,.418,.509,8,9,.889,12,51,63,40,15,11,17,29,120,Jarace Walker
2024-25,IND,PF,32,1,565,69,156,.442,31,84,.369,38,72,.528,.542,23,37,.622,13,95,108,49,33,10,42,53,192,Jarace Walker
2018-19,SAS,SG,17,0,118,16,46,.348,5,13,.385,11,33,.333,.402,8,10,.800,0,17,17,9,7,3,4,7,45,Lonnie Walker IV
2019-20,SAS,SG,61,12,988,152,357,.426,41,101,.406,111,256,.434,.483,44,61,.721,23,116,139,68,32,14,44,78,389,Lonnie Walker IV
2020-21,SAS,SG,60,38,1522,256,609,.420,100,282,.355,156,327,.477,.502,57,70,.814,14,141,155,101,29,15,65,101,669,Lonnie Walker IV
2021-22,SAS,SG,70,6,1612,311,764,.407,111,353,.314,200,411,.487,.480,116,148,.784,18,163,181,152,44,19,71,98,849,Lonnie Walker IV
2022-23,LAL,SG,56,32,1297,236,527,.448,91,249,.365,145,278,.522,.534,91,106,.858,14,95,109,64,30,17,46,71,654,Lonnie Walker IV
2023-24,BRK,SG,58,0,1011,208,492,.423,104,271,.384,104,221,.471,.528,45,59,.763,13,114,127,74,32,20,51,71,565,Lonnie Walker IV
2021-22,PHO,SG,2,0,8,0,4,.000,0,2,.000,0,2,.000,.000,0,0,0,1,1,1,2,0,0,1,0,0,M.J. Walker
2010-11,WAS,PG,69,64,2606,398,972,.409,34,115,.296,364,857,.425,.427,301,393,.766,35,282,317,574,121,35,261,175,1131,John Wall
2011-12,WAS,PG,66,66,2386,378,894,.423,3,42,.071,375,852,.440,.424,317,402,.789,48,252,300,530,95,57,255,137,1076,John Wall
2012-13,WAS,PG,49,42,1602,324,735,.441,12,45,.267,312,690,.452,.449,246,306,.804,35,161,196,373,65,37,157,117,906,John Wall
2013-14,WAS,PG,82,82,2980,579,1337,.433,108,308,.351,471,1029,.458,.473,317,394,.805,38,295,333,721,149,40,295,219,1583,John Wall
2014-15,WAS,PG,79,79,2837,519,1166,.445,65,217,.300,454,949,.478,.473,284,362,.785,36,330,366,792,138,45,304,180,1387,John Wall
2015-16,WAS,PG,77,77,2784,572,1349,.424,115,328,.351,457,1021,.448,.467,272,344,.791,42,337,379,789,145,59,318,159,1531,John Wall
2016-17,WAS,PG,78,78,2836,647,1435,.451,89,272,.327,558,1163,.480,.482,422,527,.801,59,267,326,831,157,49,322,151,1805,John Wall
2017-18,WAS,PG,41,41,1410,280,667,.420,62,167,.371,218,500,.436,.466,175,241,.726,22,128,150,393,57,45,158,80,797,John Wall
2018-19,WAS,PG,32,32,1104,245,552,.444,51,169,.302,194,383,.507,.490,122,175,.697,15,101,116,279,49,29,121,71,663,John Wall
2020-21,HOU,PG,40,40,1288,293,726,.404,79,249,.317,214,477,.449,.458,158,211,.749,17,112,129,275,42,31,141,46,823,John Wall
2022-23,LAC,PG,34,3,755,138,338,.408,33,109,.303,105,229,.459,.457,77,113,.681,14,78,92,178,27,12,80,59,386,John Wall
2023-24,OKC,SG,82,13,1692,217,442,.491,98,234,.419,119,208,.572,.602,29,37,.784,52,135,187,120,76,37,45,129,561,Cason Wallace
2024-25,OKC,SG,29,17,769,79,186,.425,27,90,.300,52,96,.542,.497,6,7,.857,35,67,102,64,48,23,17,60,191,Cason Wallace
2024-25,ATL,PG,14,1,219,24,59,.407,9,29,.310,15,30,.500,.483,4,4,1.000,2,17,19,26,10,6,16,13,61,Keaton Wallace
2023-24,BOS,SF,9,1,83,6,15,.400,2,9,.222,4,6,.667,.467,1,2,.500,5,15,20,5,5,1,3,11,15,Jordan Walsh
2024-25,BOS,PF,22,1,182,12,36,.333,7,28,.250,5,8,.625,.431,4,6,.667,10,17,27,6,5,7,5,13,35,Jordan Walsh
2024-25,TOR,SG,16,6,328,52,131,.397,17,61,.279,35,70,.500,.462,21,29,.724,16,32,48,25,9,5,15,38,142,Ja'Kobe Walter
2024-25,MIA,C,13,0,113,19,39,.487,3,10,.300,16,29,.552,.526,2,2,1.000,6,24,30,2,5,8,6,11,43,Kel'el Ware
2014-15,PHO,SF,40,1,614,113,214,.528,5,21,.238,108,193,.560,.540,14,19,.737,41,44,85,25,18,9,27,51,245,T.J. Warren
2015-16,PHO,SF,47,4,1070,221,441,.501,28,70,.400,193,371,.520,.533,45,64,.703,57,90,147,44,37,16,32,94,515,T.J. Warren
2016-17,PHO,SF,66,59,2048,403,814,.495,26,98,.265,377,716,.527,.511,119,154,.773,125,214,339,75,76,39,57,175,951,T.J. Warren
2017-18,PHO,SF,65,65,2142,529,1063,.498,20,90,.222,509,973,.523,.507,193,255,.757,125,208,333,85,65,41,85,149,1271,T.J. Warren
2018-19,PHO,SF,43,36,1360,297,611,.486,77,180,.428,220,431,.510,.549,101,124,.815,31,143,174,64,51,29,52,119,772,T.J. Warren
2019-20,IND,SF,67,67,2202,534,997,.536,91,226,.403,443,771,.575,.581,167,204,.819,68,212,280,99,78,34,84,187,1326,T.J. Warren
2020-21,IND,SF,4,4,117,27,51,.529,0,7,.000,27,44,.614,.529,8,10,.800,2,12,14,5,2,0,4,16,62,T.J. Warren
2022-23,2TM,PF,42,0,687,132,270,.489,22,67,.328,110,203,.542,.530,28,35,.800,26,95,121,40,22,12,20,65,314,T.J. Warren
2022-23,BRK,PF,26,0,490,102,200,.510,16,48,.333,86,152,.566,.550,27,33,.818,13,59,72,29,15,7,17,45,247,T.J. Warren
2022-23,PHO,SF,16,0,197,30,70,.429,6,19,.316,24,51,.471,.471,1,2,.500,13,36,49,11,7,5,3,20,67,T.J. Warren
2023-24,MIN,SF,11,0,125,18,41,.439,2,13,.154,16,28,.571,.463,3,4,.750,5,17,22,9,4,1,4,11,41,T.J. Warren
2021-22,IND,PG,48,7,968,173,427,.405,81,215,.377,92,212,.434,.500,46,61,.754,4,79,83,85,26,3,57,66,473,Duane Washington Jr.
2022-23,PHO,SG,31,3,394,94,256,.367,40,111,.360,54,145,.372,.445,16,24,.667,2,34,36,63,6,4,34,23,244,Duane Washington Jr.
2019-20,CHO,PF,58,57,1759,268,589,.455,86,230,.374,182,359,.507,.528,88,136,.647,58,258,316,123,51,44,93,158,710,P.J. Washington
2020-21,CHO,PF,64,61,1954,302,686,.440,112,290,.386,190,396,.480,.522,108,145,.745,93,325,418,161,69,79,128,171,824,P.J. Washington
2021-22,CHO,C,65,28,1768,250,532,.470,110,301,.365,140,231,.606,.573,58,81,.716,82,255,337,147,57,61,82,152,668,P.J. Washington
2022-23,CHO,PF,73,73,2380,434,978,.444,149,428,.348,285,550,.518,.520,127,174,.730,73,285,358,175,66,79,110,193,1144,P.J. Washington
2023-24,2TM,PF,73,45,2221,354,811,.436,132,413,.320,222,398,.558,.518,99,145,.683,85,326,411,141,72,59,96,169,939,P.J. Washington
2023-24,CHO,PF,44,17,1286,227,509,.446,79,244,.324,148,265,.558,.524,67,94,.713,53,179,232,97,38,32,66,112,600,P.J. Washington
2023-24,DAL,PF,29,28,935,127,302,.421,53,169,.314,74,133,.556,.508,32,51,.627,32,147,179,44,34,27,30,57,339,P.J. Washington
2024-25,DAL,PF,25,24,809,111,247,.449,39,99,.394,72,148,.486,.528,43,58,.741,37,155,192,55,31,27,44,51,304,P.J. Washington
2022-23,HOU,PG,31,2,433,58,160,.363,19,80,.238,39,80,.488,.422,10,18,.556,2,43,45,47,15,2,14,29,145,TyTy Washington Jr.
2023-24,MIL,PG,11,0,56,6,20,.300,2,6,.333,4,14,.286,.350,0,0,,1,4,5,5,3,0,2,1,14,TyTy Washington Jr.
2024-25,PHO,PG,3,0,27,3,6,.500,2,3,.667,1,3,.333,.667,0,0,,0,1,1,4,2,0,1,0,8,TyTy Washington Jr.
2018-19,MEM,SF,15,0,174,15,51,.294,2,16,.125,13,35,.371,.314,7,10,.700,4,27,31,8,4,1,6,11,39,Yuta Watanabe
2019-20,MEM,SF,18,0,105,15,34,.441,3,8,.375,12,26,.462,.485,3,8,.375,7,13,20,5,5,1,2,9,36,Yuta Watanabe
2020-21,TOR,SF,50,4,723,79,180,.439,36,90,.400,43,90,.478,.539,24,29,.828,36,123,159,40,26,19,19,57,218,Yuta Watanabe
2021-22,TOR,SF,38,4,445,56,138,.406,27,79,.342,29,59,.492,.504,24,40,.600,18,74,92,21,11,16,19,38,163,Yuta Watanabe
2022-23,BRK,SF,58,1,928,114,232,.491,60,135,.444,54,97,.557,.621,34,47,.723,30,111,141,48,25,17,22,80,322,Yuta Watanabe
2023-24,2TM,SF,34,0,464,41,116,.353,25,85,.294,16,31,.516,.461,10,17,.588,11,43,54,15,12,7,19,39,117,Yuta Watanabe
2023-24,PHO,SF,29,0,382,35,97,.361,24,75,.320,11,22,.500,.485,10,15,.667,11,34,45,10,9,7,16,34,104,Yuta Watanabe
2023-24,MEM,SF,5,0,82,6,19,.316,1,10,.100,5,9,.556,.342,0,2,.000,0,9,9,5,3,0,3,5,13,Yuta Watanabe
2021-22,OKC,SG,25,1,465,71,175,.406,53,146,.363,18,29,.621,.557,4,5,.800,6,67,73,24,19,8,11,31,199,Lindy Waters III
2022-23,OKC,SG,41,0,531,70,178,.393,58,162,.358,12,16,.750,.556,16,20,.800,16,59,75,28,14,11,10,42,214,Lindy Waters III
2023-24,OKC,SG,38,0,280,49,104,.471,37,85,.435,12,19,.632,.649,2,2,1.000,7,33,40,24,5,7,7,23,137,Lindy Waters III
2024-25,GSW,SG,23,8,411,47,129,.364,31,93,.333,16,36,.444,.484,4,5,.800,11,48,59,31,17,5,8,37,129,Lindy Waters III
2019-20,BOS,PG,11,1,119,14,49,.286,4,24,.167,10,25,.400,.327,8,8,1.000,0,12,12,16,10,2,15,13,40,Tremont Waters
2020-21,BOS,PG,26,3,238,34,84,.405,15,38,.395,19,46,.413,.494,16,17,.941,5,16,21,62,15,1,27,17,99,Tremont Waters
2021-22,2TM,PG,3,0,50,4,14,.286,2,9,.222,2,5,.400,.357,0,0,,0,4,4,7,5,0,4,4,10,Tremont Waters
2021-22,TOR,PG,2,0,42,3,12,.250,2,9,.222,1,3,.333,.333,0,0,,0,4,4,7,4,0,4,2,8,Tremont Waters
2021-22,WAS,PG,1,0,8,1,2,.500,0,0,,1,2,.500,.500,0,0,,0,0,0,0,1,0,0,2,2,Tremont Waters
2021-22,POR,SF,48,10,869,142,267,.532,9,38,.237,133,229,.581,.549,71,94,.755,57,142,199,81,25,28,44,116,364,Trendon Watford
2022-23,POR,PF,62,12,1182,181,323,.560,25,64,.391,156,259,.602,.599,72,100,.720,42,196,238,130,32,12,71,118,459,Trendon Watford
2023-24,BRK,PF,63,2,856,164,311,.527,27,68,.397,137,243,.564,.571,77,97,.794,52,142,194,81,23,19,63,106,432,Trendon Watford
2024-25,BRK,PF,13,0,209,35,79,.443,8,26,.308,27,53,.509,.494,30,35,.857,4,32,36,15,5,4,16,30,108,Trendon Watford
2022-23,DEN,SG,23,2,186,29,59,.492,6,14,.429,23,45,.511,.542,11,20,.550,8,29,37,11,2,11,8,14,75,Peyton Watson
2023-24,DEN,SF,80,4,1488,208,447,.465,45,152,.296,163,295,.553,.516,71,106,.670,56,202,258,86,42,88,58,143,532,Peyton Watson
2024-25,DEN,SF,29,12,696,92,187,.492,22,61,.361,70,126,.556,.551,49,63,.778,30,68,98,40,22,27,23,58,255,Peyton Watson
2019-20,SAS,SG,11,0,78,5,17,.294,1,5,.200,4,12,.333,.324,1,2,.500,1,6,7,11,3,1,5,8,12,Quinndary Weatherspoon
2020-21,SAS,SG,20,0,121,16,35,.457,1,6,.167,15,29,.517,.471,13,16,.813,3,8,11,8,8,2,10,18,46,Quinndary Weatherspoon
2021-22,GSW,SG,11,0,73,12,21,.571,1,5,.200,11,16,.688,.595,5,5,1.000,2,12,14,5,1,1,3,15,30,Quinndary Weatherspoon
2024-25,MEM,SG,32,27,793,133,289,.460,59,151,.391,74,138,.536,.562,43,53,.811,30,71,101,54,15,5,37,57,368,Jaylen Wells
2018-19,DEN,C,11,0,36,7,13,.538,3,7,.429,4,6,.667,.654,1,2,.500,0,4,4,5,0,0,1,3,18,Thomas Welsh
2023-24,SAS,C,71,71,2106,551,1186,.465,128,394,.325,423,792,.534,.519,292,367,.796,161,594,755,274,88,254,260,153,1522,Victor Wembanyama
2024-25,SAS,C,26,26,858,234,487,.480,88,244,.361,146,243,.601,.571,99,112,.884,48,215,263,101,27,105,93,54,655,Victor Wembanyama
2022-23,SAS,SG,37,1,669,69,215,.321,20,52,.385,49,163,.301,.367,26,44,.591,12,69,81,98,25,5,65,67,184,Blake Wesley
2023-24,SAS,SG,61,3,876,102,215,.474,12,55,.218,90,160,.563,.502,52,78,.667,18,76,94,166,29,9,55,89,268,Blake Wesley
2024-25,SAS,SG,22,0,250,34,75,.453,4,20,.200,30,55,.545,.480,15,21,.714,6,13,19,42,9,2,22,14,87,Blake Wesley
2008-09,OKC,PG,82,65,2668,436,1095,.398,35,129,.271,401,966,.415,.414,349,428,.815,178,221,399,435,110,16,274,191,1256,Russell Westbrook
2009-10,OKC,PG,82,82,2813,485,1160,.418,23,104,.221,462,1056,.438,.428,329,422,.780,143,258,401,652,108,34,268,204,1322,Russell Westbrook
2010-11,OKC,PG,82,82,2847,614,1390,.442,34,103,.330,580,1287,.451,.454,531,631,.842,121,258,379,670,155,30,316,207,1793,Russell Westbrook
2011-12,OKC,PG,66,66,2331,578,1266,.457,62,196,.316,516,1070,.482,.481,340,413,.823,96,205,301,362,112,21,239,147,1558,Russell Westbrook
2012-13,OKC,PG,82,82,2861,673,1535,.438,97,300,.323,576,1235,.466,.470,460,575,.800,111,317,428,607,145,24,273,189,1903,Russell Westbrook
2013-14,OKC,PG,46,46,1412,346,791,.437,68,214,.318,278,577,.482,.480,242,293,.826,55,208,263,319,88,7,177,104,1002,Russell Westbrook
2014-15,OKC,PG,67,67,2302,627,1471,.426,86,288,.299,541,1183,.457,.455,546,654,.835,124,364,488,574,140,14,293,184,1886,Russell Westbrook
2015-16,OKC,PG,80,80,2750,656,1444,.454,101,341,.296,555,1103,.503,.489,465,573,.812,145,481,626,834,163,20,342,200,1878,Russell Westbrook
2016-17,OKC,PG,81,81,2802,824,1941,.425,200,583,.343,624,1358,.459,.476,710,840,.845,137,727,864,840,132,31,438,190,2558,Russell Westbrook
2017-18,OKC,PG,80,80,2914,757,1687,.449,97,326,.298,660,1361,.485,.477,417,566,.737,152,652,804,820,147,20,381,200,2028,Russell Westbrook
2018-19,OKC,PG,73,73,2630,630,1473,.428,119,411,.290,511,1062,.481,.468,296,451,.656,109,698,807,784,142,33,325,245,1675,Russell Westbrook
2019-20,HOU,PG,57,57,2049,604,1281,.472,55,213,.258,549,1068,.514,.493,290,380,.763,100,351,451,401,93,20,255,200,1553,Russell Westbrook
2020-21,WAS,PG,65,65,2369,544,1238,.439,86,273,.315,458,965,.475,.474,271,413,.656,109,641,750,763,89,23,312,190,1445,Russell Westbrook
2021-22,LAL,PG,78,78,2678,548,1233,.444,79,265,.298,469,968,.485,.476,266,399,.667,110,470,580,550,75,20,295,235,1441,Russell Westbrook
2022-23,2TM,PG,73,24,2126,432,991,.436,89,286,.311,343,705,.487,.481,206,314,.656,89,334,423,551,76,33,255,162,1159,Russell Westbrook
2022-23,LAL,PG,52,3,1491,304,729,.417,63,213,.296,241,516,.467,.460,156,238,.655,59,262,321,391,53,23,184,121,827,Russell Westbrook
2022-23,LAC,PG,21,21,635,128,262,.489,26,73,.356,102,189,.540,.538,50,76,.658,30,72,102,160,23,10,71,41,332,Russell Westbrook
2023-24,LAC,PG,68,11,1529,301,663,.454,42,154,.273,259,509,.509,.486,110,160,.688,93,250,343,306,74,23,144,121,754,Russell Westbrook
2024-25,DEN,PG,29,8,755,128,298,.430,34,108,.315,94,190,.495,.487,61,99,.616,29,93,122,183,48,17,79,72,351,Russell Westbrook
2019-20,CHI,PG,65,1,1674,312,792,.394,133,376,.354,179,416,.430,.478,102,129,.791,28,202,230,175,49,6,109,117,859,Coby White
2020-21,CHI,PG,69,54,2156,375,902,.416,163,454,.359,212,448,.473,.506,128,142,.901,28,256,284,328,38,15,156,179,1041,Coby White
2021-22,CHI,PG,61,17,1675,279,644,.433,136,353,.385,143,291,.491,.539,78,91,.857,17,165,182,176,29,11,70,137,772,Coby White
2022-23,CHI,SG,74,2,1730,263,594,.443,128,344,.372,135,250,.540,.551,61,70,.871,16,196,212,204,54,6,74,122,715,Coby White
2023-24,CHI,PG,79,78,2881,541,1209,.447,209,556,.376,332,653,.508,.534,218,260,.838,44,314,358,405,53,18,166,186,1509,Coby White
2024-25,CHI,SG,29,29,944,171,407,.420,91,248,.367,80,159,.503,.532,79,90,.878,11,88,99,131,33,5,70,73,512,Coby White
2017-18,SAS,PG,17,0,139,16,33,.485,8,13,.615,8,20,.400,.606,14,20,.700,5,21,26,9,4,3,6,8,54,Derrick White
2018-19,SAS,PG,67,55,1728,260,543,.479,48,142,.338,212,401,.529,.523,95,123,.772,35,212,247,263,67,47,97,145,663,Derrick White
2019-20,SAS,SG,68,20,1677,253,552,.458,79,216,.366,174,336,.518,.530,180,211,.853,35,188,223,241,44,59,89,152,765,Derrick White
2020-21,SAS,SG,36,32,1064,186,453,.411,84,243,.346,102,210,.486,.503,97,114,.851,13,94,107,127,26,36,45,91,553,Derrick White
2021-22,2TM,SG,75,52,2199,337,800,.421,115,369,.312,222,431,.515,.493,203,235,.864,38,223,261,366,64,58,119,172,992,Derrick White
2021-22,SAS,SG,49,48,1486,243,570,.426,81,258,.314,162,312,.519,.497,139,160,.869,25,148,173,274,49,42,87,116,706,Derrick White
2021-22,BOS,SG,26,4,713,94,230,.409,34,111,.306,60,119,.504,.483,64,75,.853,13,75,88,92,15,16,32,56,286,Derrick White
2022-23,BOS,SG,82,70,2319,350,758,.462,149,391,.381,201,367,.548,.560,168,192,.875,52,241,293,321,54,76,95,177,1017,Derrick White
2023-24,BOS,SG,73,73,2381,387,839,.461,196,495,.396,191,344,.555,.578,137,152,.901,51,259,310,377,74,87,112,152,1107,Derrick White
2024-25,BOS,SG,30,30,1027,172,386,.446,106,272,.390,66,114,.579,.583,56,66,.848,30,111,141,141,31,32,51,63,506,Derrick White
2022-23,DEN,SF,17,0,66,8,19,.421,3,9,.333,5,10,.500,.500,2,3,.667,6,11,17,4,3,2,2,9,21,Jack White
2023-24,MEM,SF,4,0,64,2,16,.125,2,10,.200,0,6,.000,.188,0,0,,4,8,12,1,4,1,2,3,6,Jack White
2016-17,MIA,PF,35,0,471,33,87,.379,12,34,.353,21,53,.396,.448,20,22,.909,25,57,82,21,10,10,18,52,98,Okaro White
2017-18,MIA,PF,6,4,80,7,16,.438,4,11,.364,3,5,.600,.563,2,3,.667,3,8,11,2,1,1,1,6,20,Okaro White
2018-19,WAS,PF,3,0,6,0,2,.000,0,2,.000,0,0,,.000,0,0,,1,1,2,0,0,0,0,0,0,Okaro White
2023-24,HOU,SF,47,2,880,212,467,.454,79,220,.359,133,247,.538,.539,76,112,.679,44,136,180,33,30,17,46,64,579,Cam Whitmore
2024-25,HOU,SF,13,0,163,42,97,.433,9,42,.214,33,55,.600,.479,17,24,.708,10,21,31,7,5,2,8,11,110,Cam Whitmore
2021-22,SAS,SG,29,0,205,20,56,.357,14,43,.326,6,13,.462,.482,7,13,.538,4,10,14,9,4,3,2,14,61,Joe Wieskamp
2022-23,TOR,SF,9,0,50,3,14,.214,3,12,.250,0,2,.000,.321,0,0,,0,4,4,3,0,0,1,3,9,Joe Wieskamp
2021-22,OKC,SG,50,35,1209,156,337,.463,42,138,.304,114,199,.573,.525,62,85,.729,51,127,178,68,30,10,54,93,416,Aaron Wiggins
2022-23,OKC,SG,70,14,1297,186,363,.512,48,122,.393,138,241,.573,.579,59,71,.831,68,142,210,80,39,15,55,110,479,Aaron Wiggins
2023-24,OKC,SG,78,4,1228,212,377,.562,62,126,.492,150,251,.598,.645,56,71,.789,60,126,186,86,56,19,56,91,542,Aaron Wiggins
2024-25,OKC,SG,29,8,562,95,215,.442,39,102,.382,56,113,.496,.533,15,19,.789,24,67,91,40,24,8,24,36,244,Aaron Wiggins
2014-15,MIN,SF,82,82,2969,497,1137,.437,39,126,.310,458,1011,.453,.454,354,466,.760,134,240,374,170,86,50,177,190,1387,Andrew Wiggins
2015-16,MIN,SF,81,81,2845,594,1294,.459,57,190,.300,537,1104,.486,.481,430,565,.761,105,186,291,164,78,46,182,165,1675,Andrew Wiggins
2016-17,MIN,SF,82,82,3048,709,1570,.452,103,289,.356,606,1281,.473,.484,412,542,.760,102,226,328,189,82,30,187,183,1933,Andrew Wiggins
2017-18,MIN,SF,82,82,2979,569,1300,.438,112,338,.331,457,962,.475,.481,202,314,.643,82,276,358,160,91,51,138,163,1452,Andrew Wiggins
2018-19,MIN,SF,73,73,2543,498,1209,.412,118,348,.339,380,861,.441,.461,207,296,.699,83,269,352,184,70,48,138,153,1321,Andrew Wiggins
2019-20,2TM,SF,54,54,1858,437,978,.447,111,334,.332,326,644,.506,.504,190,268,.709,66,208,274,198,45,53,132,127,1175,Andrew Wiggins
2019-20,MIN,SF,42,42,1455,351,790,.444,91,275,.331,260,515,.505,.502,149,207,.720,48,171,219,155,29,36,107,101,942,Andrew Wiggins
2019-20,GSW,SF,12,12,403,86,188,.457,20,59,.339,66,129,.512,.511,41,61,.672,18,37,55,43,16,17,25,26,233,Andrew Wiggins
2020-21,GSW,PF,71,71,2364,505,1058,.477,140,368,.380,365,690,.529,.543,170,238,.714,82,265,347,167,67,70,126,159,1320,Andrew Wiggins
2021-22,GSW,SF,73,73,2330,475,1019,.466,157,399,.393,318,620,.513,.543,149,235,.634,85,240,325,161,76,51,111,158,1256,Andrew Wiggins
2022-23,GSW,SF,37,37,1190,250,529,.473,89,225,.396,161,304,.530,.557,44,72,.611,61,125,186,85,45,28,48,107,633,Andrew Wiggins
2023-24,GSW,SF,71,59,1920,353,780,.453,91,254,.358,262,526,.498,.511,142,189,.751,108,213,321,119,42,41,87,147,939,Andrew Wiggins
2024-25,GSW,SF,26,26,748,153,340,.450,59,139,.424,94,201,.468,.537,77,98,.786,42,70,112,60,23,20,30,44,442,Andrew Wiggins
2021-22,MIL,PG,19,0,199,26,61,.426,9,26,.346,17,35,.486,.500,19,35,.543,3,22,25,23,5,1,12,17,80,Lindell Wigginton
2022-23,MIL,PG,7,1,87,18,37,.486,6,18,.333,12,19,.632,.568,8,9,.889,0,7,7,14,0,2,12,7,50,Lindell Wigginton
2023-24,MIL,PG,3,0,8,2,5,.400,0,2,.000,2,3,.667,.400,2,2,1.000,0,0,0,0,0,0,1,1,6,Lindell Wigginton
2022-23,BRK,SG,1,0,5,0,0,,0,0,,0,0,,,0,0,,0,1,1,0,0,0,2,1,0,Alondes Williams
2023-24,MIA,SG,7,0,16,2,8,.250,0,4,.000,2,4,.500,.250,1,1,1.000,0,1,1,0,0,1,2,2,5,Alondes Williams
2024-25,DET,SG,1,0,4,2,2,1.000,1,1,1.000,1,1,1.000,1.250,0,0,,0,0,0,1,0,0,0,0,5,Alondes Williams
2021-22,POR,PG,24,16,640,105,282,.372,31,106,.292,74,176,.420,.427,68,97,.701,19,55,74,94,24,10,58,52,309,Brandon Williams
2023-24,DAL,PG,17,0,113,20,54,.370,3,15,.200,17,39,.436,.398,11,17,.647,4,9,13,17,1,1,7,4,54,Brandon Williams
2024-25,DAL,PG,5,0,21,2,9,.222,0,2,.000,2,7,.286,.222,2,3,.667,1,3,4,2,0,0,2,2,6,Brandon Williams
2024-25,UTA,SG,17,7,324,20,70,.286,8,38,.211,12,32,.375,.343,6,10,.600,9,29,38,20,7,6,12,24,54,Cody Williams
2022-23,ATL,SG,2,0,4,2,5,.400,0,2,.000,2,3,.667,.400,0,0,0,2,2,0,0,0,0,0,4,0,Donovan Williams
2019-20,BOS,PF,69,5,1043,87,211,.412,24,96,.250,63,115,.548,.469,39,54,.722,59,119,178,68,30,36,50,163,237,Grant Williams
2020-21,BOS,PF,63,9,1138,108,247,.437,48,129,.372,60,118,.508,.534,30,51,.588,48,130,178,64,32,24,56,161,294,Grant Williams
2021-22,BOS,PF,77,21,1875,205,432,.475,106,258,.411,99,174,.569,.597,86,95,.905,64,210,274,78,38,57,62,186,602,Grant Williams
2022-23,BOS,PF,79,23,2045,216,476,.454,115,291,.395,101,185,.546,.575,94,122,.770,87,276,363,131,41,31,82,192,641,Grant Williams
2023-24,2TM,PF,76,43,2130,276,605,.456,126,336,.375,150,269,.558,.560,106,140,.757,86,232,318,174,44,39,109,226,784,Grant Williams
2023-24,DAL,PF,47,33,1242,131,317,.413,79,210,.376,52,107,.486,.538,41,55,.745,46,123,169,81,24,27,53,137,382,Grant Williams
2023-24,CHO,PF,29,10,888,145,288,.503,47,126,.373,98,162,.605,.585,65,85,.765,40,109,149,93,20,12,56,89,402,Grant Williams
2024-25,CHO,PF,16,7,479,54,123,.439,27,74,.365,27,49,.551,.549,31,37,.838,18,64,82,37,18,13,28,46,166,Grant Williams
2022-23,OKC,SG,75,62,2276,414,794,.521,73,205,.356,341,589,.579,.567,155,191,.812,84,253,337,248,103,35,123,191,1056,Jalen Williams
2023-24,OKC,PF,71,71,2223,536,993,.540,103,241,.427,433,752,.576,.592,180,221,.814,37,245,282,322,80,45,123,175,1355,Jalen Williams
2024-25,OKC,SG,29,29,938,244,504,.484,57,150,.380,187,354,.528,.541,79,98,.806,26,144,170,145,51,21,67,77,624,Jalen Williams
2022-23,OKC,C,49,36,914,102,234,.436,46,113,.407,56,121,.463,.534,38,54,.704,44,197,241,76,28,12,37,111,288,Jaylin Williams
2023-24,OKC,C,69,1,897,95,228,.417,53,144,.368,42,84,.500,.533,33,41,.805,36,198,234,110,28,27,34,98,276,Jaylin Williams
2024-25,OKC,PF,2,0,17,2,6,.333,2,6,.333,0,0,,.500,0,0,,1,2,3,3,0,1,0,2,6,Jaylin Williams
2022-23,POR,SG,5,4,127,24,39,.615,3,8,.375,21,31,.677,.654,2,3,.667,10,5,15,10,3,2,4,13,53,Jeenathan Williams
2023-24,HOU,SG,22,0,129,27,50,.540,2,5,.400,25,45,.556,.560,7,13,.538,12,11,23,7,4,1,4,10,63,Jeenathan Williams
2024-25,HOU,SG,3,0,10,3,4,.750,1,2,.500,2,2,1.000,.875,0,0,,0,3,3,0,1,0,0,0,7,Jeenathan Williams
2018-19,NOP,SF,46,29,1079,107,279,.384,52,156,.333,55,123,.447,.477,13,19,.684,55,164,219,83,45,19,36,95,279,Kenrich Williams
2019-20,NOP,PF,39,18,832,51,147,.347,25,97,.258,26,50,.520,.432,9,26,.346,51,135,186,57,27,21,22,88,136,Kenrich Williams
2020-21,OKC,PF,66,13,1426,219,411,.533,52,117,.444,167,294,.568,.596,36,63,.571,84,189,273,152,55,17,76,143,526,Kenrich Williams
2021-22,OKC,SF,49,0,1072,146,317,.461,41,121,.339,105,196,.536,.525,30,55,.545,75,145,220,108,44,10,46,81,363,Kenrich Williams
2022-23,OKC,PF,53,10,1206,179,346,.517,50,134,.373,129,212,.608,.590,17,39,.436,97,164,261,105,45,14,32,112,425,Kenrich Williams
2023-24,OKC,PF,69,1,1029,131,280,.468,56,141,.397,75,139,.540,.568,7,14,.500,61,148,209,93,38,9,32,101,325,Kenrich Williams
2024-25,OKC,PF,19,0,247,45,81,.556,17,43,.395,28,38,.737,.660,8,8,1.000,18,44,62,19,13,4,5,31,115,Kenrich Williams
2023-24,TOR,C,7,2,107,9,34,.265,1,5,.200,8,29,.276,.279,0,2,.000,15,23,38,2,3,4,3,15,19,Malik Williams
2022-23,CHO,C,43,17,828,160,251,.637,0,0,160,251,.637,.637,67,97,.691,93,211,304,18,28,45,40,94,387,0,Mark Williams
2023-24,CHO,C,19,19,508,98,151,.649,0,0,98,151,.649,.649,46,64,.719,76,108,184,22,16,20,17,50,242,0,Mark Williams
2024-25,CHO,C,8,5,129,37,58,.638,0,0,37,58,.638,.638,14,19,.737,18,32,50,17,4,6,4,16,88,0,Mark Williams
2020-21,CHI,PF,71,71,1983,255,528,.483,54,138,.391,201,390,.515,.534,91,125,.728,66,261,327,99,64,46,98,126,655,Patrick Williams
2021-22,CHI,PF,17,9,422,54,102,.529,15,29,.517,39,73,.534,.603,30,41,.732,17,52,69,15,9,9,16,28,153,Patrick Williams
2022-23,CHI,PF,82,65,2323,314,677,.464,115,277,.415,199,400,.498,.549,90,105,.857,78,249,327,100,72,70,101,147,833,Patrick Williams
2023-24,CHI,PF,43,30,1174,159,359,.443,59,148,.399,100,211,.474,.525,52,66,.788,46,120,166,66,40,33,57,87,429,Patrick Williams
2024-25,CHI,PF,21,20,563,73,188,.388,38,103,.369,35,85,.412,.489,27,31,.871,19,76,95,48,20,11,32,28,211,Patrick Williams
2018-19,BOS,C,32,2,283,36,51,.706,0,0,,36,51,.706,.706,9,15,.600,27,54,81,7,9,40,10,36,81,Robert Williams
2019-20,BOS,C,29,1,388,64,88,.727,0,0,,64,88,.727,.727,22,34,.647,40,88,128,27,22,35,21,51,150,Robert Williams
2020-21,BOS,C,52,13,985,186,258,.721,0,2,.000,186,256,.727,.721,45,73,.616,133,225,358,94,43,91,52,105,417,Robert Williams
2021-22,BOS,C,61,61,1804,271,368,.736,0,1,.000,271,367,.738,.736,65,90,.722,238,350,588,121,56,134,63,137,607,Robert Williams
2022-23,BOS,C,35,20,824,127,170,.747,0,1,.000,127,169,.751,.747,25,41,.610,104,188,292,50,22,48,34,68,279,Robert Williams
2023-24,POR,C,6,0,119,17,26,.654,0,0,,17,26,.654,.654,7,9,.778,11,27,38,5,7,7,7,17,41,Robert Williams
2024-25,POR,C,10,1,171,31,42,.738,1,2,.500,30,40,.750,.750,12,13,.923,18,35,53,12,8,14,8,9,75,Robert Williams
2022-23,MEM,SG,15,1,105,12,40,.300,4,28,.143,8,12,.667,.350,2,2,1.000,4,11,15,4,6,2,5,12,30,Vince Williams Jr.
2023-24,MEM,SG,52,33,1436,169,379,.446,79,209,.378,90,170,.529,.550,104,130,.800,59,231,290,175,47,34,92,135,521,Vince Williams Jr.
2024-25,MEM,SG,3,0,45,7,19,.368,1,8,.125,6,11,.545,.395,1,4,.250,4,7,11,9,0,2,7,9,16,Vince Williams Jr.
2021-22,MEM,SF,62,31,1346,191,424,.450,76,242,.314,115,182,.632,.540,43,55,.782,26,103,129,65,35,12,41,113,501,Ziaire Williams
2022-23,MEM,SF,37,4,561,84,196,.429,25,97,.258,59,99,.596,.492,17,22,.773,16,63,79,35,14,6,37,58,210,Ziaire Williams
2023-24,MEM,SF,51,15,1038,150,378,.397,58,189,.307,92,189,.487,.474,62,75,.827,35,145,180,75,36,9,66,85,420,Ziaire Williams
2024-25,BRK,SF,21,7,459,64,159,.403,18,66,.273,46,93,.495,.459,35,44,.795,22,70,92,24,20,7,19,56,181,Ziaire Williams
2019-20,NOP,PF,24,24,668,210,360,.583,6,14,.429,204,346,.590,.592,114,178,.640,64,86,150,50,16,9,59,42,540,Zion Williamson
2020-21,NOP,PF,61,61,2026,634,1037,.611,10,34,.294,624,1003,.622,.616,369,529,.698,167,274,441,226,57,39,167,135,1647,Zion Williamson
2022-23,NOP,PF,29,29,956,285,469,.608,7,19,.368,278,450,.618,.615,177,248,.714,58,144,202,133,32,16,99,65,754,Zion Williamson
2023-24,NOP,PF,70,70,2207,624,1094,.570,6,18,.333,618,1076,.574,.573,347,494,.702,122,284,406,352,77,47,193,159,1601,Zion Williamson
2024-25,NOP,PF,6,6,186,47,104,.452,2,6,.333,45,98,.459,.462,40,60,.667,16,32,48,32,4,7,22,18,136,Zion Williamson
2017-18,MIL,PF,22,0,71,9,16,.563,2,5,.400,7,11,.636,.625,1,2,.500,2,8,10,3,3,1,4,7,21,D.J. Wilson
2018-19,MIL,PF,48,3,882,104,251,.414,46,127,.362,58,124,.468,.506,26,47,.553,45,177,222,52,18,20,32,85,280,D.J. Wilson
2019-20,MIL,PF,37,1,363,52,132,.394,18,73,.247,34,59,.576,.462,11,18,.611,12,80,92,25,3,5,19,33,133,D.J. Wilson
2020-21,2TM,PF,35,1,433,68,168,.405,30,87,.345,38,81,.469,.494,17,25,.680,20,92,112,23,11,16,22,44,183,D.J. Wilson
2020-21,MIL,PF,12,0,105,16,43,.372,10,28,.357,6,15,.400,.488,1,2,.500,3,22,25,3,1,4,4,13,43,D.J. Wilson
2020-21,HOU,PF,23,1,328,52,125,.416,20,59,.339,32,66,.485,.496,16,23,.696,17,70,87,20,10,12,18,31,140,D.J. Wilson
2021-22,TOR,PF,4,1,54,11,15,.733,0,2,.000,11,13,.846,.733,8,10,.800,1,15,16,5,5,1,2,6,30,D.J. Wilson
2023-24,PHI,PF,2,0,15,4,6,.667,2,2,1.000,2,4,.500,.833,0,0,,1,1,2,2,0,2,0,1,10,D.J. Wilson
2023-24,BRK,PF,43,3,664,76,179,.425,24,74,.324,52,105,.495,.492,38,46,.826,47,84,131,45,11,4,19,48,214,Jalen Wilson
2024-25,BRK,PF,30,7,784,90,232,.388,41,128,.320,49,104,.471,.476,46,55,.836,29,74,103,57,15,1,29,66,267,Jalen Wilson
2020-21,CLE,SF,31,0,513,57,130,.438,26,77,.338,31,53,.585,.538,21,27,.778,20,87,107,33,19,12,32,37,161,Dylan Windler
2021-22,CLE,SF,50,0,459,37,98,.378,21,70,.300,16,28,.571,.485,15,18,.833,21,68,89,34,14,3,16,47,110,Dylan Windler
2022-23,CLE,SF,3,0,10,2,3,.667,1,2,.500,1,1,1.000,.833,0,0,,0,0,0,1,1,0,1,0,5,Dylan Windler
2023-24,3TM,SF,17,0,108,15,30,.500,13,27,.481,2,3,.667,.717,0,0,,3,13,16,10,2,0,2,6,43,Dylan Windler
2023-24,NYK,SF,3,0,7,1,2,.500,1,2,.500,0,0,,.750,0,0,,0,1,1,1,0,0,0,1,3,Dylan Windler
2023-24,LAL,SF,8,0,28,4,9,.444,4,8,.500,0,1,.000,.667,0,0,,0,3,3,6,0,0,0,2,12,Dylan Windler
2023-24,ATL,SF,6,0,73,10,19,.526,8,17,.471,2,2,1.000,.737,0,0,,3,9,12,3,2,0,2,3,28,Dylan Windler
2015-16,MIA,SF,78,8,2232,195,462,.422,32,116,.276,163,346,.471,.457,80,117,.684,81,322,403,117,68,26,95,184,502,Justise Winslow
2016-17,MIA,SF,18,15,625,80,225,.356,7,35,.200,73,190,.384,.371,29,47,.617,23,71,94,66,26,6,33,52,196,Justise Winslow
2017-18,MIA,PF,68,25,1680,207,488,.424,49,129,.380,158,359,.440,.474,66,104,.635,64,306,370,148,54,33,77,140,529,Justise Winslow
2018-19,MIA,SF,66,52,1959,324,749,.433,96,256,.375,228,493,.462,.497,86,137,.628,63,292,355,282,72,19,142,177,830,Justise Winslow
2019-20,MIA,SG,11,5,352,50,129,.388,6,27,.222,44,102,.431,.411,18,27,.667,16,57,73,44,7,5,24,38,124,Justise Winslow
2020-21,MEM,SF,26,1,507,74,210,.352,10,54,.185,64,156,.410,.376,20,35,.571,18,100,118,50,15,12,37,47,178,Justise Winslow
2021-22,2TM,PF,48,11,775,110,257,.428,15,66,.227,95,191,.497,.457,39,66,.591,50,152,202,84,35,25,49,67,274,Justise Winslow
2021-22,LAC,PF,37,1,480,63,141,.447,5,29,.172,58,112,.518,.465,25,41,.610,30,103,133,52,21,18,37,46,156,Justise Winslow
2021-22,POR,PF,11,10,295,47,116,.405,10,37,.270,37,79,.468,.448,14,25,.560,20,49,69,32,14,7,12,21,118,Justise Winslow
2022-23,POR,PF,29,11,776,81,198,.409,14,45,.311,67,153,.438,.444,20,28,.714,49,96,145,98,30,11,43,89,196,Justise Winslow
2020-21,WAS,PG,22,0,98,14,33,.424,8,17,.471,6,16,.375,.545,5,6,.833,0,9,9,12,2,1,5,8,41,Cassius Winston
2021-22,WAS,PG,7,0,39,4,11,.364,2,6,.333,2,5,.400,.455,4,4,1.000,0,1,1,7,0,0,3,9,14,Cassius Winston
2020-21,GSW,C,39,27,836,191,368,.519,12,38,.316,179,330,.542,.535,54,86,.628,55,171,226,26,11,36,60,121,448,James Wiseman
2022-23,2TM,C,45,22,867,189,339,.558,4,20,.200,185,319,.580,.563,68,97,.701,73,194,267,30,7,27,51,108,450,James Wiseman
2022-23,GSW,C,21,0,262,59,94,.628,1,2,.500,58,92,.630,.633,26,38,.684,18,55,73,14,3,7,14,39,145,James Wiseman
2022-23,DET,C,24,22,605,130,245,.531,3,18,.167,127,227,.559,.537,42,59,.712,55,139,194,16,4,20,37,69,305,James Wiseman
2023-24,DET,C,63,6,1091,187,305,.613,0,2,.000,187,303,.617,.613,72,102,.706,110,226,336,54,12,39,66,141,446,James Wiseman
2024-25,IND,C,1,0,5,2,4,.500,0,1,.000,2,3,.667,.500,2,2,1.000,0,1,1,0,0,0,0,0,6,James Wiseman
2023-24,IND,SG,1,0,4,1,3,.333,0,1,.000,1,2,.500,.333,0,0,,0,0,0,0,0,0,0,0,2,Isaiah Wong
2024-25,CHO,SG,8,0,107,17,41,.415,4,12,.333,13,29,.448,.463,11,18,.611,10,9,19,16,4,0,8,10,49,Isaiah Wong
2015-16,PHI,PF,17,0,145,22,53,.415,4,11,.364,18,42,.429,.453,13,21,.619,13,25,38,3,5,7,2,11,61,Christian Wood
2016-17,CHO,PF,13,0,107,12,23,.522,0,5,.000,12,18,.667,.522,11,15,.733,14,15,29,2,3,6,7,11,35,Christian Wood
2018-19,2TM,PF,21,2,251,61,117,.521,9,26,.346,52,91,.571,.560,41,56,.732,17,66,83,8,7,10,17,17,172,Christian Wood
2018-19,MIL,PF,13,0,62,12,25,.480,3,5,.600,9,20,.450,.540,10,15,.667,4,16,20,2,0,0,3,3,37,Christian Wood
2018-19,NOP,PF,8,2,189,49,92,.533,6,21,.286,43,71,.606,.565,31,41,.756,13,50,63,6,7,10,14,14,135,Christian Wood
2019-20,DET,PF,62,12,1325,288,508,.567,54,140,.386,234,368,.636,.620,180,242,.744,104,286,390,60,34,54,84,98,810,Christian Wood
2020-21,HOU,C,41,41,1326,329,640,.514,77,206,.374,252,434,.581,.574,125,198,.631,76,319,395,71,34,48,80,88,860,Christian Wood
2021-22,HOU,C,68,67,2094,440,878,.501,131,336,.390,309,542,.570,.576,207,332,.623,110,576,686,155,54,65,126,171,1218,Christian Wood
2022-23,DAL,C,67,17,1738,396,769,.515,105,279,.376,291,490,.594,.583,217,281,.772,87,404,491,121,30,72,121,169,1114,Christian Wood
2023-24,LAL,PF,50,1,872,123,264,.466,35,114,.307,88,150,.587,.532,66,94,.702,39,215,254,49,16,33,50,72,347,Christian Wood
2020-21,SAC,SF,13,0,45,8,20,.400,1,6,.167,7,14,.500,.425,3,8,.375,4,12,16,2,0,3,1,4,20,Robert Woodard II
2021-22,SAC,SF,12,0,42,2,16,.125,1,4,.250,1,12,.083,.156,2,2,1.000,5,6,11,3,1,1,1,3,7,Robert Woodard II
2015-16,TOR,PG,27,1,229,36,80,.450,5,13,.385,31,67,.463,.481,26,35,.743,8,29,37,31,8,3,16,7,103,Delon Wright
2016-17,TOR,PG,27,0,446,49,116,.422,10,30,.333,39,86,.453,.466,42,55,.764,16,32,48,57,27,11,25,31,150,Delon Wright
2017-18,TOR,PG,69,4,1433,201,432,.465,56,153,.366,145,279,.520,.530,97,117,.829,45,153,198,200,72,33,78,81,555,Delon Wright
2018-19,2TM,PG,75,13,1699,242,558,.434,50,168,.298,192,390,.492,.478,119,150,.793,68,198,266,248,88,30,77,103,653,Delon Wright
2018-19,TOR,PG,49,2,897,127,293,.433,30,90,.333,97,203,.478,.485,53,61,.869,39,86,125,110,46,15,37,53,337,Delon Wright
2018-19,MEM,PG,26,11,802,115,265,.434,20,78,.256,95,187,.508,.472,66,89,.742,29,112,141,138,42,15,40,50,316,Delon Wright
2019-20,DAL,PG,73,5,1570,190,411,.462,47,127,.370,143,284,.504,.519,77,100,.770,70,210,280,244,85,22,73,93,504,Delon Wright
2020-21,2TM,PG,63,39,1748,240,518,.463,64,172,.372,176,346,.509,.525,101,126,.802,65,204,269,278,101,30,83,75,645,Delon Wright
2020-21,DET,PG,36,31,1052,136,293,.464,31,89,.348,105,204,.515,.517,71,90,.789,37,127,164,181,58,19,48,45,374,Delon Wright
2020-21,SAC,PG,27,8,696,104,225,.462,33,83,.398,71,142,.500,.536,30,36,.833,28,77,105,97,43,11,35,30,271,Delon Wright
2021-22,ATL,SG,77,8,1452,122,269,.454,44,116,.379,78,153,.510,.535,54,63,.857,50,170,220,188,93,19,45,56,342,Delon Wright
2022-23,WAS,PG,50,14,1221,138,291,.474,41,119,.345,97,172,.564,.545,52,60,.867,58,122,180,194,92,17,44,59,369,Delon Wright
2023-24,2TM,PG,47,1,742,74,188,.394,25,68,.368,49,120,.408,.460,37,45,.822,19,67,86,119,54,11,14,32,210,Delon Wright
2023-24,WAS,PG,33,0,456,48,122,.393,14,38,.368,34,84,.405,.451,24,29,.828,13,46,59,82,35,8,11,22,134,Delon Wright
2023-24,MIA,PG,14,1,286,26,66,.394,11,30,.367,15,36,.417,.477,13,16,.813,6,21,27,37,19,3,3,10,76,Delon Wright
2024-25,MIL,PG,22,2,366,21,70,.300,11,42,.262,10,28,.357,.379,8,14,.571,15,27,42,42,19,6,13,16,61,Delon Wright
2021-22,MIN,PG,5,0,19,2,3,.667,1,2,.500,1,1,1.000,.833,0,0,,0,0,0,3,0,0,1,1,5,McKinley Wright IV
2022-23,DAL,PG,27,1,335,46,98,.469,9,28,.321,37,70,.529,.515,13,19,.684,9,38,47,58,8,5,19,24,114,McKinley Wright IV
2019-20,UTA,PG,4,0,45,7,20,.350,2,10,.200,5,10,.500,.400,3,4,.750,0,5,5,7,2,0,3,5,19,Justin Wright-Foreman
2021-22,IND,SG,2,0,21,2,7,.286,1,6,.167,1,1,1.000,.357,3,5,.600,0,2,2,4,2,1,1,4,8,Gabe York
2022-23,IND,SG,3,0,56,8,21,.381,6,18,.333,2,3,.667,.524,2,2,1.000,0,6,6,5,2,0,0,5,24,Gabe York
2007-08,PHI,PF,74,22,1554,264,490,.539,6,19,.316,258,471,.548,.545,76,103,.738,120,192,312,58,73,8,64,126,610,Thaddeus Young
2008-09,PHI,PF,75,71,2580,475,960,.495,56,164,.341,419,796,.526,.524,139,189,.735,139,238,377,86,100,23,118,165,1145,Thaddeus Young
2009-10,PHI,PF,67,45,2145,382,813,.470,48,138,.348,334,675,.495,.499,114,165,.691,130,220,350,97,81,15,126,133,926,Thaddeus Young
2010-11,PHI,PF,82,1,2135,458,847,.541,6,22,.273,452,825,.548,.544,123,174,.707,153,281,434,82,90,26,99,170,1045,Thaddeus Young
2011-12,PHI,PF,63,1,1755,348,687,.507,1,4,.250,347,683,.508,.507,111,144,.771,137,188,325,74,64,41,55,127,808,Thaddeus Young
2012-13,PHI,PF,76,76,2629,509,958,.531,1,8,.125,508,950,.535,.532,108,188,.574,182,389,571,125,133,55,90,191,1127,Thaddeus Young
2013-14,PHI,PF,79,78,2718,582,1283,.454,90,292,.308,492,991,.496,.489,163,229,.712,166,310,476,182,167,36,165,213,1417,Thaddeus Young
2014-15,2TM,PF,76,68,2434,451,968,.466,38,115,.330,413,853,.484,.486,131,200,.655,127,284,411,173,124,25,117,171,1071,Thaddeus Young
2014-15,MIN,PF,48,48,1605,289,641,.451,19,65,.292,270,576,.469,.466,88,129,.682,75,170,245,135,86,17,75,115,685,Thaddeus Young
2014-15,BRK,PF,28,20,829,162,327,.495,19,50,.380,143,277,.516,.524,43,71,.606,52,114,166,38,38,8,42,56,386,Thaddeus Young
2015-16,BRK,PF,73,73,2407,495,963,.514,7,30,.233,488,933,.523,.518,105,163,.644,176,484,660,136,112,37,136,182,1102,Thaddeus Young
2016-17,IND,PF,74,74,2237,362,687,.527,45,118,.381,317,569,.557,.560,45,86,.523,131,317,448,122,113,29,95,135,814,Thaddeus Young
2017-18,IND,PF,81,81,2607,421,864,.487,58,181,.320,363,683,.531,.521,55,92,.598,184,328,512,152,135,36,105,175,955,Thaddeus Young
2018-19,IND,PF,81,81,2489,443,841,.527,51,146,.349,392,695,.564,.557,87,135,.644,192,331,523,204,123,36,123,194,1024,Thaddeus Young
2019-20,CHI,PF,64,16,1591,269,601,.448,79,222,.356,190,379,.501,.513,42,72,.583,94,221,315,117,92,23,102,134,659,Thaddeus Young
2020-21,CHI,PF,68,23,1652,370,662,.559,12,45,.267,358,617,.580,.568,71,113,.628,168,255,423,291,74,40,137,152,823,Thaddeus Young
2021-22,2TM,PF,52,1,845,141,272,.518,17,48,.354,124,224,.554,.550,23,49,.469,80,128,208,104,54,18,52,81,322,Thaddeus Young
2021-22,SAS,PF,26,1,370,74,128,.578,0,5,.000,74,123,.602,.578,10,22,.455,40,53,93,59,23,7,30,38,158,Thaddeus Young
2021-22,TOR,PF,26,0,475,67,144,.465,17,43,.395,50,101,.495,.524,13,27,.481,40,75,115,45,31,11,22,43,164,Thaddeus Young
2022-23,TOR,PF,54,9,795,108,198,.545,6,34,.176,102,164,.622,.561,18,26,.692,71,95,166,75,54,5,42,88,240,Thaddeus Young
2023-24,2TM,PF,33,6,439,65,108,.602,1,7,.143,64,101,.634,.606,6,15,.400,46,57,103,57,23,5,15,49,137,Thaddeus Young
2023-24,TOR,PF,23,6,350,54,87,.621,1,6,.167,53,81,.654,.626,5,12,.417,29,46,75,50,18,3,11,38,114,Thaddeus Young
2023-24,PHO,PF,10,0,89,11,21,.524,0,1,.000,11,20,.550,.524,1,3,.333,17,11,28,7,5,2,4,11,23,Thaddeus Young
2018-19,ATL,PG,81,81,2503,525,1256,.418,156,482,.324,369,774,.477,.480,343,414,.829,64,237,301,653,72,15,308,140,1549,Trae Young
2019-20,ATL,PG,60,60,2120,546,1249,.437,205,568,.361,341,681,.501,.519,481,559,.860,32,223,255,560,65,8,289,104,1778,Trae Young
2020-21,ATL,PG,63,63,2125,487,1112,.438,136,397,.343,351,715,.491,.499,484,546,.886,38,207,245,594,53,12,261,111,1594,Trae Young
2021-22,ATL,PG,76,76,2652,711,1544,.460,233,610,.382,478,934,.512,.536,500,553,.904,50,234,284,737,72,7,303,128,2155,Trae Young
2022-23,ATL,PG,73,73,2541,597,1390,.429,154,460,.335,443,930,.476,.485,566,639,.886,56,161,217,741,80,9,300,104,1914,Trae Young
2023-24,ATL,PG,54,54,1942,433,1008,.430,175,469,.373,258,539,.479,.516,348,407,.855,23,126,149,583,72,11,235,109,1389,Trae Young
2024-25,ATL,PG,29,29,1046,194,488,.398,79,240,.329,115,248,.464,.478,171,195,.877,18,91,109,350,38,4,131,62,638,Trae Young
2021-22,MIA,C,56,12,706,130,247,.526,1,11,.091,129,236,.547,.528,38,61,.623,85,209,294,49,17,20,41,84,299,Omer Yurtseven
2022-23,MIA,C,9,0,83,16,27,.593,3,7,.429,13,20,.650,.648,5,6,.833,8,15,23,2,2,2,4,16,40,Omer Yurtseven
2023-24,UTA,C,48,12,545,99,184,.538,5,24,.208,94,160,.588,.552,19,28,.679,72,136,208,29,8,18,37,52,222,Omer Yurtseven
2013-14,CHA,C,82,3,1416,172,404,.426,0,1,.000,172,403,.427,.426,146,200,.730,118,235,353,92,40,41,87,170,490,Cody Zeller
2014-15,CHO,C,62,45,1487,172,373,.461,1,1,1.000,171,372,.460,.462,127,164,.774,97,265,362,100,34,49,62,156,472,Cody Zeller
2015-16,CHO,C,73,60,1774,231,437,.529,1,10,.100,230,427,.539,.530,175,232,.754,138,317,455,71,57,63,68,204,638,Cody Zeller
2016-17,CHO,C,62,58,1725,253,443,.571,0,1,.000,253,442,.572,.571,133,196,.679,135,270,405,99,62,58,65,189,639,Cody Zeller
2017-18,CHO,C,33,0,627,85,156,.545,2,3,.667,83,153,.542,.551,61,85,.718,67,110,177,31,14,21,33,81,233,Cody Zeller
2018-19,CHO,C,49,47,1243,190,345,.551,6,22,.273,184,323,.570,.559,111,141,.787,110,223,333,102,38,41,62,164,497,Cody Zeller
2019-20,CHO,C,58,39,1341,251,479,.524,18,75,.240,233,404,.577,.543,122,179,.682,160,251,411,88,40,25,75,140,642,Cody Zeller
2020-21,CHO,C,48,21,1005,181,324,.559,4,28,.143,177,296,.598,.565,85,119,.714,119,209,328,86,27,17,51,121,451,Cody Zeller
2021-22,POR,C,27,0,355,51,90,.567,0,4,.000,51,86,.593,.567,38,49,.776,50,75,125,22,8,6,19,56,140,Cody Zeller
2022-23,MIA,C,15,2,217,37,59,.627,0,2,.000,37,57,.649,.627,24,35,.686,25,39,64,10,3,4,14,33,98,Cody Zeller
2023-24,NOP,C,43,0,320,26,62,.419,1,3,.333,25,59,.424,.427,23,38,.605,48,64,112,39,9,5,16,45,76,Cody Zeller
2016-17,LAL,C,38,11,609,126,238,.529,0,3,.000,126,235,.536,.529,32,49,.653,41,118,159,30,14,33,30,66,284,Ivica Zubac
2017-18,LAL,C,43,0,410,61,122,.500,0,1,.000,61,121,.504,.500,39,51,.765,45,78,123,25,8,15,26,47,161,Ivica Zubac
2018-19,2TM,C,59,37,1040,212,379,.559,0,0,,212,379,.559,.559,101,126,.802,115,247,362,63,14,51,70,137,525,Ivica Zubac
2018-19,LAL,C,33,12,516,112,193,.580,0,0,,112,193,.580,.580,57,66,.864,54,108,162,25,4,27,33,73,281,Ivica Zubac
2018-19,LAC,C,26,25,524,100,186,.538,0,0,,100,186,.538,.538,44,60,.733,61,139,200,38,10,24,37,64,244,Ivica Zubac
2019-20,LAC,C,72,70,1326,236,385,.613,0,2,.000,236,383,.616,.613,124,166,.747,197,346,543,82,16,66,61,168,596,Ivica Zubac
2020-21,LAC,C,72,33,1609,257,394,.652,1,4,.250,256,390,.656,.654,135,171,.789,189,330,519,90,24,62,81,187,650,Ivica Zubac
2021-22,LAC,C,76,76,1852,310,495,.626,0,0,,310,495,.626,.626,165,227,.727,217,427,644,120,36,77,114,203,785,Ivica Zubac
2022-23,LAC,C,76,76,2170,326,514,.634,0,2,.000,326,512,.637,.634,166,238,.697,236,520,756,77,29,98,117,219,818,Ivica Zubac
2023-24,LAC,C,68,68,1794,337,519,.649,0,0,,337,519,.649,.649,120,166,.723,196,430,626,93,22,83,79,180,794,Ivica Zubac
2024-25,LAC,C,31,31,1011,213,347,.614,0,0,,213,347,.614,.614,46,88,.523,122,267,389,77,22,35,59,64,472,Ivica Zubac
